"Date","Season","home","visitor","FT","hgoal","vgoal","division","tier","totgoal","goaldif","result"
NA,1979,"AP Leamington","Altrincham","1-4",1,4,5,5,5,-3,"A"
NA,1979,"Bangor City","Altrincham","1-1",1,1,5,5,2,0,"D"
NA,1979,"Barnet","Altrincham","2-0",2,0,5,5,2,2,"H"
NA,1979,"Barrow","Altrincham","1-3",1,3,5,5,4,-2,"A"
NA,1979,"Bath City","Altrincham","1-1",1,1,5,5,2,0,"D"
NA,1979,"Boston United","Altrincham","2-5",2,5,5,5,7,-3,"A"
NA,1979,"Ebbsfleet United","Altrincham","0-2",0,2,5,5,2,-2,"A"
NA,1979,"Kettering Town","Altrincham","1-2",1,2,5,5,3,-1,"A"
NA,1979,"Maidstone United","Altrincham","2-2",2,2,5,5,4,0,"D"
NA,1979,"Northwich Victoria","Altrincham","1-0",1,0,5,5,1,1,"H"
NA,1979,"Nuneaton Town","Altrincham","2-0",2,0,5,5,2,2,"H"
NA,1979,"Redditch United","Altrincham","0-1",0,1,5,5,1,-1,"A"
NA,1979,"Scarborough","Altrincham","1-1",1,1,5,5,2,0,"D"
NA,1979,"Stafford Rangers","Altrincham","1-2",1,2,5,5,3,-1,"A"
NA,1979,"Telford United","Altrincham","3-2",3,2,5,5,5,1,"H"
NA,1979,"Wealdstone","Altrincham","1-4",1,4,5,5,5,-3,"A"
NA,1979,"Weymouth","Altrincham","0-0",0,0,5,5,0,0,"D"
NA,1979,"Worcester City","Altrincham","3-2",3,2,5,5,5,1,"H"
NA,1979,"Yeovil","Altrincham","3-2",3,2,5,5,5,1,"H"
NA,1979,"Altrincham","AP Leamington","3-0",3,0,5,5,3,3,"H"
NA,1979,"Bangor City","AP Leamington","3-2",3,2,5,5,5,1,"H"
NA,1979,"Barnet","AP Leamington","1-0",1,0,5,5,1,1,"H"
NA,1979,"Barrow","AP Leamington","6-2",6,2,5,5,8,4,"H"
NA,1979,"Bath City","AP Leamington","0-0",0,0,5,5,0,0,"D"
NA,1979,"Boston United","AP Leamington","2-0",2,0,5,5,2,2,"H"
NA,1979,"Ebbsfleet United","AP Leamington","3-2",3,2,5,5,5,1,"H"
NA,1979,"Kettering Town","AP Leamington","1-1",1,1,5,5,2,0,"D"
NA,1979,"Maidstone United","AP Leamington","0-0",0,0,5,5,0,0,"D"
NA,1979,"Northwich Victoria","AP Leamington","2-1",2,1,5,5,3,1,"H"
NA,1979,"Nuneaton Town","AP Leamington","1-1",1,1,5,5,2,0,"D"
NA,1979,"Redditch United","AP Leamington","3-1",3,1,5,5,4,2,"H"
NA,1979,"Scarborough","AP Leamington","5-0",5,0,5,5,5,5,"H"
NA,1979,"Stafford Rangers","AP Leamington","1-1",1,1,5,5,2,0,"D"
NA,1979,"Telford United","AP Leamington","0-1",0,1,5,5,1,-1,"A"
NA,1979,"Wealdstone","AP Leamington","1-2",1,2,5,5,3,-1,"A"
NA,1979,"Weymouth","AP Leamington","2-1",2,1,5,5,3,1,"H"
NA,1979,"Worcester City","AP Leamington","1-1",1,1,5,5,2,0,"D"
NA,1979,"Yeovil","AP Leamington","1-0",1,0,5,5,1,1,"H"
NA,1979,"Altrincham","Bangor City","5-0",5,0,5,5,5,5,"H"
NA,1979,"AP Leamington","Bangor City","1-1",1,1,5,5,2,0,"D"
NA,1979,"Barnet","Bangor City","1-1",1,1,5,5,2,0,"D"
NA,1979,"Barrow","Bangor City","1-1",1,1,5,5,2,0,"D"
NA,1979,"Bath City","Bangor City","2-1",2,1,5,5,3,1,"H"
NA,1979,"Boston United","Bangor City","3-1",3,1,5,5,4,2,"H"
NA,1979,"Ebbsfleet United","Bangor City","1-1",1,1,5,5,2,0,"D"
NA,1979,"Kettering Town","Bangor City","0-1",0,1,5,5,1,-1,"A"
NA,1979,"Maidstone United","Bangor City","0-1",0,1,5,5,1,-1,"A"
NA,1979,"Northwich Victoria","Bangor City","4-0",4,0,5,5,4,4,"H"
NA,1979,"Nuneaton Town","Bangor City","2-2",2,2,5,5,4,0,"D"
NA,1979,"Redditch United","Bangor City","1-5",1,5,5,5,6,-4,"A"
NA,1979,"Scarborough","Bangor City","0-0",0,0,5,5,0,0,"D"
NA,1979,"Stafford Rangers","Bangor City","0-1",0,1,5,5,1,-1,"A"
NA,1979,"Telford United","Bangor City","2-0",2,0,5,5,2,2,"H"
NA,1979,"Wealdstone","Bangor City","0-0",0,0,5,5,0,0,"D"
NA,1979,"Weymouth","Bangor City","4-2",4,2,5,5,6,2,"H"
NA,1979,"Worcester City","Bangor City","0-0",0,0,5,5,0,0,"D"
NA,1979,"Yeovil","Bangor City","1-2",1,2,5,5,3,-1,"A"
NA,1979,"Altrincham","Barnet","1-0",1,0,5,5,1,1,"H"
NA,1979,"AP Leamington","Barnet","2-1",2,1,5,5,3,1,"H"
NA,1979,"Bangor City","Barnet","1-1",1,1,5,5,2,0,"D"
NA,1979,"Barrow","Barnet","3-1",3,1,5,5,4,2,"H"
NA,1979,"Bath City","Barnet","1-2",1,2,5,5,3,-1,"A"
NA,1979,"Boston United","Barnet","1-1",1,1,5,5,2,0,"D"
NA,1979,"Ebbsfleet United","Barnet","1-0",1,0,5,5,1,1,"H"
NA,1979,"Kettering Town","Barnet","1-0",1,0,5,5,1,1,"H"
NA,1979,"Maidstone United","Barnet","2-0",2,0,5,5,2,2,"H"
NA,1979,"Northwich Victoria","Barnet","2-0",2,0,5,5,2,2,"H"
NA,1979,"Nuneaton Town","Barnet","2-1",2,1,5,5,3,1,"H"
NA,1979,"Redditch United","Barnet","1-0",1,0,5,5,1,1,"H"
NA,1979,"Scarborough","Barnet","0-0",0,0,5,5,0,0,"D"
NA,1979,"Stafford Rangers","Barnet","1-2",1,2,5,5,3,-1,"A"
NA,1979,"Telford United","Barnet","1-2",1,2,5,5,3,-1,"A"
NA,1979,"Wealdstone","Barnet","2-1",2,1,5,5,3,1,"H"
NA,1979,"Weymouth","Barnet","1-1",1,1,5,5,2,0,"D"
NA,1979,"Worcester City","Barnet","2-1",2,1,5,5,3,1,"H"
NA,1979,"Yeovil","Barnet","5-0",5,0,5,5,5,5,"H"
NA,1979,"Altrincham","Barrow","3-1",3,1,5,5,4,2,"H"
NA,1979,"AP Leamington","Barrow","0-1",0,1,5,5,1,-1,"A"
NA,1979,"Bangor City","Barrow","1-1",1,1,5,5,2,0,"D"
NA,1979,"Barnet","Barrow","1-1",1,1,5,5,2,0,"D"
NA,1979,"Bath City","Barrow","1-0",1,0,5,5,1,1,"H"
NA,1979,"Boston United","Barrow","3-0",3,0,5,5,3,3,"H"
NA,1979,"Ebbsfleet United","Barrow","5-1",5,1,5,5,6,4,"H"
NA,1979,"Kettering Town","Barrow","0-4",0,4,5,5,4,-4,"A"
NA,1979,"Maidstone United","Barrow","2-0",2,0,5,5,2,2,"H"
NA,1979,"Northwich Victoria","Barrow","6-3",6,3,5,5,9,3,"H"
NA,1979,"Nuneaton Town","Barrow","3-0",3,0,5,5,3,3,"H"
NA,1979,"Redditch United","Barrow","1-3",1,3,5,5,4,-2,"A"
NA,1979,"Scarborough","Barrow","2-0",2,0,5,5,2,2,"H"
NA,1979,"Stafford Rangers","Barrow","1-1",1,1,5,5,2,0,"D"
NA,1979,"Telford United","Barrow","3-2",3,2,5,5,5,1,"H"
NA,1979,"Wealdstone","Barrow","2-1",2,1,5,5,3,1,"H"
NA,1979,"Weymouth","Barrow","1-0",1,0,5,5,1,1,"H"
NA,1979,"Worcester City","Barrow","2-0",2,0,5,5,2,2,"H"
NA,1979,"Yeovil","Barrow","0-1",0,1,5,5,1,-1,"A"
NA,1979,"Altrincham","Bath City","4-0",4,0,5,5,4,4,"H"
NA,1979,"AP Leamington","Bath City","1-2",1,2,5,5,3,-1,"A"
NA,1979,"Bangor City","Bath City","2-1",2,1,5,5,3,1,"H"
NA,1979,"Barnet","Bath City","1-0",1,0,5,5,1,1,"H"
NA,1979,"Barrow","Bath City","2-1",2,1,5,5,3,1,"H"
NA,1979,"Boston United","Bath City","3-2",3,2,5,5,5,1,"H"
NA,1979,"Ebbsfleet United","Bath City","2-0",2,0,5,5,2,2,"H"
NA,1979,"Kettering Town","Bath City","1-2",1,2,5,5,3,-1,"A"
NA,1979,"Maidstone United","Bath City","6-0",6,0,5,5,6,6,"H"
NA,1979,"Northwich Victoria","Bath City","6-1",6,1,5,5,7,5,"H"
NA,1979,"Nuneaton Town","Bath City","1-1",1,1,5,5,2,0,"D"
NA,1979,"Redditch United","Bath City","1-1",1,1,5,5,2,0,"D"
NA,1979,"Scarborough","Bath City","6-1",6,1,5,5,7,5,"H"
NA,1979,"Stafford Rangers","Bath City","4-0",4,0,5,5,4,4,"H"
NA,1979,"Telford United","Bath City","3-1",3,1,5,5,4,2,"H"
NA,1979,"Wealdstone","Bath City","1-1",1,1,5,5,2,0,"D"
NA,1979,"Weymouth","Bath City","1-2",1,2,5,5,3,-1,"A"
NA,1979,"Worcester City","Bath City","2-1",2,1,5,5,3,1,"H"
NA,1979,"Yeovil","Bath City","1-0",1,0,5,5,1,1,"H"
NA,1979,"Altrincham","Boston United","3-0",3,0,5,5,3,3,"H"
NA,1979,"AP Leamington","Boston United","2-0",2,0,5,5,2,2,"H"
NA,1979,"Bangor City","Boston United","2-0",2,0,5,5,2,2,"H"
NA,1979,"Barnet","Boston United","0-0",0,0,5,5,0,0,"D"
NA,1979,"Barrow","Boston United","0-1",0,1,5,5,1,-1,"A"
NA,1979,"Bath City","Boston United","0-1",0,1,5,5,1,-1,"A"
NA,1979,"Ebbsfleet United","Boston United","0-0",0,0,5,5,0,0,"D"
NA,1979,"Kettering Town","Boston United","3-1",3,1,5,5,4,2,"H"
NA,1979,"Maidstone United","Boston United","1-0",1,0,5,5,1,1,"H"
NA,1979,"Northwich Victoria","Boston United","0-1",0,1,5,5,1,-1,"A"
NA,1979,"Nuneaton Town","Boston United","2-0",2,0,5,5,2,2,"H"
NA,1979,"Redditch United","Boston United","0-2",0,2,5,5,2,-2,"A"
NA,1979,"Scarborough","Boston United","2-4",2,4,5,5,6,-2,"A"
NA,1979,"Stafford Rangers","Boston United","0-0",0,0,5,5,0,0,"D"
NA,1979,"Telford United","Boston United","4-1",4,1,5,5,5,3,"H"
NA,1979,"Wealdstone","Boston United","1-1",1,1,5,5,2,0,"D"
NA,1979,"Weymouth","Boston United","3-0",3,0,5,5,3,3,"H"
NA,1979,"Worcester City","Boston United","0-0",0,0,5,5,0,0,"D"
NA,1979,"Yeovil","Boston United","0-0",0,0,5,5,0,0,"D"
NA,1979,"Altrincham","Ebbsfleet United","4-1",4,1,5,5,5,3,"H"
NA,1979,"AP Leamington","Ebbsfleet United","0-1",0,1,5,5,1,-1,"A"
NA,1979,"Bangor City","Ebbsfleet United","1-2",1,2,5,5,3,-1,"A"
NA,1979,"Barnet","Ebbsfleet United","3-0",3,0,5,5,3,3,"H"
NA,1979,"Barrow","Ebbsfleet United","1-1",1,1,5,5,2,0,"D"
NA,1979,"Bath City","Ebbsfleet United","2-0",2,0,5,5,2,2,"H"
NA,1979,"Boston United","Ebbsfleet United","4-0",4,0,5,5,4,4,"H"
NA,1979,"Kettering Town","Ebbsfleet United","0-0",0,0,5,5,0,0,"D"
NA,1979,"Maidstone United","Ebbsfleet United","3-0",3,0,5,5,3,3,"H"
NA,1979,"Northwich Victoria","Ebbsfleet United","0-0",0,0,5,5,0,0,"D"
NA,1979,"Nuneaton Town","Ebbsfleet United","3-1",3,1,5,5,4,2,"H"
NA,1979,"Redditch United","Ebbsfleet United","0-2",0,2,5,5,2,-2,"A"
NA,1979,"Scarborough","Ebbsfleet United","1-1",1,1,5,5,2,0,"D"
NA,1979,"Stafford Rangers","Ebbsfleet United","0-1",0,1,5,5,1,-1,"A"
NA,1979,"Telford United","Ebbsfleet United","1-2",1,2,5,5,3,-1,"A"
NA,1979,"Wealdstone","Ebbsfleet United","0-0",0,0,5,5,0,0,"D"
NA,1979,"Weymouth","Ebbsfleet United","1-0",1,0,5,5,1,1,"H"
NA,1979,"Worcester City","Ebbsfleet United","1-0",1,0,5,5,1,1,"H"
NA,1979,"Yeovil","Ebbsfleet United","1-1",1,1,5,5,2,0,"D"
NA,1979,"Altrincham","Kettering Town","0-0",0,0,5,5,0,0,"D"
NA,1979,"AP Leamington","Kettering Town","1-3",1,3,5,5,4,-2,"A"
NA,1979,"Bangor City","Kettering Town","1-1",1,1,5,5,2,0,"D"
NA,1979,"Barnet","Kettering Town","0-2",0,2,5,5,2,-2,"A"
NA,1979,"Barrow","Kettering Town","1-2",1,2,5,5,3,-1,"A"
NA,1979,"Bath City","Kettering Town","3-0",3,0,5,5,3,3,"H"
NA,1979,"Boston United","Kettering Town","1-0",1,0,5,5,1,1,"H"
NA,1979,"Ebbsfleet United","Kettering Town","2-2",2,2,5,5,4,0,"D"
NA,1979,"Maidstone United","Kettering Town","1-3",1,3,5,5,4,-2,"A"
NA,1979,"Northwich Victoria","Kettering Town","2-2",2,2,5,5,4,0,"D"
NA,1979,"Nuneaton Town","Kettering Town","2-2",2,2,5,5,4,0,"D"
NA,1979,"Redditch United","Kettering Town","0-1",0,1,5,5,1,-1,"A"
NA,1979,"Scarborough","Kettering Town","2-0",2,0,5,5,2,2,"H"
NA,1979,"Stafford Rangers","Kettering Town","0-0",0,0,5,5,0,0,"D"
NA,1979,"Telford United","Kettering Town","1-0",1,0,5,5,1,1,"H"
NA,1979,"Wealdstone","Kettering Town","2-2",2,2,5,5,4,0,"D"
NA,1979,"Weymouth","Kettering Town","3-1",3,1,5,5,4,2,"H"
NA,1979,"Worcester City","Kettering Town","1-4",1,4,5,5,5,-3,"A"
NA,1979,"Yeovil","Kettering Town","1-1",1,1,5,5,2,0,"D"
NA,1979,"Altrincham","Maidstone United","1-0",1,0,5,5,1,1,"H"
NA,1979,"AP Leamington","Maidstone United","0-2",0,2,5,5,2,-2,"A"
NA,1979,"Bangor City","Maidstone United","1-0",1,0,5,5,1,1,"H"
NA,1979,"Barnet","Maidstone United","0-1",0,1,5,5,1,-1,"A"
NA,1979,"Barrow","Maidstone United","0-2",0,2,5,5,2,-2,"A"
NA,1979,"Bath City","Maidstone United","1-1",1,1,5,5,2,0,"D"
NA,1979,"Boston United","Maidstone United","1-1",1,1,5,5,2,0,"D"
NA,1979,"Ebbsfleet United","Maidstone United","1-0",1,0,5,5,1,1,"H"
NA,1979,"Kettering Town","Maidstone United","1-1",1,1,5,5,2,0,"D"
NA,1979,"Northwich Victoria","Maidstone United","0-2",0,2,5,5,2,-2,"A"
NA,1979,"Nuneaton Town","Maidstone United","4-0",4,0,5,5,4,4,"H"
NA,1979,"Redditch United","Maidstone United","0-0",0,0,5,5,0,0,"D"
NA,1979,"Scarborough","Maidstone United","1-2",1,2,5,5,3,-1,"A"
NA,1979,"Stafford Rangers","Maidstone United","1-1",1,1,5,5,2,0,"D"
NA,1979,"Telford United","Maidstone United","3-1",3,1,5,5,4,2,"H"
NA,1979,"Wealdstone","Maidstone United","0-0",0,0,5,5,0,0,"D"
NA,1979,"Weymouth","Maidstone United","1-1",1,1,5,5,2,0,"D"
NA,1979,"Worcester City","Maidstone United","3-1",3,1,5,5,4,2,"H"
NA,1979,"Yeovil","Maidstone United","3-0",3,0,5,5,3,3,"H"
NA,1979,"Altrincham","Northwich Victoria","0-0",0,0,5,5,0,0,"D"
NA,1979,"AP Leamington","Northwich Victoria","2-2",2,2,5,5,4,0,"D"
NA,1979,"Bangor City","Northwich Victoria","0-3",0,3,5,5,3,-3,"A"
NA,1979,"Barnet","Northwich Victoria","0-2",0,2,5,5,2,-2,"A"
NA,1979,"Barrow","Northwich Victoria","1-0",1,0,5,5,1,1,"H"
NA,1979,"Bath City","Northwich Victoria","0-0",0,0,5,5,0,0,"D"
NA,1979,"Boston United","Northwich Victoria","2-0",2,0,5,5,2,2,"H"
NA,1979,"Ebbsfleet United","Northwich Victoria","2-1",2,1,5,5,3,1,"H"
NA,1979,"Kettering Town","Northwich Victoria","1-0",1,0,5,5,1,1,"H"
NA,1979,"Maidstone United","Northwich Victoria","3-4",3,4,5,5,7,-1,"A"
NA,1979,"Nuneaton Town","Northwich Victoria","2-1",2,1,5,5,3,1,"H"
NA,1979,"Redditch United","Northwich Victoria","0-1",0,1,5,5,1,-1,"A"
NA,1979,"Scarborough","Northwich Victoria","2-1",2,1,5,5,3,1,"H"
NA,1979,"Stafford Rangers","Northwich Victoria","4-1",4,1,5,5,5,3,"H"
NA,1979,"Telford United","Northwich Victoria","0-0",0,0,5,5,0,0,"D"
NA,1979,"Wealdstone","Northwich Victoria","0-1",0,1,5,5,1,-1,"A"
NA,1979,"Weymouth","Northwich Victoria","2-0",2,0,5,5,2,2,"H"
NA,1979,"Worcester City","Northwich Victoria","2-1",2,1,5,5,3,1,"H"
NA,1979,"Yeovil","Northwich Victoria","1-1",1,1,5,5,2,0,"D"
NA,1979,"Altrincham","Nuneaton Town","3-1",3,1,5,5,4,2,"H"
NA,1979,"AP Leamington","Nuneaton Town","0-0",0,0,5,5,0,0,"D"
NA,1979,"Bangor City","Nuneaton Town","1-0",1,0,5,5,1,1,"H"
NA,1979,"Barnet","Nuneaton Town","2-1",2,1,5,5,3,1,"H"
NA,1979,"Barrow","Nuneaton Town","1-0",1,0,5,5,1,1,"H"
NA,1979,"Bath City","Nuneaton Town","1-1",1,1,5,5,2,0,"D"
NA,1979,"Boston United","Nuneaton Town","2-2",2,2,5,5,4,0,"D"
NA,1979,"Ebbsfleet United","Nuneaton Town","2-2",2,2,5,5,4,0,"D"
NA,1979,"Kettering Town","Nuneaton Town","1-1",1,1,5,5,2,0,"D"
NA,1979,"Maidstone United","Nuneaton Town","1-1",1,1,5,5,2,0,"D"
NA,1979,"Northwich Victoria","Nuneaton Town","2-1",2,1,5,5,3,1,"H"
NA,1979,"Redditch United","Nuneaton Town","1-0",1,0,5,5,1,1,"H"
NA,1979,"Scarborough","Nuneaton Town","2-1",2,1,5,5,3,1,"H"
NA,1979,"Stafford Rangers","Nuneaton Town","0-1",0,1,5,5,1,-1,"A"
NA,1979,"Telford United","Nuneaton Town","2-1",2,1,5,5,3,1,"H"
NA,1979,"Wealdstone","Nuneaton Town","2-2",2,2,5,5,4,0,"D"
NA,1979,"Weymouth","Nuneaton Town","2-0",2,0,5,5,2,2,"H"
NA,1979,"Worcester City","Nuneaton Town","1-1",1,1,5,5,2,0,"D"
NA,1979,"Yeovil","Nuneaton Town","2-1",2,1,5,5,3,1,"H"
NA,1979,"Altrincham","Redditch United","2-0",2,0,5,5,2,2,"H"
NA,1979,"AP Leamington","Redditch United","0-2",0,2,5,5,2,-2,"A"
NA,1979,"Bangor City","Redditch United","1-0",1,0,5,5,1,1,"H"
NA,1979,"Barnet","Redditch United","0-0",0,0,5,5,0,0,"D"
NA,1979,"Barrow","Redditch United","2-0",2,0,5,5,2,2,"H"
NA,1979,"Bath City","Redditch United","1-1",1,1,5,5,2,0,"D"
NA,1979,"Boston United","Redditch United","2-0",2,0,5,5,2,2,"H"
NA,1979,"Ebbsfleet United","Redditch United","1-0",1,0,5,5,1,1,"H"
NA,1979,"Kettering Town","Redditch United","2-1",2,1,5,5,3,1,"H"
NA,1979,"Maidstone United","Redditch United","4-1",4,1,5,5,5,3,"H"
NA,1979,"Northwich Victoria","Redditch United","1-0",1,0,5,5,1,1,"H"
NA,1979,"Nuneaton Town","Redditch United","5-1",5,1,5,5,6,4,"H"
NA,1979,"Scarborough","Redditch United","3-0",3,0,5,5,3,3,"H"
NA,1979,"Stafford Rangers","Redditch United","1-1",1,1,5,5,2,0,"D"
NA,1979,"Telford United","Redditch United","2-1",2,1,5,5,3,1,"H"
NA,1979,"Wealdstone","Redditch United","2-0",2,0,5,5,2,2,"H"
NA,1979,"Weymouth","Redditch United","6-0",6,0,5,5,6,6,"H"
NA,1979,"Worcester City","Redditch United","3-0",3,0,5,5,3,3,"H"
NA,1979,"Yeovil","Redditch United","2-0",2,0,5,5,2,2,"H"
NA,1979,"Altrincham","Scarborough","2-0",2,0,5,5,2,2,"H"
NA,1979,"AP Leamington","Scarborough","1-1",1,1,5,5,2,0,"D"
NA,1979,"Bangor City","Scarborough","1-0",1,0,5,5,1,1,"H"
NA,1979,"Barnet","Scarborough","0-0",0,0,5,5,0,0,"D"
NA,1979,"Barrow","Scarborough","0-0",0,0,5,5,0,0,"D"
NA,1979,"Bath City","Scarborough","1-0",1,0,5,5,1,1,"H"
NA,1979,"Boston United","Scarborough","2-2",2,2,5,5,4,0,"D"
NA,1979,"Ebbsfleet United","Scarborough","3-0",3,0,5,5,3,3,"H"
NA,1979,"Kettering Town","Scarborough","1-0",1,0,5,5,1,1,"H"
NA,1979,"Maidstone United","Scarborough","2-0",2,0,5,5,2,2,"H"
NA,1979,"Northwich Victoria","Scarborough","1-1",1,1,5,5,2,0,"D"
NA,1979,"Nuneaton Town","Scarborough","3-1",3,1,5,5,4,2,"H"
NA,1979,"Redditch United","Scarborough","1-2",1,2,5,5,3,-1,"A"
NA,1979,"Stafford Rangers","Scarborough","3-1",3,1,5,5,4,2,"H"
NA,1979,"Telford United","Scarborough","0-1",0,1,5,5,1,-1,"A"
NA,1979,"Wealdstone","Scarborough","2-4",2,4,5,5,6,-2,"A"
NA,1979,"Weymouth","Scarborough","0-1",0,1,5,5,1,-1,"A"
NA,1979,"Worcester City","Scarborough","0-0",0,0,5,5,0,0,"D"
NA,1979,"Yeovil","Scarborough","1-1",1,1,5,5,2,0,"D"
NA,1979,"Altrincham","Stafford Rangers","3-1",3,1,5,5,4,2,"H"
NA,1979,"AP Leamington","Stafford Rangers","2-0",2,0,5,5,2,2,"H"
NA,1979,"Bangor City","Stafford Rangers","1-1",1,1,5,5,2,0,"D"
NA,1979,"Barnet","Stafford Rangers","2-1",2,1,5,5,3,1,"H"
NA,1979,"Barrow","Stafford Rangers","2-1",2,1,5,5,3,1,"H"
NA,1979,"Bath City","Stafford Rangers","2-1",2,1,5,5,3,1,"H"
NA,1979,"Boston United","Stafford Rangers","3-2",3,2,5,5,5,1,"H"
NA,1979,"Ebbsfleet United","Stafford Rangers","2-0",2,0,5,5,2,2,"H"
NA,1979,"Kettering Town","Stafford Rangers","3-6",3,6,5,5,9,-3,"A"
NA,1979,"Maidstone United","Stafford Rangers","2-0",2,0,5,5,2,2,"H"
NA,1979,"Northwich Victoria","Stafford Rangers","1-0",1,0,5,5,1,1,"H"
NA,1979,"Nuneaton Town","Stafford Rangers","3-1",3,1,5,5,4,2,"H"
NA,1979,"Redditch United","Stafford Rangers","0-2",0,2,5,5,2,-2,"A"
NA,1979,"Scarborough","Stafford Rangers","0-0",0,0,5,5,0,0,"D"
NA,1979,"Telford United","Stafford Rangers","2-2",2,2,5,5,4,0,"D"
NA,1979,"Wealdstone","Stafford Rangers","2-1",2,1,5,5,3,1,"H"
NA,1979,"Weymouth","Stafford Rangers","2-1",2,1,5,5,3,1,"H"
NA,1979,"Worcester City","Stafford Rangers","1-0",1,0,5,5,1,1,"H"
NA,1979,"Yeovil","Stafford Rangers","3-1",3,1,5,5,4,2,"H"
NA,1979,"Altrincham","Telford United","2-0",2,0,5,5,2,2,"H"
NA,1979,"AP Leamington","Telford United","2-1",2,1,5,5,3,1,"H"
NA,1979,"Bangor City","Telford United","1-1",1,1,5,5,2,0,"D"
NA,1979,"Barnet","Telford United","4-1",4,1,5,5,5,3,"H"
NA,1979,"Barrow","Telford United","2-0",2,0,5,5,2,2,"H"
NA,1979,"Bath City","Telford United","1-1",1,1,5,5,2,0,"D"
NA,1979,"Boston United","Telford United","3-1",3,1,5,5,4,2,"H"
NA,1979,"Ebbsfleet United","Telford United","1-2",1,2,5,5,3,-1,"A"
NA,1979,"Kettering Town","Telford United","3-2",3,2,5,5,5,1,"H"
NA,1979,"Maidstone United","Telford United","3-0",3,0,5,5,3,3,"H"
NA,1979,"Northwich Victoria","Telford United","2-1",2,1,5,5,3,1,"H"
NA,1979,"Nuneaton Town","Telford United","1-1",1,1,5,5,2,0,"D"
NA,1979,"Redditch United","Telford United","2-2",2,2,5,5,4,0,"D"
NA,1979,"Scarborough","Telford United","1-2",1,2,5,5,3,-1,"A"
NA,1979,"Stafford Rangers","Telford United","0-1",0,1,5,5,1,-1,"A"
NA,1979,"Wealdstone","Telford United","0-0",0,0,5,5,0,0,"D"
NA,1979,"Weymouth","Telford United","3-2",3,2,5,5,5,1,"H"
NA,1979,"Worcester City","Telford United","2-1",2,1,5,5,3,1,"H"
NA,1979,"Yeovil","Telford United","0-2",0,2,5,5,2,-2,"A"
NA,1979,"Altrincham","Wealdstone","2-1",2,1,5,5,3,1,"H"
NA,1979,"AP Leamington","Wealdstone","0-0",0,0,5,5,0,0,"D"
NA,1979,"Bangor City","Wealdstone","1-0",1,0,5,5,1,1,"H"
NA,1979,"Barnet","Wealdstone","1-3",1,3,5,5,4,-2,"A"
NA,1979,"Barrow","Wealdstone","1-0",1,0,5,5,1,1,"H"
NA,1979,"Bath City","Wealdstone","4-4",4,4,5,5,8,0,"D"
NA,1979,"Boston United","Wealdstone","0-0",0,0,5,5,0,0,"D"
NA,1979,"Ebbsfleet United","Wealdstone","3-0",3,0,5,5,3,3,"H"
NA,1979,"Kettering Town","Wealdstone","2-0",2,0,5,5,2,2,"H"
NA,1979,"Maidstone United","Wealdstone","3-0",3,0,5,5,3,3,"H"
NA,1979,"Northwich Victoria","Wealdstone","0-0",0,0,5,5,0,0,"D"
NA,1979,"Nuneaton Town","Wealdstone","0-1",0,1,5,5,1,-1,"A"
NA,1979,"Redditch United","Wealdstone","4-1",4,1,5,5,5,3,"H"
NA,1979,"Scarborough","Wealdstone","0-0",0,0,5,5,0,0,"D"
NA,1979,"Stafford Rangers","Wealdstone","0-1",0,1,5,5,1,-1,"A"
NA,1979,"Telford United","Wealdstone","1-3",1,3,5,5,4,-2,"A"
NA,1979,"Weymouth","Wealdstone","4-0",4,0,5,5,4,4,"H"
NA,1979,"Worcester City","Wealdstone","2-1",2,1,5,5,3,1,"H"
NA,1979,"Yeovil","Wealdstone","1-1",1,1,5,5,2,0,"D"
NA,1979,"Altrincham","Weymouth","3-2",3,2,5,5,5,1,"H"
NA,1979,"AP Leamington","Weymouth","0-2",0,2,5,5,2,-2,"A"
NA,1979,"Bangor City","Weymouth","1-2",1,2,5,5,3,-1,"A"
NA,1979,"Barnet","Weymouth","0-2",0,2,5,5,2,-2,"A"
NA,1979,"Barrow","Weymouth","0-1",0,1,5,5,1,-1,"A"
NA,1979,"Bath City","Weymouth","4-2",4,2,5,5,6,2,"H"
NA,1979,"Boston United","Weymouth","2-2",2,2,5,5,4,0,"D"
NA,1979,"Ebbsfleet United","Weymouth","2-3",2,3,5,5,5,-1,"A"
NA,1979,"Kettering Town","Weymouth","3-1",3,1,5,5,4,2,"H"
NA,1979,"Maidstone United","Weymouth","1-1",1,1,5,5,2,0,"D"
NA,1979,"Northwich Victoria","Weymouth","0-0",0,0,5,5,0,0,"D"
NA,1979,"Nuneaton Town","Weymouth","1-2",1,2,5,5,3,-1,"A"
NA,1979,"Redditch United","Weymouth","0-2",0,2,5,5,2,-2,"A"
NA,1979,"Scarborough","Weymouth","0-0",0,0,5,5,0,0,"D"
NA,1979,"Stafford Rangers","Weymouth","1-5",1,5,5,5,6,-4,"A"
NA,1979,"Telford United","Weymouth","3-3",3,3,5,5,6,0,"D"
NA,1979,"Wealdstone","Weymouth","1-1",1,1,5,5,2,0,"D"
NA,1979,"Worcester City","Weymouth","1-1",1,1,5,5,2,0,"D"
NA,1979,"Yeovil","Weymouth","0-1",0,1,5,5,1,-1,"A"
NA,1979,"Altrincham","Worcester City","3-1",3,1,5,5,4,2,"H"
NA,1979,"AP Leamington","Worcester City","1-0",1,0,5,5,1,1,"H"
NA,1979,"Bangor City","Worcester City","0-2",0,2,5,5,2,-2,"A"
NA,1979,"Barnet","Worcester City","0-0",0,0,5,5,0,0,"D"
NA,1979,"Barrow","Worcester City","1-2",1,2,5,5,3,-1,"A"
NA,1979,"Bath City","Worcester City","0-4",0,4,5,5,4,-4,"A"
NA,1979,"Boston United","Worcester City","1-1",1,1,5,5,2,0,"D"
NA,1979,"Ebbsfleet United","Worcester City","3-2",3,2,5,5,5,1,"H"
NA,1979,"Kettering Town","Worcester City","0-0",0,0,5,5,0,0,"D"
NA,1979,"Maidstone United","Worcester City","2-1",2,1,5,5,3,1,"H"
NA,1979,"Northwich Victoria","Worcester City","1-0",1,0,5,5,1,1,"H"
NA,1979,"Nuneaton Town","Worcester City","1-0",1,0,5,5,1,1,"H"
NA,1979,"Redditch United","Worcester City","1-1",1,1,5,5,2,0,"D"
NA,1979,"Scarborough","Worcester City","4-1",4,1,5,5,5,3,"H"
NA,1979,"Stafford Rangers","Worcester City","0-0",0,0,5,5,0,0,"D"
NA,1979,"Telford United","Worcester City","0-1",0,1,5,5,1,-1,"A"
NA,1979,"Wealdstone","Worcester City","2-4",2,4,5,5,6,-2,"A"
NA,1979,"Weymouth","Worcester City","1-2",1,2,5,5,3,-1,"A"
NA,1979,"Yeovil","Worcester City","0-2",0,2,5,5,2,-2,"A"
NA,1979,"Altrincham","Yeovil","1-1",1,1,5,5,2,0,"D"
NA,1979,"AP Leamington","Yeovil","0-4",0,4,5,5,4,-4,"A"
NA,1979,"Bangor City","Yeovil","1-0",1,0,5,5,1,1,"H"
NA,1979,"Barnet","Yeovil","0-3",0,3,5,5,3,-3,"A"
NA,1979,"Barrow","Yeovil","2-0",2,0,5,5,2,2,"H"
NA,1979,"Bath City","Yeovil","1-1",1,1,5,5,2,0,"D"
NA,1979,"Boston United","Yeovil","3-0",3,0,5,5,3,3,"H"
NA,1979,"Ebbsfleet United","Yeovil","2-0",2,0,5,5,2,2,"H"
NA,1979,"Kettering Town","Yeovil","5-3",5,3,5,5,8,2,"H"
NA,1979,"Maidstone United","Yeovil","0-1",0,1,5,5,1,-1,"A"
NA,1979,"Northwich Victoria","Yeovil","0-1",0,1,5,5,1,-1,"A"
NA,1979,"Nuneaton Town","Yeovil","3-0",3,0,5,5,3,3,"H"
NA,1979,"Redditch United","Yeovil","2-2",2,2,5,5,4,0,"D"
NA,1979,"Scarborough","Yeovil","0-0",0,0,5,5,0,0,"D"
NA,1979,"Stafford Rangers","Yeovil","2-1",2,1,5,5,3,1,"H"
NA,1979,"Telford United","Yeovil","0-3",0,3,5,5,3,-3,"A"
NA,1979,"Wealdstone","Yeovil","5-0",5,0,5,5,5,5,"H"
NA,1979,"Weymouth","Yeovil","3-0",3,0,5,5,3,3,"H"
NA,1979,"Worcester City","Yeovil","2-0",2,0,5,5,2,2,"H"
NA,1980,"AP Leamington","Altrincham","2-4",2,4,5,5,6,-2,"A"
NA,1980,"Bangor City","Altrincham","4-5",4,5,5,5,9,-1,"A"
NA,1980,"Barnet","Altrincham","3-2",3,2,5,5,5,1,"H"
NA,1980,"Barrow","Altrincham","0-4",0,4,5,5,4,-4,"A"
NA,1980,"Bath City","Altrincham","0-1",0,1,5,5,1,-1,"A"
NA,1980,"Boston United","Altrincham","1-1",1,1,5,5,2,0,"D"
NA,1980,"Frickley Athletic","Altrincham","0-2",0,2,5,5,2,-2,"A"
NA,1980,"Ebbsfleet United","Altrincham","0-2",0,2,5,5,2,-2,"A"
NA,1980,"Kettering Town","Altrincham","1-1",1,1,5,5,2,0,"D"
NA,1980,"Maidstone United","Altrincham","1-2",1,2,5,5,3,-1,"A"
NA,1980,"Northwich Victoria","Altrincham","1-0",1,0,5,5,1,1,"H"
NA,1980,"Nuneaton Town","Altrincham","0-0",0,0,5,5,0,0,"D"
NA,1980,"Scarborough","Altrincham","1-0",1,0,5,5,1,1,"H"
NA,1980,"Stafford Rangers","Altrincham","1-3",1,3,5,5,4,-2,"A"
NA,1980,"Telford United","Altrincham","3-2",3,2,5,5,5,1,"H"
NA,1980,"Wealdstone","Altrincham","1-2",1,2,5,5,3,-1,"A"
NA,1980,"Weymouth","Altrincham","0-0",0,0,5,5,0,0,"D"
NA,1980,"Worcester City","Altrincham","0-0",0,0,5,5,0,0,"D"
NA,1980,"Yeovil","Altrincham","1-1",1,1,5,5,2,0,"D"
NA,1980,"Altrincham","AP Leamington","4-1",4,1,5,5,5,3,"H"
NA,1980,"Bangor City","AP Leamington","1-0",1,0,5,5,1,1,"H"
NA,1980,"Barnet","AP Leamington","1-0",1,0,5,5,1,1,"H"
NA,1980,"Barrow","AP Leamington","0-2",0,2,5,5,2,-2,"A"
NA,1980,"Bath City","AP Leamington","5-0",5,0,5,5,5,5,"H"
NA,1980,"Boston United","AP Leamington","2-3",2,3,5,5,5,-1,"A"
NA,1980,"Frickley Athletic","AP Leamington","0-0",0,0,5,5,0,0,"D"
NA,1980,"Ebbsfleet United","AP Leamington","4-0",4,0,5,5,4,4,"H"
NA,1980,"Kettering Town","AP Leamington","3-0",3,0,5,5,3,3,"H"
NA,1980,"Maidstone United","AP Leamington","2-1",2,1,5,5,3,1,"H"
NA,1980,"Northwich Victoria","AP Leamington","2-0",2,0,5,5,2,2,"H"
NA,1980,"Nuneaton Town","AP Leamington","3-0",3,0,5,5,3,3,"H"
NA,1980,"Scarborough","AP Leamington","0-0",0,0,5,5,0,0,"D"
NA,1980,"Stafford Rangers","AP Leamington","1-1",1,1,5,5,2,0,"D"
NA,1980,"Telford United","AP Leamington","2-3",2,3,5,5,5,-1,"A"
NA,1980,"Wealdstone","AP Leamington","1-2",1,2,5,5,3,-1,"A"
NA,1980,"Weymouth","AP Leamington","3-2",3,2,5,5,5,1,"H"
NA,1980,"Worcester City","AP Leamington","3-3",3,3,5,5,6,0,"D"
NA,1980,"Yeovil","AP Leamington","3-0",3,0,5,5,3,3,"H"
NA,1980,"Altrincham","Bangor City","2-0",2,0,5,5,2,2,"H"
NA,1980,"AP Leamington","Bangor City","1-0",1,0,5,5,1,1,"H"
NA,1980,"Barnet","Bangor City","0-1",0,1,5,5,1,-1,"A"
NA,1980,"Barrow","Bangor City","3-0",3,0,5,5,3,3,"H"
NA,1980,"Bath City","Bangor City","0-0",0,0,5,5,0,0,"D"
NA,1980,"Boston United","Bangor City","1-1",1,1,5,5,2,0,"D"
NA,1980,"Frickley Athletic","Bangor City","4-0",4,0,5,5,4,4,"H"
NA,1980,"Ebbsfleet United","Bangor City","1-0",1,0,5,5,1,1,"H"
NA,1980,"Kettering Town","Bangor City","3-1",3,1,5,5,4,2,"H"
NA,1980,"Maidstone United","Bangor City","1-0",1,0,5,5,1,1,"H"
NA,1980,"Northwich Victoria","Bangor City","2-1",2,1,5,5,3,1,"H"
NA,1980,"Nuneaton Town","Bangor City","3-2",3,2,5,5,5,1,"H"
NA,1980,"Scarborough","Bangor City","1-1",1,1,5,5,2,0,"D"
NA,1980,"Stafford Rangers","Bangor City","4-0",4,0,5,5,4,4,"H"
NA,1980,"Telford United","Bangor City","1-1",1,1,5,5,2,0,"D"
NA,1980,"Wealdstone","Bangor City","1-1",1,1,5,5,2,0,"D"
NA,1980,"Weymouth","Bangor City","4-0",4,0,5,5,4,4,"H"
NA,1980,"Worcester City","Bangor City","1-1",1,1,5,5,2,0,"D"
NA,1980,"Yeovil","Bangor City","1-0",1,0,5,5,1,1,"H"
NA,1980,"Altrincham","Barnet","2-0",2,0,5,5,2,2,"H"
NA,1980,"AP Leamington","Barnet","0-1",0,1,5,5,1,-1,"A"
NA,1980,"Bangor City","Barnet","4-2",4,2,5,5,6,2,"H"
NA,1980,"Barrow","Barnet","1-1",1,1,5,5,2,0,"D"
NA,1980,"Bath City","Barnet","1-0",1,0,5,5,1,1,"H"
NA,1980,"Boston United","Barnet","3-0",3,0,5,5,3,3,"H"
NA,1980,"Frickley Athletic","Barnet","3-0",3,0,5,5,3,3,"H"
NA,1980,"Ebbsfleet United","Barnet","0-2",0,2,5,5,2,-2,"A"
NA,1980,"Kettering Town","Barnet","2-1",2,1,5,5,3,1,"H"
NA,1980,"Maidstone United","Barnet","4-1",4,1,5,5,5,3,"H"
NA,1980,"Northwich Victoria","Barnet","4-1",4,1,5,5,5,3,"H"
NA,1980,"Nuneaton Town","Barnet","0-1",0,1,5,5,1,-1,"A"
NA,1980,"Scarborough","Barnet","3-0",3,0,5,5,3,3,"H"
NA,1980,"Stafford Rangers","Barnet","1-0",1,0,5,5,1,1,"H"
NA,1980,"Telford United","Barnet","0-0",0,0,5,5,0,0,"D"
NA,1980,"Wealdstone","Barnet","2-0",2,0,5,5,2,2,"H"
NA,1980,"Weymouth","Barnet","3-0",3,0,5,5,3,3,"H"
NA,1980,"Worcester City","Barnet","4-0",4,0,5,5,4,4,"H"
NA,1980,"Yeovil","Barnet","1-2",1,2,5,5,3,-1,"A"
NA,1980,"Altrincham","Barrow","2-2",2,2,5,5,4,0,"D"
NA,1980,"AP Leamington","Barrow","2-2",2,2,5,5,4,0,"D"
NA,1980,"Bangor City","Barrow","2-6",2,6,5,5,8,-4,"A"
NA,1980,"Barnet","Barrow","0-0",0,0,5,5,0,0,"D"
NA,1980,"Bath City","Barrow","2-1",2,1,5,5,3,1,"H"
NA,1980,"Boston United","Barrow","0-2",0,2,5,5,2,-2,"A"
NA,1980,"Frickley Athletic","Barrow","5-0",5,0,5,5,5,5,"H"
NA,1980,"Ebbsfleet United","Barrow","0-2",0,2,5,5,2,-2,"A"
NA,1980,"Kettering Town","Barrow","0-1",0,1,5,5,1,-1,"A"
NA,1980,"Maidstone United","Barrow","1-0",1,0,5,5,1,1,"H"
NA,1980,"Northwich Victoria","Barrow","0-0",0,0,5,5,0,0,"D"
NA,1980,"Nuneaton Town","Barrow","3-1",3,1,5,5,4,2,"H"
NA,1980,"Scarborough","Barrow","0-0",0,0,5,5,0,0,"D"
NA,1980,"Stafford Rangers","Barrow","1-0",1,0,5,5,1,1,"H"
NA,1980,"Telford United","Barrow","5-2",5,2,5,5,7,3,"H"
NA,1980,"Wealdstone","Barrow","2-0",2,0,5,5,2,2,"H"
NA,1980,"Weymouth","Barrow","2-1",2,1,5,5,3,1,"H"
NA,1980,"Worcester City","Barrow","2-4",2,4,5,5,6,-2,"A"
NA,1980,"Yeovil","Barrow","2-1",2,1,5,5,3,1,"H"
NA,1980,"Altrincham","Bath City","3-1",3,1,5,5,4,2,"H"
NA,1980,"AP Leamington","Bath City","0-4",0,4,5,5,4,-4,"A"
NA,1980,"Bangor City","Bath City","0-1",0,1,5,5,1,-1,"A"
NA,1980,"Barnet","Bath City","1-5",1,5,5,5,6,-4,"A"
NA,1980,"Barrow","Bath City","0-0",0,0,5,5,0,0,"D"
NA,1980,"Boston United","Bath City","4-2",4,2,5,5,6,2,"H"
NA,1980,"Frickley Athletic","Bath City","2-1",2,1,5,5,3,1,"H"
NA,1980,"Ebbsfleet United","Bath City","2-1",2,1,5,5,3,1,"H"
NA,1980,"Kettering Town","Bath City","2-2",2,2,5,5,4,0,"D"
NA,1980,"Maidstone United","Bath City","2-1",2,1,5,5,3,1,"H"
NA,1980,"Northwich Victoria","Bath City","3-1",3,1,5,5,4,2,"H"
NA,1980,"Nuneaton Town","Bath City","0-0",0,0,5,5,0,0,"D"
NA,1980,"Scarborough","Bath City","1-0",1,0,5,5,1,1,"H"
NA,1980,"Stafford Rangers","Bath City","0-2",0,2,5,5,2,-2,"A"
NA,1980,"Telford United","Bath City","2-1",2,1,5,5,3,1,"H"
NA,1980,"Wealdstone","Bath City","0-1",0,1,5,5,1,-1,"A"
NA,1980,"Weymouth","Bath City","1-1",1,1,5,5,2,0,"D"
NA,1980,"Worcester City","Bath City","0-2",0,2,5,5,2,-2,"A"
NA,1980,"Yeovil","Bath City","1-2",1,2,5,5,3,-1,"A"
NA,1980,"Altrincham","Boston United","2-0",2,0,5,5,2,2,"H"
NA,1980,"AP Leamington","Boston United","0-0",0,0,5,5,0,0,"D"
NA,1980,"Bangor City","Boston United","1-1",1,1,5,5,2,0,"D"
NA,1980,"Barnet","Boston United","2-2",2,2,5,5,4,0,"D"
NA,1980,"Barrow","Boston United","0-2",0,2,5,5,2,-2,"A"
NA,1980,"Bath City","Boston United","2-0",2,0,5,5,2,2,"H"
NA,1980,"Frickley Athletic","Boston United","0-1",0,1,5,5,1,-1,"A"
NA,1980,"Ebbsfleet United","Boston United","1-2",1,2,5,5,3,-1,"A"
NA,1980,"Kettering Town","Boston United","0-0",0,0,5,5,0,0,"D"
NA,1980,"Maidstone United","Boston United","2-2",2,2,5,5,4,0,"D"
NA,1980,"Northwich Victoria","Boston United","3-1",3,1,5,5,4,2,"H"
NA,1980,"Nuneaton Town","Boston United","0-2",0,2,5,5,2,-2,"A"
NA,1980,"Scarborough","Boston United","3-2",3,2,5,5,5,1,"H"
NA,1980,"Stafford Rangers","Boston United","2-3",2,3,5,5,5,-1,"A"
NA,1980,"Telford United","Boston United","2-0",2,0,5,5,2,2,"H"
NA,1980,"Wealdstone","Boston United","3-0",3,0,5,5,3,3,"H"
NA,1980,"Weymouth","Boston United","2-1",2,1,5,5,3,1,"H"
NA,1980,"Worcester City","Boston United","1-4",1,4,5,5,5,-3,"A"
NA,1980,"Yeovil","Boston United","2-1",2,1,5,5,3,1,"H"
NA,1980,"Altrincham","Frickley Athletic","2-0",2,0,5,5,2,2,"H"
NA,1980,"AP Leamington","Frickley Athletic","2-2",2,2,5,5,4,0,"D"
NA,1980,"Bangor City","Frickley Athletic","4-3",4,3,5,5,7,1,"H"
NA,1980,"Barnet","Frickley Athletic","2-0",2,0,5,5,2,2,"H"
NA,1980,"Barrow","Frickley Athletic","0-0",0,0,5,5,0,0,"D"
NA,1980,"Bath City","Frickley Athletic","3-0",3,0,5,5,3,3,"H"
NA,1980,"Boston United","Frickley Athletic","1-2",1,2,5,5,3,-1,"A"
NA,1980,"Ebbsfleet United","Frickley Athletic","3-1",3,1,5,5,4,2,"H"
NA,1980,"Kettering Town","Frickley Athletic","6-1",6,1,5,5,7,5,"H"
NA,1980,"Maidstone United","Frickley Athletic","1-1",1,1,5,5,2,0,"D"
NA,1980,"Northwich Victoria","Frickley Athletic","1-3",1,3,5,5,4,-2,"A"
NA,1980,"Nuneaton Town","Frickley Athletic","0-1",0,1,5,5,1,-1,"A"
NA,1980,"Scarborough","Frickley Athletic","2-1",2,1,5,5,3,1,"H"
NA,1980,"Stafford Rangers","Frickley Athletic","3-3",3,3,5,5,6,0,"D"
NA,1980,"Telford United","Frickley Athletic","1-0",1,0,5,5,1,1,"H"
NA,1980,"Wealdstone","Frickley Athletic","0-2",0,2,5,5,2,-2,"A"
NA,1980,"Weymouth","Frickley Athletic","1-2",1,2,5,5,3,-1,"A"
NA,1980,"Worcester City","Frickley Athletic","3-0",3,0,5,5,3,3,"H"
NA,1980,"Yeovil","Frickley Athletic","5-3",5,3,5,5,8,2,"H"
NA,1980,"Altrincham","Ebbsfleet United","2-1",2,1,5,5,3,1,"H"
NA,1980,"AP Leamington","Ebbsfleet United","4-1",4,1,5,5,5,3,"H"
NA,1980,"Bangor City","Ebbsfleet United","1-1",1,1,5,5,2,0,"D"
NA,1980,"Barnet","Ebbsfleet United","1-1",1,1,5,5,2,0,"D"
NA,1980,"Barrow","Ebbsfleet United","3-1",3,1,5,5,4,2,"H"
NA,1980,"Bath City","Ebbsfleet United","1-0",1,0,5,5,1,1,"H"
NA,1980,"Boston United","Ebbsfleet United","2-1",2,1,5,5,3,1,"H"
NA,1980,"Frickley Athletic","Ebbsfleet United","2-4",2,4,5,5,6,-2,"A"
NA,1980,"Kettering Town","Ebbsfleet United","2-0",2,0,5,5,2,2,"H"
NA,1980,"Maidstone United","Ebbsfleet United","1-1",1,1,5,5,2,0,"D"
NA,1980,"Northwich Victoria","Ebbsfleet United","4-0",4,0,5,5,4,4,"H"
NA,1980,"Nuneaton Town","Ebbsfleet United","1-2",1,2,5,5,3,-1,"A"
NA,1980,"Scarborough","Ebbsfleet United","1-0",1,0,5,5,1,1,"H"
NA,1980,"Stafford Rangers","Ebbsfleet United","2-3",2,3,5,5,5,-1,"A"
NA,1980,"Telford United","Ebbsfleet United","0-0",0,0,5,5,0,0,"D"
NA,1980,"Wealdstone","Ebbsfleet United","3-1",3,1,5,5,4,2,"H"
NA,1980,"Weymouth","Ebbsfleet United","0-1",0,1,5,5,1,-1,"A"
NA,1980,"Worcester City","Ebbsfleet United","3-1",3,1,5,5,4,2,"H"
NA,1980,"Yeovil","Ebbsfleet United","1-3",1,3,5,5,4,-2,"A"
NA,1980,"Altrincham","Kettering Town","4-1",4,1,5,5,5,3,"H"
NA,1980,"AP Leamington","Kettering Town","3-3",3,3,5,5,6,0,"D"
NA,1980,"Bangor City","Kettering Town","0-1",0,1,5,5,1,-1,"A"
NA,1980,"Barnet","Kettering Town","0-1",0,1,5,5,1,-1,"A"
NA,1980,"Barrow","Kettering Town","2-1",2,1,5,5,3,1,"H"
NA,1980,"Bath City","Kettering Town","0-0",0,0,5,5,0,0,"D"
NA,1980,"Boston United","Kettering Town","2-1",2,1,5,5,3,1,"H"
NA,1980,"Frickley Athletic","Kettering Town","1-1",1,1,5,5,2,0,"D"
NA,1980,"Ebbsfleet United","Kettering Town","1-0",1,0,5,5,1,1,"H"
NA,1980,"Maidstone United","Kettering Town","1-2",1,2,5,5,3,-1,"A"
NA,1980,"Northwich Victoria","Kettering Town","1-1",1,1,5,5,2,0,"D"
NA,1980,"Nuneaton Town","Kettering Town","1-5",1,5,5,5,6,-4,"A"
NA,1980,"Scarborough","Kettering Town","1-2",1,2,5,5,3,-1,"A"
NA,1980,"Stafford Rangers","Kettering Town","3-1",3,1,5,5,4,2,"H"
NA,1980,"Telford United","Kettering Town","0-2",0,2,5,5,2,-2,"A"
NA,1980,"Wealdstone","Kettering Town","1-1",1,1,5,5,2,0,"D"
NA,1980,"Weymouth","Kettering Town","1-2",1,2,5,5,3,-1,"A"
NA,1980,"Worcester City","Kettering Town","2-1",2,1,5,5,3,1,"H"
NA,1980,"Yeovil","Kettering Town","1-2",1,2,5,5,3,-1,"A"
NA,1980,"Altrincham","Maidstone United","2-1",2,1,5,5,3,1,"H"
NA,1980,"AP Leamington","Maidstone United","2-3",2,3,5,5,5,-1,"A"
NA,1980,"Bangor City","Maidstone United","1-1",1,1,5,5,2,0,"D"
NA,1980,"Barnet","Maidstone United","4-1",4,1,5,5,5,3,"H"
NA,1980,"Barrow","Maidstone United","4-1",4,1,5,5,5,3,"H"
NA,1980,"Bath City","Maidstone United","0-0",0,0,5,5,0,0,"D"
NA,1980,"Boston United","Maidstone United","1-1",1,1,5,5,2,0,"D"
NA,1980,"Frickley Athletic","Maidstone United","2-1",2,1,5,5,3,1,"H"
NA,1980,"Ebbsfleet United","Maidstone United","1-2",1,2,5,5,3,-1,"A"
NA,1980,"Kettering Town","Maidstone United","3-0",3,0,5,5,3,3,"H"
NA,1980,"Northwich Victoria","Maidstone United","2-1",2,1,5,5,3,1,"H"
NA,1980,"Nuneaton Town","Maidstone United","1-1",1,1,5,5,2,0,"D"
NA,1980,"Scarborough","Maidstone United","1-2",1,2,5,5,3,-1,"A"
NA,1980,"Stafford Rangers","Maidstone United","3-1",3,1,5,5,4,2,"H"
NA,1980,"Telford United","Maidstone United","1-2",1,2,5,5,3,-1,"A"
NA,1980,"Wealdstone","Maidstone United","2-1",2,1,5,5,3,1,"H"
NA,1980,"Weymouth","Maidstone United","1-1",1,1,5,5,2,0,"D"
NA,1980,"Worcester City","Maidstone United","2-1",2,1,5,5,3,1,"H"
NA,1980,"Yeovil","Maidstone United","2-1",2,1,5,5,3,1,"H"
NA,1980,"Altrincham","Northwich Victoria","1-1",1,1,5,5,2,0,"D"
NA,1980,"AP Leamington","Northwich Victoria","1-1",1,1,5,5,2,0,"D"
NA,1980,"Bangor City","Northwich Victoria","0-0",0,0,5,5,0,0,"D"
NA,1980,"Barnet","Northwich Victoria","1-0",1,0,5,5,1,1,"H"
NA,1980,"Barrow","Northwich Victoria","2-1",2,1,5,5,3,1,"H"
NA,1980,"Bath City","Northwich Victoria","0-0",0,0,5,5,0,0,"D"
NA,1980,"Boston United","Northwich Victoria","2-3",2,3,5,5,5,-1,"A"
NA,1980,"Frickley Athletic","Northwich Victoria","0-1",0,1,5,5,1,-1,"A"
NA,1980,"Ebbsfleet United","Northwich Victoria","0-1",0,1,5,5,1,-1,"A"
NA,1980,"Kettering Town","Northwich Victoria","3-3",3,3,5,5,6,0,"D"
NA,1980,"Maidstone United","Northwich Victoria","4-0",4,0,5,5,4,4,"H"
NA,1980,"Nuneaton Town","Northwich Victoria","2-0",2,0,5,5,2,2,"H"
NA,1980,"Scarborough","Northwich Victoria","0-0",0,0,5,5,0,0,"D"
NA,1980,"Stafford Rangers","Northwich Victoria","2-0",2,0,5,5,2,2,"H"
NA,1980,"Telford United","Northwich Victoria","1-3",1,3,5,5,4,-2,"A"
NA,1980,"Wealdstone","Northwich Victoria","1-1",1,1,5,5,2,0,"D"
NA,1980,"Weymouth","Northwich Victoria","4-3",4,3,5,5,7,1,"H"
NA,1980,"Worcester City","Northwich Victoria","2-1",2,1,5,5,3,1,"H"
NA,1980,"Yeovil","Northwich Victoria","1-2",1,2,5,5,3,-1,"A"
NA,1980,"Altrincham","Nuneaton Town","0-3",0,3,5,5,3,-3,"A"
NA,1980,"AP Leamington","Nuneaton Town","0-1",0,1,5,5,1,-1,"A"
NA,1980,"Bangor City","Nuneaton Town","2-5",2,5,5,5,7,-3,"A"
NA,1980,"Barnet","Nuneaton Town","1-0",1,0,5,5,1,1,"H"
NA,1980,"Barrow","Nuneaton Town","1-0",1,0,5,5,1,1,"H"
NA,1980,"Bath City","Nuneaton Town","0-0",0,0,5,5,0,0,"D"
NA,1980,"Boston United","Nuneaton Town","3-1",3,1,5,5,4,2,"H"
NA,1980,"Frickley Athletic","Nuneaton Town","4-3",4,3,5,5,7,1,"H"
NA,1980,"Ebbsfleet United","Nuneaton Town","4-0",4,0,5,5,4,4,"H"
NA,1980,"Kettering Town","Nuneaton Town","3-0",3,0,5,5,3,3,"H"
NA,1980,"Maidstone United","Nuneaton Town","1-3",1,3,5,5,4,-2,"A"
NA,1980,"Northwich Victoria","Nuneaton Town","2-0",2,0,5,5,2,2,"H"
NA,1980,"Scarborough","Nuneaton Town","2-1",2,1,5,5,3,1,"H"
NA,1980,"Stafford Rangers","Nuneaton Town","2-2",2,2,5,5,4,0,"D"
NA,1980,"Telford United","Nuneaton Town","2-2",2,2,5,5,4,0,"D"
NA,1980,"Wealdstone","Nuneaton Town","0-0",0,0,5,5,0,0,"D"
NA,1980,"Weymouth","Nuneaton Town","1-0",1,0,5,5,1,1,"H"
NA,1980,"Worcester City","Nuneaton Town","1-0",1,0,5,5,1,1,"H"
NA,1980,"Yeovil","Nuneaton Town","5-1",5,1,5,5,6,4,"H"
NA,1980,"Altrincham","Scarborough","4-3",4,3,5,5,7,1,"H"
NA,1980,"AP Leamington","Scarborough","2-0",2,0,5,5,2,2,"H"
NA,1980,"Bangor City","Scarborough","0-3",0,3,5,5,3,-3,"A"
NA,1980,"Barnet","Scarborough","1-2",1,2,5,5,3,-1,"A"
NA,1980,"Barrow","Scarborough","0-1",0,1,5,5,1,-1,"A"
NA,1980,"Bath City","Scarborough","0-1",0,1,5,5,1,-1,"A"
NA,1980,"Boston United","Scarborough","0-3",0,3,5,5,3,-3,"A"
NA,1980,"Frickley Athletic","Scarborough","1-0",1,0,5,5,1,1,"H"
NA,1980,"Ebbsfleet United","Scarborough","1-1",1,1,5,5,2,0,"D"
NA,1980,"Kettering Town","Scarborough","1-0",1,0,5,5,1,1,"H"
NA,1980,"Maidstone United","Scarborough","1-1",1,1,5,5,2,0,"D"
NA,1980,"Northwich Victoria","Scarborough","0-1",0,1,5,5,1,-1,"A"
NA,1980,"Nuneaton Town","Scarborough","0-4",0,4,5,5,4,-4,"A"
NA,1980,"Stafford Rangers","Scarborough","2-1",2,1,5,5,3,1,"H"
NA,1980,"Telford United","Scarborough","0-0",0,0,5,5,0,0,"D"
NA,1980,"Wealdstone","Scarborough","2-2",2,2,5,5,4,0,"D"
NA,1980,"Weymouth","Scarborough","1-1",1,1,5,5,2,0,"D"
NA,1980,"Worcester City","Scarborough","2-0",2,0,5,5,2,2,"H"
NA,1980,"Yeovil","Scarborough","0-0",0,0,5,5,0,0,"D"
NA,1980,"Altrincham","Stafford Rangers","4-2",4,2,5,5,6,2,"H"
NA,1980,"AP Leamington","Stafford Rangers","1-1",1,1,5,5,2,0,"D"
NA,1980,"Bangor City","Stafford Rangers","0-0",0,0,5,5,0,0,"D"
NA,1980,"Barnet","Stafford Rangers","1-1",1,1,5,5,2,0,"D"
NA,1980,"Barrow","Stafford Rangers","5-1",5,1,5,5,6,4,"H"
NA,1980,"Bath City","Stafford Rangers","0-0",0,0,5,5,0,0,"D"
NA,1980,"Boston United","Stafford Rangers","2-2",2,2,5,5,4,0,"D"
NA,1980,"Frickley Athletic","Stafford Rangers","3-2",3,2,5,5,5,1,"H"
NA,1980,"Ebbsfleet United","Stafford Rangers","1-1",1,1,5,5,2,0,"D"
NA,1980,"Kettering Town","Stafford Rangers","1-0",1,0,5,5,1,1,"H"
NA,1980,"Maidstone United","Stafford Rangers","4-1",4,1,5,5,5,3,"H"
NA,1980,"Northwich Victoria","Stafford Rangers","2-1",2,1,5,5,3,1,"H"
NA,1980,"Nuneaton Town","Stafford Rangers","2-2",2,2,5,5,4,0,"D"
NA,1980,"Scarborough","Stafford Rangers","0-0",0,0,5,5,0,0,"D"
NA,1980,"Telford United","Stafford Rangers","1-1",1,1,5,5,2,0,"D"
NA,1980,"Wealdstone","Stafford Rangers","1-1",1,1,5,5,2,0,"D"
NA,1980,"Weymouth","Stafford Rangers","2-1",2,1,5,5,3,1,"H"
NA,1980,"Worcester City","Stafford Rangers","1-1",1,1,5,5,2,0,"D"
NA,1980,"Yeovil","Stafford Rangers","3-4",3,4,5,5,7,-1,"A"
NA,1980,"Altrincham","Telford United","0-2",0,2,5,5,2,-2,"A"
NA,1980,"AP Leamington","Telford United","5-0",5,0,5,5,5,5,"H"
NA,1980,"Bangor City","Telford United","2-0",2,0,5,5,2,2,"H"
NA,1980,"Barnet","Telford United","2-1",2,1,5,5,3,1,"H"
NA,1980,"Barrow","Telford United","0-1",0,1,5,5,1,-1,"A"
NA,1980,"Bath City","Telford United","0-1",0,1,5,5,1,-1,"A"
NA,1980,"Boston United","Telford United","5-3",5,3,5,5,8,2,"H"
NA,1980,"Frickley Athletic","Telford United","4-1",4,1,5,5,5,3,"H"
NA,1980,"Ebbsfleet United","Telford United","2-2",2,2,5,5,4,0,"D"
NA,1980,"Kettering Town","Telford United","2-1",2,1,5,5,3,1,"H"
NA,1980,"Maidstone United","Telford United","3-0",3,0,5,5,3,3,"H"
NA,1980,"Northwich Victoria","Telford United","1-0",1,0,5,5,1,1,"H"
NA,1980,"Nuneaton Town","Telford United","3-3",3,3,5,5,6,0,"D"
NA,1980,"Scarborough","Telford United","1-1",1,1,5,5,2,0,"D"
NA,1980,"Stafford Rangers","Telford United","0-1",0,1,5,5,1,-1,"A"
NA,1980,"Wealdstone","Telford United","4-0",4,0,5,5,4,4,"H"
NA,1980,"Weymouth","Telford United","1-0",1,0,5,5,1,1,"H"
NA,1980,"Worcester City","Telford United","0-3",0,3,5,5,3,-3,"A"
NA,1980,"Yeovil","Telford United","1-2",1,2,5,5,3,-1,"A"
NA,1980,"Altrincham","Wealdstone","2-0",2,0,5,5,2,2,"H"
NA,1980,"AP Leamington","Wealdstone","1-1",1,1,5,5,2,0,"D"
NA,1980,"Bangor City","Wealdstone","0-2",0,2,5,5,2,-2,"A"
NA,1980,"Barnet","Wealdstone","3-0",3,0,5,5,3,3,"H"
NA,1980,"Barrow","Wealdstone","1-0",1,0,5,5,1,1,"H"
NA,1980,"Bath City","Wealdstone","2-0",2,0,5,5,2,2,"H"
NA,1980,"Boston United","Wealdstone","2-1",2,1,5,5,3,1,"H"
NA,1980,"Frickley Athletic","Wealdstone","1-1",1,1,5,5,2,0,"D"
NA,1980,"Ebbsfleet United","Wealdstone","0-1",0,1,5,5,1,-1,"A"
NA,1980,"Kettering Town","Wealdstone","0-1",0,1,5,5,1,-1,"A"
NA,1980,"Maidstone United","Wealdstone","4-0",4,0,5,5,4,4,"H"
NA,1980,"Northwich Victoria","Wealdstone","0-0",0,0,5,5,0,0,"D"
NA,1980,"Nuneaton Town","Wealdstone","2-0",2,0,5,5,2,2,"H"
NA,1980,"Scarborough","Wealdstone","4-0",4,0,5,5,4,4,"H"
NA,1980,"Stafford Rangers","Wealdstone","3-0",3,0,5,5,3,3,"H"
NA,1980,"Telford United","Wealdstone","2-1",2,1,5,5,3,1,"H"
NA,1980,"Weymouth","Wealdstone","2-1",2,1,5,5,3,1,"H"
NA,1980,"Worcester City","Wealdstone","4-1",4,1,5,5,5,3,"H"
NA,1980,"Yeovil","Wealdstone","4-0",4,0,5,5,4,4,"H"
NA,1980,"Altrincham","Weymouth","1-2",1,2,5,5,3,-1,"A"
NA,1980,"AP Leamington","Weymouth","0-1",0,1,5,5,1,-1,"A"
NA,1980,"Bangor City","Weymouth","2-0",2,0,5,5,2,2,"H"
NA,1980,"Barnet","Weymouth","0-3",0,3,5,5,3,-3,"A"
NA,1980,"Barrow","Weymouth","0-1",0,1,5,5,1,-1,"A"
NA,1980,"Bath City","Weymouth","2-3",2,3,5,5,5,-1,"A"
NA,1980,"Boston United","Weymouth","2-1",2,1,5,5,3,1,"H"
NA,1980,"Frickley Athletic","Weymouth","1-2",1,2,5,5,3,-1,"A"
NA,1980,"Ebbsfleet United","Weymouth","1-0",1,0,5,5,1,1,"H"
NA,1980,"Kettering Town","Weymouth","1-0",1,0,5,5,1,1,"H"
NA,1980,"Maidstone United","Weymouth","3-0",3,0,5,5,3,3,"H"
NA,1980,"Northwich Victoria","Weymouth","0-0",0,0,5,5,0,0,"D"
NA,1980,"Nuneaton Town","Weymouth","1-4",1,4,5,5,5,-3,"A"
NA,1980,"Scarborough","Weymouth","2-0",2,0,5,5,2,2,"H"
NA,1980,"Stafford Rangers","Weymouth","2-0",2,0,5,5,2,2,"H"
NA,1980,"Telford United","Weymouth","1-0",1,0,5,5,1,1,"H"
NA,1980,"Wealdstone","Weymouth","1-1",1,1,5,5,2,0,"D"
NA,1980,"Worcester City","Weymouth","2-1",2,1,5,5,3,1,"H"
NA,1980,"Yeovil","Weymouth","0-5",0,5,5,5,5,-5,"A"
NA,1980,"Altrincham","Worcester City","1-0",1,0,5,5,1,1,"H"
NA,1980,"AP Leamington","Worcester City","2-1",2,1,5,5,3,1,"H"
NA,1980,"Bangor City","Worcester City","1-1",1,1,5,5,2,0,"D"
NA,1980,"Barnet","Worcester City","0-2",0,2,5,5,2,-2,"A"
NA,1980,"Barrow","Worcester City","1-0",1,0,5,5,1,1,"H"
NA,1980,"Bath City","Worcester City","3-0",3,0,5,5,3,3,"H"
NA,1980,"Boston United","Worcester City","3-1",3,1,5,5,4,2,"H"
NA,1980,"Frickley Athletic","Worcester City","1-1",1,1,5,5,2,0,"D"
NA,1980,"Ebbsfleet United","Worcester City","2-1",2,1,5,5,3,1,"H"
NA,1980,"Kettering Town","Worcester City","1-0",1,0,5,5,1,1,"H"
NA,1980,"Maidstone United","Worcester City","2-0",2,0,5,5,2,2,"H"
NA,1980,"Northwich Victoria","Worcester City","3-0",3,0,5,5,3,3,"H"
NA,1980,"Nuneaton Town","Worcester City","2-3",2,3,5,5,5,-1,"A"
NA,1980,"Scarborough","Worcester City","0-0",0,0,5,5,0,0,"D"
NA,1980,"Stafford Rangers","Worcester City","1-0",1,0,5,5,1,1,"H"
NA,1980,"Telford United","Worcester City","1-2",1,2,5,5,3,-1,"A"
NA,1980,"Wealdstone","Worcester City","1-2",1,2,5,5,3,-1,"A"
NA,1980,"Weymouth","Worcester City","1-0",1,0,5,5,1,1,"H"
NA,1980,"Yeovil","Worcester City","3-0",3,0,5,5,3,3,"H"
NA,1980,"Altrincham","Yeovil","2-1",2,1,5,5,3,1,"H"
NA,1980,"AP Leamington","Yeovil","1-0",1,0,5,5,1,1,"H"
NA,1980,"Bangor City","Yeovil","0-2",0,2,5,5,2,-2,"A"
NA,1980,"Barnet","Yeovil","4-4",4,4,5,5,8,0,"D"
NA,1980,"Barrow","Yeovil","2-1",2,1,5,5,3,1,"H"
NA,1980,"Bath City","Yeovil","2-1",2,1,5,5,3,1,"H"
NA,1980,"Boston United","Yeovil","3-1",3,1,5,5,4,2,"H"
NA,1980,"Frickley Athletic","Yeovil","2-1",2,1,5,5,3,1,"H"
NA,1980,"Ebbsfleet United","Yeovil","2-2",2,2,5,5,4,0,"D"
NA,1980,"Kettering Town","Yeovil","4-0",4,0,5,5,4,4,"H"
NA,1980,"Maidstone United","Yeovil","4-2",4,2,5,5,6,2,"H"
NA,1980,"Northwich Victoria","Yeovil","1-2",1,2,5,5,3,-1,"A"
NA,1980,"Nuneaton Town","Yeovil","3-0",3,0,5,5,3,3,"H"
NA,1980,"Scarborough","Yeovil","2-1",2,1,5,5,3,1,"H"
NA,1980,"Stafford Rangers","Yeovil","1-1",1,1,5,5,2,0,"D"
NA,1980,"Telford United","Yeovil","0-1",0,1,5,5,1,-1,"A"
NA,1980,"Wealdstone","Yeovil","1-1",1,1,5,5,2,0,"D"
NA,1980,"Weymouth","Yeovil","0-1",0,1,5,5,1,-1,"A"
NA,1980,"Worcester City","Yeovil","0-1",0,1,5,5,1,-1,"A"
NA,1981,"AP Leamington","Altrincham","0-1",0,1,5,5,1,-1,"A"
NA,1981,"Barnet","Altrincham","0-0",0,0,5,5,0,0,"D"
NA,1981,"Barrow","Altrincham","1-0",1,0,5,5,1,1,"H"
NA,1981,"Bath City","Altrincham","1-1",1,1,5,5,2,0,"D"
NA,1981,"Boston United","Altrincham","1-1",1,1,5,5,2,0,"D"
NA,1981,"Dagenham","Altrincham","2-0",2,0,5,5,2,2,"H"
NA,1981,"Dartford","Altrincham","0-1",0,1,5,5,1,-1,"A"
NA,1981,"Enfield","Altrincham","1-1",1,1,5,5,2,0,"D"
NA,1981,"Frickley Athletic","Altrincham","1-1",1,1,5,5,2,0,"D"
NA,1981,"Ebbsfleet United","Altrincham","1-1",1,1,5,5,2,0,"D"
NA,1981,"Kettering Town","Altrincham","5-4",5,4,5,5,9,1,"H"
NA,1981,"Maidstone United","Altrincham","0-0",0,0,5,5,0,0,"D"
NA,1981,"Northwich Victoria","Altrincham","2-0",2,0,5,5,2,2,"H"
NA,1981,"Runcorn","Altrincham","5-4",5,4,5,5,9,1,"H"
NA,1981,"Scarborough","Altrincham","1-3",1,3,5,5,4,-2,"A"
NA,1981,"Stafford Rangers","Altrincham","2-0",2,0,5,5,2,2,"H"
NA,1981,"Telford United","Altrincham","4-3",4,3,5,5,7,1,"H"
NA,1981,"Trowbridge Town","Altrincham","0-2",0,2,5,5,2,-2,"A"
NA,1981,"Weymouth","Altrincham","1-0",1,0,5,5,1,1,"H"
NA,1981,"Worcester City","Altrincham","4-3",4,3,5,5,7,1,"H"
NA,1981,"Yeovil","Altrincham","2-1",2,1,5,5,3,1,"H"
NA,1981,"Altrincham","AP Leamington","2-3",2,3,5,5,5,-1,"A"
NA,1981,"Barnet","AP Leamington","0-0",0,0,5,5,0,0,"D"
NA,1981,"Barrow","AP Leamington","4-2",4,2,5,5,6,2,"H"
NA,1981,"Bath City","AP Leamington","7-0",7,0,5,5,7,7,"H"
NA,1981,"Boston United","AP Leamington","2-0",2,0,5,5,2,2,"H"
NA,1981,"Dagenham","AP Leamington","0-0",0,0,5,5,0,0,"D"
NA,1981,"Dartford","AP Leamington","2-2",2,2,5,5,4,0,"D"
NA,1981,"Enfield","AP Leamington","6-1",6,1,5,5,7,5,"H"
NA,1981,"Frickley Athletic","AP Leamington","4-1",4,1,5,5,5,3,"H"
NA,1981,"Ebbsfleet United","AP Leamington","4-1",4,1,5,5,5,3,"H"
NA,1981,"Kettering Town","AP Leamington","1-2",1,2,5,5,3,-1,"A"
NA,1981,"Maidstone United","AP Leamington","4-0",4,0,5,5,4,4,"H"
NA,1981,"Northwich Victoria","AP Leamington","3-0",3,0,5,5,3,3,"H"
NA,1981,"Runcorn","AP Leamington","3-0",3,0,5,5,3,3,"H"
NA,1981,"Scarborough","AP Leamington","6-1",6,1,5,5,7,5,"H"
NA,1981,"Stafford Rangers","AP Leamington","3-1",3,1,5,5,4,2,"H"
NA,1981,"Telford United","AP Leamington","2-0",2,0,5,5,2,2,"H"
NA,1981,"Trowbridge Town","AP Leamington","2-1",2,1,5,5,3,1,"H"
NA,1981,"Weymouth","AP Leamington","1-2",1,2,5,5,3,-1,"A"
NA,1981,"Worcester City","AP Leamington","2-1",2,1,5,5,3,1,"H"
NA,1981,"Yeovil","AP Leamington","3-2",3,2,5,5,5,1,"H"
NA,1981,"Altrincham","Barnet","2-0",2,0,5,5,2,2,"H"
NA,1981,"AP Leamington","Barnet","0-2",0,2,5,5,2,-2,"A"
NA,1981,"Barrow","Barnet","2-1",2,1,5,5,3,1,"H"
NA,1981,"Bath City","Barnet","2-1",2,1,5,5,3,1,"H"
NA,1981,"Boston United","Barnet","1-1",1,1,5,5,2,0,"D"
NA,1981,"Dagenham","Barnet","1-1",1,1,5,5,2,0,"D"
NA,1981,"Dartford","Barnet","2-1",2,1,5,5,3,1,"H"
NA,1981,"Enfield","Barnet","0-0",0,0,5,5,0,0,"D"
NA,1981,"Frickley Athletic","Barnet","0-1",0,1,5,5,1,-1,"A"
NA,1981,"Ebbsfleet United","Barnet","2-3",2,3,5,5,5,-1,"A"
NA,1981,"Kettering Town","Barnet","5-2",5,2,5,5,7,3,"H"
NA,1981,"Maidstone United","Barnet","0-0",0,0,5,5,0,0,"D"
NA,1981,"Northwich Victoria","Barnet","1-1",1,1,5,5,2,0,"D"
NA,1981,"Runcorn","Barnet","1-0",1,0,5,5,1,1,"H"
NA,1981,"Scarborough","Barnet","1-0",1,0,5,5,1,1,"H"
NA,1981,"Stafford Rangers","Barnet","1-0",1,0,5,5,1,1,"H"
NA,1981,"Telford United","Barnet","3-0",3,0,5,5,3,3,"H"
NA,1981,"Trowbridge Town","Barnet","1-1",1,1,5,5,2,0,"D"
NA,1981,"Weymouth","Barnet","0-2",0,2,5,5,2,-2,"A"
NA,1981,"Worcester City","Barnet","3-1",3,1,5,5,4,2,"H"
NA,1981,"Yeovil","Barnet","4-1",4,1,5,5,5,3,"H"
NA,1981,"Altrincham","Barrow","1-1",1,1,5,5,2,0,"D"
NA,1981,"AP Leamington","Barrow","1-1",1,1,5,5,2,0,"D"
NA,1981,"Barnet","Barrow","1-2",1,2,5,5,3,-1,"A"
NA,1981,"Bath City","Barrow","0-0",0,0,5,5,0,0,"D"
NA,1981,"Boston United","Barrow","2-1",2,1,5,5,3,1,"H"
NA,1981,"Dagenham","Barrow","1-0",1,0,5,5,1,1,"H"
NA,1981,"Dartford","Barrow","0-2",0,2,5,5,2,-2,"A"
NA,1981,"Enfield","Barrow","7-2",7,2,5,5,9,5,"H"
NA,1981,"Frickley Athletic","Barrow","2-1",2,1,5,5,3,1,"H"
NA,1981,"Ebbsfleet United","Barrow","3-1",3,1,5,5,4,2,"H"
NA,1981,"Kettering Town","Barrow","0-2",0,2,5,5,2,-2,"A"
NA,1981,"Maidstone United","Barrow","1-0",1,0,5,5,1,1,"H"
NA,1981,"Northwich Victoria","Barrow","2-0",2,0,5,5,2,2,"H"
NA,1981,"Runcorn","Barrow","0-0",0,0,5,5,0,0,"D"
NA,1981,"Scarborough","Barrow","2-0",2,0,5,5,2,2,"H"
NA,1981,"Stafford Rangers","Barrow","1-1",1,1,5,5,2,0,"D"
NA,1981,"Telford United","Barrow","0-0",0,0,5,5,0,0,"D"
NA,1981,"Trowbridge Town","Barrow","2-0",2,0,5,5,2,2,"H"
NA,1981,"Weymouth","Barrow","3-0",3,0,5,5,3,3,"H"
NA,1981,"Worcester City","Barrow","4-0",4,0,5,5,4,4,"H"
NA,1981,"Yeovil","Barrow","0-0",0,0,5,5,0,0,"D"
NA,1981,"Altrincham","Bath City","1-0",1,0,5,5,1,1,"H"
NA,1981,"AP Leamington","Bath City","0-1",0,1,5,5,1,-1,"A"
NA,1981,"Barnet","Bath City","0-1",0,1,5,5,1,-1,"A"
NA,1981,"Barrow","Bath City","0-1",0,1,5,5,1,-1,"A"
NA,1981,"Boston United","Bath City","4-0",4,0,5,5,4,4,"H"
NA,1981,"Dagenham","Bath City","0-1",0,1,5,5,1,-1,"A"
NA,1981,"Dartford","Bath City","1-1",1,1,5,5,2,0,"D"
NA,1981,"Enfield","Bath City","5-1",5,1,5,5,6,4,"H"
NA,1981,"Frickley Athletic","Bath City","1-3",1,3,5,5,4,-2,"A"
NA,1981,"Ebbsfleet United","Bath City","0-2",0,2,5,5,2,-2,"A"
NA,1981,"Kettering Town","Bath City","1-3",1,3,5,5,4,-2,"A"
NA,1981,"Maidstone United","Bath City","1-0",1,0,5,5,1,1,"H"
NA,1981,"Northwich Victoria","Bath City","2-1",2,1,5,5,3,1,"H"
NA,1981,"Runcorn","Bath City","5-1",5,1,5,5,6,4,"H"
NA,1981,"Scarborough","Bath City","1-1",1,1,5,5,2,0,"D"
NA,1981,"Stafford Rangers","Bath City","2-0",2,0,5,5,2,2,"H"
NA,1981,"Telford United","Bath City","0-2",0,2,5,5,2,-2,"A"
NA,1981,"Trowbridge Town","Bath City","1-1",1,1,5,5,2,0,"D"
NA,1981,"Weymouth","Bath City","2-0",2,0,5,5,2,2,"H"
NA,1981,"Worcester City","Bath City","2-0",2,0,5,5,2,2,"H"
NA,1981,"Yeovil","Bath City","2-0",2,0,5,5,2,2,"H"
NA,1981,"Altrincham","Boston United","1-1",1,1,5,5,2,0,"D"
NA,1981,"AP Leamington","Boston United","2-2",2,2,5,5,4,0,"D"
NA,1981,"Barnet","Boston United","0-0",0,0,5,5,0,0,"D"
NA,1981,"Barrow","Boston United","1-0",1,0,5,5,1,1,"H"
NA,1981,"Bath City","Boston United","1-2",1,2,5,5,3,-1,"A"
NA,1981,"Dagenham","Boston United","2-0",2,0,5,5,2,2,"H"
NA,1981,"Dartford","Boston United","2-1",2,1,5,5,3,1,"H"
NA,1981,"Enfield","Boston United","4-0",4,0,5,5,4,4,"H"
NA,1981,"Frickley Athletic","Boston United","4-1",4,1,5,5,5,3,"H"
NA,1981,"Ebbsfleet United","Boston United","3-1",3,1,5,5,4,2,"H"
NA,1981,"Kettering Town","Boston United","1-1",1,1,5,5,2,0,"D"
NA,1981,"Maidstone United","Boston United","0-2",0,2,5,5,2,-2,"A"
NA,1981,"Northwich Victoria","Boston United","1-0",1,0,5,5,1,1,"H"
NA,1981,"Runcorn","Boston United","4-0",4,0,5,5,4,4,"H"
NA,1981,"Scarborough","Boston United","1-1",1,1,5,5,2,0,"D"
NA,1981,"Stafford Rangers","Boston United","0-0",0,0,5,5,0,0,"D"
NA,1981,"Telford United","Boston United","4-1",4,1,5,5,5,3,"H"
NA,1981,"Trowbridge Town","Boston United","1-0",1,0,5,5,1,1,"H"
NA,1981,"Weymouth","Boston United","2-1",2,1,5,5,3,1,"H"
NA,1981,"Worcester City","Boston United","0-0",0,0,5,5,0,0,"D"
NA,1981,"Yeovil","Boston United","0-1",0,1,5,5,1,-1,"A"
NA,1981,"Altrincham","Dagenham","1-1",1,1,5,5,2,0,"D"
NA,1981,"AP Leamington","Dagenham","0-4",0,4,5,5,4,-4,"A"
NA,1981,"Barnet","Dagenham","1-2",1,2,5,5,3,-1,"A"
NA,1981,"Barrow","Dagenham","2-2",2,2,5,5,4,0,"D"
NA,1981,"Bath City","Dagenham","0-3",0,3,5,5,3,-3,"A"
NA,1981,"Boston United","Dagenham","3-4",3,4,5,5,7,-1,"A"
NA,1981,"Dartford","Dagenham","0-3",0,3,5,5,3,-3,"A"
NA,1981,"Enfield","Dagenham","3-2",3,2,5,5,5,1,"H"
NA,1981,"Frickley Athletic","Dagenham","3-1",3,1,5,5,4,2,"H"
NA,1981,"Ebbsfleet United","Dagenham","1-2",1,2,5,5,3,-1,"A"
NA,1981,"Kettering Town","Dagenham","3-1",3,1,5,5,4,2,"H"
NA,1981,"Maidstone United","Dagenham","2-2",2,2,5,5,4,0,"D"
NA,1981,"Northwich Victoria","Dagenham","3-0",3,0,5,5,3,3,"H"
NA,1981,"Runcorn","Dagenham","1-0",1,0,5,5,1,1,"H"
NA,1981,"Scarborough","Dagenham","1-1",1,1,5,5,2,0,"D"
NA,1981,"Stafford Rangers","Dagenham","0-0",0,0,5,5,0,0,"D"
NA,1981,"Telford United","Dagenham","0-2",0,2,5,5,2,-2,"A"
NA,1981,"Trowbridge Town","Dagenham","0-1",0,1,5,5,1,-1,"A"
NA,1981,"Weymouth","Dagenham","1-1",1,1,5,5,2,0,"D"
NA,1981,"Worcester City","Dagenham","2-1",2,1,5,5,3,1,"H"
NA,1981,"Yeovil","Dagenham","1-4",1,4,5,5,5,-3,"A"
NA,1981,"Altrincham","Dartford","2-0",2,0,5,5,2,2,"H"
NA,1981,"AP Leamington","Dartford","0-2",0,2,5,5,2,-2,"A"
NA,1981,"Barnet","Dartford","2-0",2,0,5,5,2,2,"H"
NA,1981,"Barrow","Dartford","2-0",2,0,5,5,2,2,"H"
NA,1981,"Bath City","Dartford","1-1",1,1,5,5,2,0,"D"
NA,1981,"Boston United","Dartford","3-2",3,2,5,5,5,1,"H"
NA,1981,"Dagenham","Dartford","2-1",2,1,5,5,3,1,"H"
NA,1981,"Enfield","Dartford","1-1",1,1,5,5,2,0,"D"
NA,1981,"Frickley Athletic","Dartford","3-0",3,0,5,5,3,3,"H"
NA,1981,"Ebbsfleet United","Dartford","1-0",1,0,5,5,1,1,"H"
NA,1981,"Kettering Town","Dartford","4-4",4,4,5,5,8,0,"D"
NA,1981,"Maidstone United","Dartford","5-1",5,1,5,5,6,4,"H"
NA,1981,"Northwich Victoria","Dartford","3-4",3,4,5,5,7,-1,"A"
NA,1981,"Runcorn","Dartford","4-2",4,2,5,5,6,2,"H"
NA,1981,"Scarborough","Dartford","2-0",2,0,5,5,2,2,"H"
NA,1981,"Stafford Rangers","Dartford","0-3",0,3,5,5,3,-3,"A"
NA,1981,"Telford United","Dartford","2-0",2,0,5,5,2,2,"H"
NA,1981,"Trowbridge Town","Dartford","2-1",2,1,5,5,3,1,"H"
NA,1981,"Weymouth","Dartford","2-1",2,1,5,5,3,1,"H"
NA,1981,"Worcester City","Dartford","2-0",2,0,5,5,2,2,"H"
NA,1981,"Yeovil","Dartford","1-1",1,1,5,5,2,0,"D"
NA,1981,"Altrincham","Enfield","1-0",1,0,5,5,1,1,"H"
NA,1981,"AP Leamington","Enfield","2-3",2,3,5,5,5,-1,"A"
NA,1981,"Barnet","Enfield","4-1",4,1,5,5,5,3,"H"
NA,1981,"Barrow","Enfield","0-2",0,2,5,5,2,-2,"A"
NA,1981,"Bath City","Enfield","0-1",0,1,5,5,1,-1,"A"
NA,1981,"Boston United","Enfield","1-0",1,0,5,5,1,1,"H"
NA,1981,"Dagenham","Enfield","2-4",2,4,5,5,6,-2,"A"
NA,1981,"Dartford","Enfield","0-2",0,2,5,5,2,-2,"A"
NA,1981,"Frickley Athletic","Enfield","1-1",1,1,5,5,2,0,"D"
NA,1981,"Ebbsfleet United","Enfield","1-2",1,2,5,5,3,-1,"A"
NA,1981,"Kettering Town","Enfield","0-1",0,1,5,5,1,-1,"A"
NA,1981,"Maidstone United","Enfield","1-4",1,4,5,5,5,-3,"A"
NA,1981,"Northwich Victoria","Enfield","2-1",2,1,5,5,3,1,"H"
NA,1981,"Runcorn","Enfield","2-0",2,0,5,5,2,2,"H"
NA,1981,"Scarborough","Enfield","1-4",1,4,5,5,5,-3,"A"
NA,1981,"Stafford Rangers","Enfield","0-1",0,1,5,5,1,-1,"A"
NA,1981,"Telford United","Enfield","0-0",0,0,5,5,0,0,"D"
NA,1981,"Trowbridge Town","Enfield","2-2",2,2,5,5,4,0,"D"
NA,1981,"Weymouth","Enfield","2-2",2,2,5,5,4,0,"D"
NA,1981,"Worcester City","Enfield","1-2",1,2,5,5,3,-1,"A"
NA,1981,"Yeovil","Enfield","1-2",1,2,5,5,3,-1,"A"
NA,1981,"Altrincham","Frickley Athletic","1-1",1,1,5,5,2,0,"D"
NA,1981,"AP Leamington","Frickley Athletic","1-0",1,0,5,5,1,1,"H"
NA,1981,"Barnet","Frickley Athletic","0-0",0,0,5,5,0,0,"D"
NA,1981,"Barrow","Frickley Athletic","2-0",2,0,5,5,2,2,"H"
NA,1981,"Bath City","Frickley Athletic","1-3",1,3,5,5,4,-2,"A"
NA,1981,"Boston United","Frickley Athletic","3-1",3,1,5,5,4,2,"H"
NA,1981,"Dagenham","Frickley Athletic","2-0",2,0,5,5,2,2,"H"
NA,1981,"Dartford","Frickley Athletic","1-0",1,0,5,5,1,1,"H"
NA,1981,"Enfield","Frickley Athletic","3-0",3,0,5,5,3,3,"H"
NA,1981,"Ebbsfleet United","Frickley Athletic","4-1",4,1,5,5,5,3,"H"
NA,1981,"Kettering Town","Frickley Athletic","0-0",0,0,5,5,0,0,"D"
NA,1981,"Maidstone United","Frickley Athletic","0-0",0,0,5,5,0,0,"D"
NA,1981,"Northwich Victoria","Frickley Athletic","0-0",0,0,5,5,0,0,"D"
NA,1981,"Runcorn","Frickley Athletic","1-0",1,0,5,5,1,1,"H"
NA,1981,"Scarborough","Frickley Athletic","0-1",0,1,5,5,1,-1,"A"
NA,1981,"Stafford Rangers","Frickley Athletic","0-0",0,0,5,5,0,0,"D"
NA,1981,"Telford United","Frickley Athletic","7-1",7,1,5,5,8,6,"H"
NA,1981,"Trowbridge Town","Frickley Athletic","2-0",2,0,5,5,2,2,"H"
NA,1981,"Weymouth","Frickley Athletic","5-0",5,0,5,5,5,5,"H"
NA,1981,"Worcester City","Frickley Athletic","3-2",3,2,5,5,5,1,"H"
NA,1981,"Yeovil","Frickley Athletic","1-2",1,2,5,5,3,-1,"A"
NA,1981,"Altrincham","Ebbsfleet United","3-1",3,1,5,5,4,2,"H"
NA,1981,"AP Leamington","Ebbsfleet United","3-3",3,3,5,5,6,0,"D"
NA,1981,"Barnet","Ebbsfleet United","2-0",2,0,5,5,2,2,"H"
NA,1981,"Barrow","Ebbsfleet United","3-1",3,1,5,5,4,2,"H"
NA,1981,"Bath City","Ebbsfleet United","1-0",1,0,5,5,1,1,"H"
NA,1981,"Boston United","Ebbsfleet United","2-2",2,2,5,5,4,0,"D"
NA,1981,"Dagenham","Ebbsfleet United","1-1",1,1,5,5,2,0,"D"
NA,1981,"Dartford","Ebbsfleet United","0-1",0,1,5,5,1,-1,"A"
NA,1981,"Enfield","Ebbsfleet United","4-0",4,0,5,5,4,4,"H"
NA,1981,"Frickley Athletic","Ebbsfleet United","1-1",1,1,5,5,2,0,"D"
NA,1981,"Kettering Town","Ebbsfleet United","2-1",2,1,5,5,3,1,"H"
NA,1981,"Maidstone United","Ebbsfleet United","0-1",0,1,5,5,1,-1,"A"
NA,1981,"Northwich Victoria","Ebbsfleet United","1-0",1,0,5,5,1,1,"H"
NA,1981,"Runcorn","Ebbsfleet United","1-0",1,0,5,5,1,1,"H"
NA,1981,"Scarborough","Ebbsfleet United","5-0",5,0,5,5,5,5,"H"
NA,1981,"Stafford Rangers","Ebbsfleet United","1-0",1,0,5,5,1,1,"H"
NA,1981,"Telford United","Ebbsfleet United","1-0",1,0,5,5,1,1,"H"
NA,1981,"Trowbridge Town","Ebbsfleet United","2-1",2,1,5,5,3,1,"H"
NA,1981,"Weymouth","Ebbsfleet United","1-2",1,2,5,5,3,-1,"A"
NA,1981,"Worcester City","Ebbsfleet United","2-1",2,1,5,5,3,1,"H"
NA,1981,"Yeovil","Ebbsfleet United","2-1",2,1,5,5,3,1,"H"
NA,1981,"Altrincham","Kettering Town","2-1",2,1,5,5,3,1,"H"
NA,1981,"AP Leamington","Kettering Town","3-3",3,3,5,5,6,0,"D"
NA,1981,"Barnet","Kettering Town","2-1",2,1,5,5,3,1,"H"
NA,1981,"Barrow","Kettering Town","7-2",7,2,5,5,9,5,"H"
NA,1981,"Bath City","Kettering Town","3-2",3,2,5,5,5,1,"H"
NA,1981,"Boston United","Kettering Town","4-2",4,2,5,5,6,2,"H"
NA,1981,"Dagenham","Kettering Town","2-1",2,1,5,5,3,1,"H"
NA,1981,"Dartford","Kettering Town","2-2",2,2,5,5,4,0,"D"
NA,1981,"Enfield","Kettering Town","1-1",1,1,5,5,2,0,"D"
NA,1981,"Frickley Athletic","Kettering Town","3-2",3,2,5,5,5,1,"H"
NA,1981,"Ebbsfleet United","Kettering Town","1-3",1,3,5,5,4,-2,"A"
NA,1981,"Maidstone United","Kettering Town","2-0",2,0,5,5,2,2,"H"
NA,1981,"Northwich Victoria","Kettering Town","2-0",2,0,5,5,2,2,"H"
NA,1981,"Runcorn","Kettering Town","3-2",3,2,5,5,5,1,"H"
NA,1981,"Scarborough","Kettering Town","1-0",1,0,5,5,1,1,"H"
NA,1981,"Stafford Rangers","Kettering Town","1-1",1,1,5,5,2,0,"D"
NA,1981,"Telford United","Kettering Town","1-0",1,0,5,5,1,1,"H"
NA,1981,"Trowbridge Town","Kettering Town","0-1",0,1,5,5,1,-1,"A"
NA,1981,"Weymouth","Kettering Town","2-3",2,3,5,5,5,-1,"A"
NA,1981,"Worcester City","Kettering Town","1-1",1,1,5,5,2,0,"D"
NA,1981,"Yeovil","Kettering Town","1-1",1,1,5,5,2,0,"D"
NA,1981,"Altrincham","Maidstone United","1-2",1,2,5,5,3,-1,"A"
NA,1981,"AP Leamington","Maidstone United","1-1",1,1,5,5,2,0,"D"
NA,1981,"Barnet","Maidstone United","1-1",1,1,5,5,2,0,"D"
NA,1981,"Barrow","Maidstone United","2-0",2,0,5,5,2,2,"H"
NA,1981,"Bath City","Maidstone United","1-1",1,1,5,5,2,0,"D"
NA,1981,"Boston United","Maidstone United","6-0",6,0,5,5,6,6,"H"
NA,1981,"Dagenham","Maidstone United","1-1",1,1,5,5,2,0,"D"
NA,1981,"Dartford","Maidstone United","2-1",2,1,5,5,3,1,"H"
NA,1981,"Enfield","Maidstone United","3-2",3,2,5,5,5,1,"H"
NA,1981,"Frickley Athletic","Maidstone United","0-3",0,3,5,5,3,-3,"A"
NA,1981,"Ebbsfleet United","Maidstone United","2-2",2,2,5,5,4,0,"D"
NA,1981,"Kettering Town","Maidstone United","2-2",2,2,5,5,4,0,"D"
NA,1981,"Northwich Victoria","Maidstone United","3-1",3,1,5,5,4,2,"H"
NA,1981,"Runcorn","Maidstone United","1-1",1,1,5,5,2,0,"D"
NA,1981,"Scarborough","Maidstone United","0-0",0,0,5,5,0,0,"D"
NA,1981,"Stafford Rangers","Maidstone United","1-1",1,1,5,5,2,0,"D"
NA,1981,"Telford United","Maidstone United","1-2",1,2,5,5,3,-1,"A"
NA,1981,"Trowbridge Town","Maidstone United","3-0",3,0,5,5,3,3,"H"
NA,1981,"Weymouth","Maidstone United","1-0",1,0,5,5,1,1,"H"
NA,1981,"Worcester City","Maidstone United","4-1",4,1,5,5,5,3,"H"
NA,1981,"Yeovil","Maidstone United","1-0",1,0,5,5,1,1,"H"
NA,1981,"Altrincham","Northwich Victoria","0-2",0,2,5,5,2,-2,"A"
NA,1981,"AP Leamington","Northwich Victoria","0-2",0,2,5,5,2,-2,"A"
NA,1981,"Barnet","Northwich Victoria","0-1",0,1,5,5,1,-1,"A"
NA,1981,"Barrow","Northwich Victoria","6-1",6,1,5,5,7,5,"H"
NA,1981,"Bath City","Northwich Victoria","1-1",1,1,5,5,2,0,"D"
NA,1981,"Boston United","Northwich Victoria","2-0",2,0,5,5,2,2,"H"
NA,1981,"Dagenham","Northwich Victoria","2-1",2,1,5,5,3,1,"H"
NA,1981,"Dartford","Northwich Victoria","0-1",0,1,5,5,1,-1,"A"
NA,1981,"Enfield","Northwich Victoria","1-0",1,0,5,5,1,1,"H"
NA,1981,"Frickley Athletic","Northwich Victoria","1-0",1,0,5,5,1,1,"H"
NA,1981,"Ebbsfleet United","Northwich Victoria","0-1",0,1,5,5,1,-1,"A"
NA,1981,"Kettering Town","Northwich Victoria","0-0",0,0,5,5,0,0,"D"
NA,1981,"Maidstone United","Northwich Victoria","6-1",6,1,5,5,7,5,"H"
NA,1981,"Runcorn","Northwich Victoria","0-1",0,1,5,5,1,-1,"A"
NA,1981,"Scarborough","Northwich Victoria","0-4",0,4,5,5,4,-4,"A"
NA,1981,"Stafford Rangers","Northwich Victoria","2-2",2,2,5,5,4,0,"D"
NA,1981,"Telford United","Northwich Victoria","2-1",2,1,5,5,3,1,"H"
NA,1981,"Trowbridge Town","Northwich Victoria","1-0",1,0,5,5,1,1,"H"
NA,1981,"Weymouth","Northwich Victoria","1-0",1,0,5,5,1,1,"H"
NA,1981,"Worcester City","Northwich Victoria","0-1",0,1,5,5,1,-1,"A"
NA,1981,"Yeovil","Northwich Victoria","4-1",4,1,5,5,5,3,"H"
NA,1981,"Altrincham","Runcorn","2-2",2,2,5,5,4,0,"D"
NA,1981,"AP Leamington","Runcorn","1-1",1,1,5,5,2,0,"D"
NA,1981,"Barnet","Runcorn","1-3",1,3,5,5,4,-2,"A"
NA,1981,"Barrow","Runcorn","1-1",1,1,5,5,2,0,"D"
NA,1981,"Bath City","Runcorn","0-2",0,2,5,5,2,-2,"A"
NA,1981,"Boston United","Runcorn","0-1",0,1,5,5,1,-1,"A"
NA,1981,"Dagenham","Runcorn","0-1",0,1,5,5,1,-1,"A"
NA,1981,"Dartford","Runcorn","1-2",1,2,5,5,3,-1,"A"
NA,1981,"Enfield","Runcorn","2-0",2,0,5,5,2,2,"H"
NA,1981,"Frickley Athletic","Runcorn","2-0",2,0,5,5,2,2,"H"
NA,1981,"Ebbsfleet United","Runcorn","2-4",2,4,5,5,6,-2,"A"
NA,1981,"Kettering Town","Runcorn","0-0",0,0,5,5,0,0,"D"
NA,1981,"Maidstone United","Runcorn","1-2",1,2,5,5,3,-1,"A"
NA,1981,"Northwich Victoria","Runcorn","1-1",1,1,5,5,2,0,"D"
NA,1981,"Scarborough","Runcorn","3-0",3,0,5,5,3,3,"H"
NA,1981,"Stafford Rangers","Runcorn","0-1",0,1,5,5,1,-1,"A"
NA,1981,"Telford United","Runcorn","1-1",1,1,5,5,2,0,"D"
NA,1981,"Trowbridge Town","Runcorn","0-0",0,0,5,5,0,0,"D"
NA,1981,"Weymouth","Runcorn","0-1",0,1,5,5,1,-1,"A"
NA,1981,"Worcester City","Runcorn","0-1",0,1,5,5,1,-1,"A"
NA,1981,"Yeovil","Runcorn","1-3",1,3,5,5,4,-2,"A"
NA,1981,"Altrincham","Scarborough","2-0",2,0,5,5,2,2,"H"
NA,1981,"AP Leamington","Scarborough","1-2",1,2,5,5,3,-1,"A"
NA,1981,"Barnet","Scarborough","1-1",1,1,5,5,2,0,"D"
NA,1981,"Barrow","Scarborough","3-2",3,2,5,5,5,1,"H"
NA,1981,"Bath City","Scarborough","2-0",2,0,5,5,2,2,"H"
NA,1981,"Boston United","Scarborough","2-1",2,1,5,5,3,1,"H"
NA,1981,"Dagenham","Scarborough","2-2",2,2,5,5,4,0,"D"
NA,1981,"Dartford","Scarborough","0-1",0,1,5,5,1,-1,"A"
NA,1981,"Enfield","Scarborough","1-4",1,4,5,5,5,-3,"A"
NA,1981,"Frickley Athletic","Scarborough","2-3",2,3,5,5,5,-1,"A"
NA,1981,"Ebbsfleet United","Scarborough","3-0",3,0,5,5,3,3,"H"
NA,1981,"Kettering Town","Scarborough","1-2",1,2,5,5,3,-1,"A"
NA,1981,"Maidstone United","Scarborough","0-2",0,2,5,5,2,-2,"A"
NA,1981,"Northwich Victoria","Scarborough","2-1",2,1,5,5,3,1,"H"
NA,1981,"Runcorn","Scarborough","2-0",2,0,5,5,2,2,"H"
NA,1981,"Stafford Rangers","Scarborough","1-1",1,1,5,5,2,0,"D"
NA,1981,"Telford United","Scarborough","1-1",1,1,5,5,2,0,"D"
NA,1981,"Trowbridge Town","Scarborough","1-3",1,3,5,5,4,-2,"A"
NA,1981,"Weymouth","Scarborough","3-1",3,1,5,5,4,2,"H"
NA,1981,"Worcester City","Scarborough","2-4",2,4,5,5,6,-2,"A"
NA,1981,"Yeovil","Scarborough","0-0",0,0,5,5,0,0,"D"
NA,1981,"Altrincham","Stafford Rangers","0-1",0,1,5,5,1,-1,"A"
NA,1981,"AP Leamington","Stafford Rangers","1-5",1,5,5,5,6,-4,"A"
NA,1981,"Barnet","Stafford Rangers","0-2",0,2,5,5,2,-2,"A"
NA,1981,"Barrow","Stafford Rangers","1-1",1,1,5,5,2,0,"D"
NA,1981,"Bath City","Stafford Rangers","1-1",1,1,5,5,2,0,"D"
NA,1981,"Boston United","Stafford Rangers","2-1",2,1,5,5,3,1,"H"
NA,1981,"Dagenham","Stafford Rangers","2-2",2,2,5,5,4,0,"D"
NA,1981,"Dartford","Stafford Rangers","2-2",2,2,5,5,4,0,"D"
NA,1981,"Enfield","Stafford Rangers","2-0",2,0,5,5,2,2,"H"
NA,1981,"Frickley Athletic","Stafford Rangers","2-0",2,0,5,5,2,2,"H"
NA,1981,"Ebbsfleet United","Stafford Rangers","1-1",1,1,5,5,2,0,"D"
NA,1981,"Kettering Town","Stafford Rangers","3-0",3,0,5,5,3,3,"H"
NA,1981,"Maidstone United","Stafford Rangers","3-1",3,1,5,5,4,2,"H"
NA,1981,"Northwich Victoria","Stafford Rangers","1-2",1,2,5,5,3,-1,"A"
NA,1981,"Runcorn","Stafford Rangers","1-0",1,0,5,5,1,1,"H"
NA,1981,"Scarborough","Stafford Rangers","1-0",1,0,5,5,1,1,"H"
NA,1981,"Telford United","Stafford Rangers","0-3",0,3,5,5,3,-3,"A"
NA,1981,"Trowbridge Town","Stafford Rangers","1-1",1,1,5,5,2,0,"D"
NA,1981,"Weymouth","Stafford Rangers","1-1",1,1,5,5,2,0,"D"
NA,1981,"Worcester City","Stafford Rangers","1-1",1,1,5,5,2,0,"D"
NA,1981,"Yeovil","Stafford Rangers","2-1",2,1,5,5,3,1,"H"
NA,1981,"Altrincham","Telford United","3-0",3,0,5,5,3,3,"H"
NA,1981,"AP Leamington","Telford United","0-2",0,2,5,5,2,-2,"A"
NA,1981,"Barnet","Telford United","1-0",1,0,5,5,1,1,"H"
NA,1981,"Barrow","Telford United","2-0",2,0,5,5,2,2,"H"
NA,1981,"Bath City","Telford United","1-2",1,2,5,5,3,-1,"A"
NA,1981,"Boston United","Telford United","4-2",4,2,5,5,6,2,"H"
NA,1981,"Dagenham","Telford United","3-2",3,2,5,5,5,1,"H"
NA,1981,"Dartford","Telford United","2-0",2,0,5,5,2,2,"H"
NA,1981,"Enfield","Telford United","3-4",3,4,5,5,7,-1,"A"
NA,1981,"Frickley Athletic","Telford United","0-0",0,0,5,5,0,0,"D"
NA,1981,"Ebbsfleet United","Telford United","0-2",0,2,5,5,2,-2,"A"
NA,1981,"Kettering Town","Telford United","1-3",1,3,5,5,4,-2,"A"
NA,1981,"Maidstone United","Telford United","2-2",2,2,5,5,4,0,"D"
NA,1981,"Northwich Victoria","Telford United","2-2",2,2,5,5,4,0,"D"
NA,1981,"Runcorn","Telford United","2-3",2,3,5,5,5,-1,"A"
NA,1981,"Scarborough","Telford United","0-0",0,0,5,5,0,0,"D"
NA,1981,"Stafford Rangers","Telford United","1-2",1,2,5,5,3,-1,"A"
NA,1981,"Trowbridge Town","Telford United","1-2",1,2,5,5,3,-1,"A"
NA,1981,"Weymouth","Telford United","0-1",0,1,5,5,1,-1,"A"
NA,1981,"Worcester City","Telford United","2-1",2,1,5,5,3,1,"H"
NA,1981,"Yeovil","Telford United","1-2",1,2,5,5,3,-1,"A"
NA,1981,"Altrincham","Trowbridge Town","1-2",1,2,5,5,3,-1,"A"
NA,1981,"AP Leamington","Trowbridge Town","0-1",0,1,5,5,1,-1,"A"
NA,1981,"Barnet","Trowbridge Town","0-0",0,0,5,5,0,0,"D"
NA,1981,"Barrow","Trowbridge Town","1-0",1,0,5,5,1,1,"H"
NA,1981,"Bath City","Trowbridge Town","1-1",1,1,5,5,2,0,"D"
NA,1981,"Boston United","Trowbridge Town","1-0",1,0,5,5,1,1,"H"
NA,1981,"Dagenham","Trowbridge Town","1-2",1,2,5,5,3,-1,"A"
NA,1981,"Dartford","Trowbridge Town","1-0",1,0,5,5,1,1,"H"
NA,1981,"Enfield","Trowbridge Town","2-1",2,1,5,5,3,1,"H"
NA,1981,"Frickley Athletic","Trowbridge Town","2-0",2,0,5,5,2,2,"H"
NA,1981,"Ebbsfleet United","Trowbridge Town","1-1",1,1,5,5,2,0,"D"
NA,1981,"Kettering Town","Trowbridge Town","4-0",4,0,5,5,4,4,"H"
NA,1981,"Maidstone United","Trowbridge Town","3-0",3,0,5,5,3,3,"H"
NA,1981,"Northwich Victoria","Trowbridge Town","0-0",0,0,5,5,0,0,"D"
NA,1981,"Runcorn","Trowbridge Town","2-0",2,0,5,5,2,2,"H"
NA,1981,"Scarborough","Trowbridge Town","3-1",3,1,5,5,4,2,"H"
NA,1981,"Stafford Rangers","Trowbridge Town","0-2",0,2,5,5,2,-2,"A"
NA,1981,"Telford United","Trowbridge Town","2-0",2,0,5,5,2,2,"H"
NA,1981,"Weymouth","Trowbridge Town","1-0",1,0,5,5,1,1,"H"
NA,1981,"Worcester City","Trowbridge Town","3-1",3,1,5,5,4,2,"H"
NA,1981,"Yeovil","Trowbridge Town","2-0",2,0,5,5,2,2,"H"
NA,1981,"Altrincham","Weymouth","0-0",0,0,5,5,0,0,"D"
NA,1981,"AP Leamington","Weymouth","2-2",2,2,5,5,4,0,"D"
NA,1981,"Barnet","Weymouth","0-3",0,3,5,5,3,-3,"A"
NA,1981,"Barrow","Weymouth","2-0",2,0,5,5,2,2,"H"
NA,1981,"Bath City","Weymouth","2-1",2,1,5,5,3,1,"H"
NA,1981,"Boston United","Weymouth","0-2",0,2,5,5,2,-2,"A"
NA,1981,"Dagenham","Weymouth","2-1",2,1,5,5,3,1,"H"
NA,1981,"Dartford","Weymouth","0-0",0,0,5,5,0,0,"D"
NA,1981,"Enfield","Weymouth","3-0",3,0,5,5,3,3,"H"
NA,1981,"Frickley Athletic","Weymouth","0-1",0,1,5,5,1,-1,"A"
NA,1981,"Ebbsfleet United","Weymouth","2-1",2,1,5,5,3,1,"H"
NA,1981,"Kettering Town","Weymouth","1-2",1,2,5,5,3,-1,"A"
NA,1981,"Maidstone United","Weymouth","0-1",0,1,5,5,1,-1,"A"
NA,1981,"Northwich Victoria","Weymouth","0-2",0,2,5,5,2,-2,"A"
NA,1981,"Runcorn","Weymouth","3-1",3,1,5,5,4,2,"H"
NA,1981,"Scarborough","Weymouth","2-1",2,1,5,5,3,1,"H"
NA,1981,"Stafford Rangers","Weymouth","3-0",3,0,5,5,3,3,"H"
NA,1981,"Telford United","Weymouth","2-0",2,0,5,5,2,2,"H"
NA,1981,"Trowbridge Town","Weymouth","1-1",1,1,5,5,2,0,"D"
NA,1981,"Worcester City","Weymouth","0-0",0,0,5,5,0,0,"D"
NA,1981,"Yeovil","Weymouth","1-4",1,4,5,5,5,-3,"A"
NA,1981,"Altrincham","Worcester City","6-3",6,3,5,5,9,3,"H"
NA,1981,"AP Leamington","Worcester City","0-1",0,1,5,5,1,-1,"A"
NA,1981,"Barnet","Worcester City","1-2",1,2,5,5,3,-1,"A"
NA,1981,"Barrow","Worcester City","0-0",0,0,5,5,0,0,"D"
NA,1981,"Bath City","Worcester City","2-3",2,3,5,5,5,-1,"A"
NA,1981,"Boston United","Worcester City","3-2",3,2,5,5,5,1,"H"
NA,1981,"Dagenham","Worcester City","1-2",1,2,5,5,3,-1,"A"
NA,1981,"Dartford","Worcester City","0-2",0,2,5,5,2,-2,"A"
NA,1981,"Enfield","Worcester City","1-2",1,2,5,5,3,-1,"A"
NA,1981,"Frickley Athletic","Worcester City","1-2",1,2,5,5,3,-1,"A"
NA,1981,"Ebbsfleet United","Worcester City","1-1",1,1,5,5,2,0,"D"
NA,1981,"Kettering Town","Worcester City","0-1",0,1,5,5,1,-1,"A"
NA,1981,"Maidstone United","Worcester City","2-2",2,2,5,5,4,0,"D"
NA,1981,"Northwich Victoria","Worcester City","3-0",3,0,5,5,3,3,"H"
NA,1981,"Runcorn","Worcester City","5-2",5,2,5,5,7,3,"H"
NA,1981,"Scarborough","Worcester City","1-0",1,0,5,5,1,1,"H"
NA,1981,"Stafford Rangers","Worcester City","0-2",0,2,5,5,2,-2,"A"
NA,1981,"Telford United","Worcester City","3-2",3,2,5,5,5,1,"H"
NA,1981,"Trowbridge Town","Worcester City","1-1",1,1,5,5,2,0,"D"
NA,1981,"Weymouth","Worcester City","3-2",3,2,5,5,5,1,"H"
NA,1981,"Yeovil","Worcester City","3-0",3,0,5,5,3,3,"H"
NA,1981,"Altrincham","Yeovil","7-1",7,1,5,5,8,6,"H"
NA,1981,"AP Leamington","Yeovil","2-5",2,5,5,5,7,-3,"A"
NA,1981,"Barnet","Yeovil","0-0",0,0,5,5,0,0,"D"
NA,1981,"Barrow","Yeovil","3-1",3,1,5,5,4,2,"H"
NA,1981,"Bath City","Yeovil","2-0",2,0,5,5,2,2,"H"
NA,1981,"Boston United","Yeovil","0-0",0,0,5,5,0,0,"D"
NA,1981,"Dagenham","Yeovil","3-0",3,0,5,5,3,3,"H"
NA,1981,"Dartford","Yeovil","5-0",5,0,5,5,5,5,"H"
NA,1981,"Enfield","Yeovil","2-0",2,0,5,5,2,2,"H"
NA,1981,"Frickley Athletic","Yeovil","2-1",2,1,5,5,3,1,"H"
NA,1981,"Ebbsfleet United","Yeovil","1-1",1,1,5,5,2,0,"D"
NA,1981,"Kettering Town","Yeovil","1-1",1,1,5,5,2,0,"D"
NA,1981,"Maidstone United","Yeovil","0-1",0,1,5,5,1,-1,"A"
NA,1981,"Northwich Victoria","Yeovil","1-1",1,1,5,5,2,0,"D"
NA,1981,"Runcorn","Yeovil","2-1",2,1,5,5,3,1,"H"
NA,1981,"Scarborough","Yeovil","2-2",2,2,5,5,4,0,"D"
NA,1981,"Stafford Rangers","Yeovil","3-1",3,1,5,5,4,2,"H"
NA,1981,"Telford United","Yeovil","2-1",2,1,5,5,3,1,"H"
NA,1981,"Trowbridge Town","Yeovil","2-4",2,4,5,5,6,-2,"A"
NA,1981,"Weymouth","Yeovil","1-1",1,1,5,5,2,0,"D"
NA,1981,"Worcester City","Yeovil","0-1",0,1,5,5,1,-1,"A"
NA,1982,"Bangor City","Altrincham","1-0",1,0,5,5,1,1,"H"
NA,1982,"Barnet","Altrincham","2-1",2,1,5,5,3,1,"H"
NA,1982,"Barrow","Altrincham","2-2",2,2,5,5,4,0,"D"
NA,1982,"Bath City","Altrincham","0-2",0,2,5,5,2,-2,"A"
NA,1982,"Boston United","Altrincham","3-0",3,0,5,5,3,3,"H"
NA,1982,"Dagenham","Altrincham","1-1",1,1,5,5,2,0,"D"
NA,1982,"Enfield","Altrincham","2-1",2,1,5,5,3,1,"H"
NA,1982,"Frickley Athletic","Altrincham","3-0",3,0,5,5,3,3,"H"
NA,1982,"Kettering Town","Altrincham","3-2",3,2,5,5,5,1,"H"
NA,1982,"Maidstone United","Altrincham","3-2",3,2,5,5,5,1,"H"
NA,1982,"Northwich Victoria","Altrincham","2-1",2,1,5,5,3,1,"H"
NA,1982,"Nuneaton Town","Altrincham","3-1",3,1,5,5,4,2,"H"
NA,1982,"Runcorn","Altrincham","1-0",1,0,5,5,1,1,"H"
NA,1982,"Scarborough","Altrincham","1-1",1,1,5,5,2,0,"D"
NA,1982,"Stafford Rangers","Altrincham","2-3",2,3,5,5,5,-1,"A"
NA,1982,"Telford United","Altrincham","1-1",1,1,5,5,2,0,"D"
NA,1982,"Trowbridge Town","Altrincham","3-2",3,2,5,5,5,1,"H"
NA,1982,"Wealdstone","Altrincham","1-1",1,1,5,5,2,0,"D"
NA,1982,"Weymouth","Altrincham","2-0",2,0,5,5,2,2,"H"
NA,1982,"Worcester City","Altrincham","1-0",1,0,5,5,1,1,"H"
NA,1982,"Yeovil","Altrincham","2-1",2,1,5,5,3,1,"H"
NA,1982,"Altrincham","Bangor City","2-0",2,0,5,5,2,2,"H"
NA,1982,"Barnet","Bangor City","1-3",1,3,5,5,4,-2,"A"
NA,1982,"Barrow","Bangor City","1-5",1,5,5,5,6,-4,"A"
NA,1982,"Bath City","Bangor City","1-2",1,2,5,5,3,-1,"A"
NA,1982,"Boston United","Bangor City","4-3",4,3,5,5,7,1,"H"
NA,1982,"Dagenham","Bangor City","1-1",1,1,5,5,2,0,"D"
NA,1982,"Enfield","Bangor City","6-2",6,2,5,5,8,4,"H"
NA,1982,"Frickley Athletic","Bangor City","3-3",3,3,5,5,6,0,"D"
NA,1982,"Kettering Town","Bangor City","3-4",3,4,5,5,7,-1,"A"
NA,1982,"Maidstone United","Bangor City","6-1",6,1,5,5,7,5,"H"
NA,1982,"Northwich Victoria","Bangor City","1-4",1,4,5,5,5,-3,"A"
NA,1982,"Nuneaton Town","Bangor City","2-1",2,1,5,5,3,1,"H"
NA,1982,"Runcorn","Bangor City","1-2",1,2,5,5,3,-1,"A"
NA,1982,"Scarborough","Bangor City","2-0",2,0,5,5,2,2,"H"
NA,1982,"Stafford Rangers","Bangor City","1-1",1,1,5,5,2,0,"D"
NA,1982,"Telford United","Bangor City","2-0",2,0,5,5,2,2,"H"
NA,1982,"Trowbridge Town","Bangor City","3-2",3,2,5,5,5,1,"H"
NA,1982,"Wealdstone","Bangor City","2-0",2,0,5,5,2,2,"H"
NA,1982,"Weymouth","Bangor City","2-1",2,1,5,5,3,1,"H"
NA,1982,"Worcester City","Bangor City","1-1",1,1,5,5,2,0,"D"
NA,1982,"Yeovil","Bangor City","3-2",3,2,5,5,5,1,"H"
NA,1982,"Altrincham","Barnet","3-0",3,0,5,5,3,3,"H"
NA,1982,"Bangor City","Barnet","1-0",1,0,5,5,1,1,"H"
NA,1982,"Barrow","Barnet","0-1",0,1,5,5,1,-1,"A"
NA,1982,"Bath City","Barnet","0-2",0,2,5,5,2,-2,"A"
NA,1982,"Boston United","Barnet","1-0",1,0,5,5,1,1,"H"
NA,1982,"Dagenham","Barnet","1-2",1,2,5,5,3,-1,"A"
NA,1982,"Enfield","Barnet","5-0",5,0,5,5,5,5,"H"
NA,1982,"Frickley Athletic","Barnet","0-1",0,1,5,5,1,-1,"A"
NA,1982,"Kettering Town","Barnet","3-1",3,1,5,5,4,2,"H"
NA,1982,"Maidstone United","Barnet","2-0",2,0,5,5,2,2,"H"
NA,1982,"Northwich Victoria","Barnet","1-0",1,0,5,5,1,1,"H"
NA,1982,"Nuneaton Town","Barnet","1-0",1,0,5,5,1,1,"H"
NA,1982,"Runcorn","Barnet","2-0",2,0,5,5,2,2,"H"
NA,1982,"Scarborough","Barnet","0-2",0,2,5,5,2,-2,"A"
NA,1982,"Stafford Rangers","Barnet","1-0",1,0,5,5,1,1,"H"
NA,1982,"Telford United","Barnet","3-0",3,0,5,5,3,3,"H"
NA,1982,"Trowbridge Town","Barnet","0-2",0,2,5,5,2,-2,"A"
NA,1982,"Wealdstone","Barnet","6-0",6,0,5,5,6,6,"H"
NA,1982,"Weymouth","Barnet","1-3",1,3,5,5,4,-2,"A"
NA,1982,"Worcester City","Barnet","4-2",4,2,5,5,6,2,"H"
NA,1982,"Yeovil","Barnet","4-2",4,2,5,5,6,2,"H"
NA,1982,"Altrincham","Barrow","2-2",2,2,5,5,4,0,"D"
NA,1982,"Bangor City","Barrow","2-2",2,2,5,5,4,0,"D"
NA,1982,"Barnet","Barrow","2-1",2,1,5,5,3,1,"H"
NA,1982,"Bath City","Barrow","4-1",4,1,5,5,5,3,"H"
NA,1982,"Boston United","Barrow","2-1",2,1,5,5,3,1,"H"
NA,1982,"Dagenham","Barrow","0-0",0,0,5,5,0,0,"D"
NA,1982,"Enfield","Barrow","2-0",2,0,5,5,2,2,"H"
NA,1982,"Frickley Athletic","Barrow","1-1",1,1,5,5,2,0,"D"
NA,1982,"Kettering Town","Barrow","3-1",3,1,5,5,4,2,"H"
NA,1982,"Maidstone United","Barrow","2-0",2,0,5,5,2,2,"H"
NA,1982,"Northwich Victoria","Barrow","1-0",1,0,5,5,1,1,"H"
NA,1982,"Nuneaton Town","Barrow","1-1",1,1,5,5,2,0,"D"
NA,1982,"Runcorn","Barrow","2-1",2,1,5,5,3,1,"H"
NA,1982,"Scarborough","Barrow","1-1",1,1,5,5,2,0,"D"
NA,1982,"Stafford Rangers","Barrow","2-0",2,0,5,5,2,2,"H"
NA,1982,"Telford United","Barrow","1-3",1,3,5,5,4,-2,"A"
NA,1982,"Trowbridge Town","Barrow","2-1",2,1,5,5,3,1,"H"
NA,1982,"Wealdstone","Barrow","4-0",4,0,5,5,4,4,"H"
NA,1982,"Weymouth","Barrow","1-1",1,1,5,5,2,0,"D"
NA,1982,"Worcester City","Barrow","2-1",2,1,5,5,3,1,"H"
NA,1982,"Yeovil","Barrow","2-2",2,2,5,5,4,0,"D"
NA,1982,"Altrincham","Bath City","0-0",0,0,5,5,0,0,"D"
NA,1982,"Bangor City","Bath City","0-0",0,0,5,5,0,0,"D"
NA,1982,"Barnet","Bath City","2-1",2,1,5,5,3,1,"H"
NA,1982,"Barrow","Bath City","0-1",0,1,5,5,1,-1,"A"
NA,1982,"Boston United","Bath City","2-2",2,2,5,5,4,0,"D"
NA,1982,"Dagenham","Bath City","0-1",0,1,5,5,1,-1,"A"
NA,1982,"Enfield","Bath City","3-0",3,0,5,5,3,3,"H"
NA,1982,"Frickley Athletic","Bath City","2-1",2,1,5,5,3,1,"H"
NA,1982,"Kettering Town","Bath City","4-2",4,2,5,5,6,2,"H"
NA,1982,"Maidstone United","Bath City","0-1",0,1,5,5,1,-1,"A"
NA,1982,"Northwich Victoria","Bath City","3-0",3,0,5,5,3,3,"H"
NA,1982,"Nuneaton Town","Bath City","5-0",5,0,5,5,5,5,"H"
NA,1982,"Runcorn","Bath City","1-0",1,0,5,5,1,1,"H"
NA,1982,"Scarborough","Bath City","0-1",0,1,5,5,1,-1,"A"
NA,1982,"Stafford Rangers","Bath City","1-1",1,1,5,5,2,0,"D"
NA,1982,"Telford United","Bath City","2-0",2,0,5,5,2,2,"H"
NA,1982,"Trowbridge Town","Bath City","1-1",1,1,5,5,2,0,"D"
NA,1982,"Wealdstone","Bath City","1-1",1,1,5,5,2,0,"D"
NA,1982,"Weymouth","Bath City","1-0",1,0,5,5,1,1,"H"
NA,1982,"Worcester City","Bath City","1-4",1,4,5,5,5,-3,"A"
NA,1982,"Yeovil","Bath City","1-0",1,0,5,5,1,1,"H"
NA,1982,"Altrincham","Boston United","2-2",2,2,5,5,4,0,"D"
NA,1982,"Bangor City","Boston United","0-1",0,1,5,5,1,-1,"A"
NA,1982,"Barnet","Boston United","1-4",1,4,5,5,5,-3,"A"
NA,1982,"Barrow","Boston United","1-1",1,1,5,5,2,0,"D"
NA,1982,"Bath City","Boston United","3-2",3,2,5,5,5,1,"H"
NA,1982,"Dagenham","Boston United","1-1",1,1,5,5,2,0,"D"
NA,1982,"Enfield","Boston United","4-2",4,2,5,5,6,2,"H"
NA,1982,"Frickley Athletic","Boston United","2-0",2,0,5,5,2,2,"H"
NA,1982,"Kettering Town","Boston United","2-0",2,0,5,5,2,2,"H"
NA,1982,"Maidstone United","Boston United","2-0",2,0,5,5,2,2,"H"
NA,1982,"Northwich Victoria","Boston United","1-1",1,1,5,5,2,0,"D"
NA,1982,"Nuneaton Town","Boston United","1-2",1,2,5,5,3,-1,"A"
NA,1982,"Runcorn","Boston United","3-2",3,2,5,5,5,1,"H"
NA,1982,"Scarborough","Boston United","0-0",0,0,5,5,0,0,"D"
NA,1982,"Stafford Rangers","Boston United","0-2",0,2,5,5,2,-2,"A"
NA,1982,"Telford United","Boston United","3-2",3,2,5,5,5,1,"H"
NA,1982,"Trowbridge Town","Boston United","1-2",1,2,5,5,3,-1,"A"
NA,1982,"Wealdstone","Boston United","0-0",0,0,5,5,0,0,"D"
NA,1982,"Weymouth","Boston United","4-2",4,2,5,5,6,2,"H"
NA,1982,"Worcester City","Boston United","1-1",1,1,5,5,2,0,"D"
NA,1982,"Yeovil","Boston United","0-4",0,4,5,5,4,-4,"A"
NA,1982,"Altrincham","Dagenham","2-0",2,0,5,5,2,2,"H"
NA,1982,"Bangor City","Dagenham","1-1",1,1,5,5,2,0,"D"
NA,1982,"Barnet","Dagenham","2-2",2,2,5,5,4,0,"D"
NA,1982,"Barrow","Dagenham","1-2",1,2,5,5,3,-1,"A"
NA,1982,"Bath City","Dagenham","3-1",3,1,5,5,4,2,"H"
NA,1982,"Boston United","Dagenham","3-3",3,3,5,5,6,0,"D"
NA,1982,"Enfield","Dagenham","2-1",2,1,5,5,3,1,"H"
NA,1982,"Frickley Athletic","Dagenham","1-2",1,2,5,5,3,-1,"A"
NA,1982,"Kettering Town","Dagenham","1-2",1,2,5,5,3,-1,"A"
NA,1982,"Maidstone United","Dagenham","1-3",1,3,5,5,4,-2,"A"
NA,1982,"Northwich Victoria","Dagenham","3-0",3,0,5,5,3,3,"H"
NA,1982,"Nuneaton Town","Dagenham","1-1",1,1,5,5,2,0,"D"
NA,1982,"Runcorn","Dagenham","5-1",5,1,5,5,6,4,"H"
NA,1982,"Scarborough","Dagenham","1-1",1,1,5,5,2,0,"D"
NA,1982,"Stafford Rangers","Dagenham","1-2",1,2,5,5,3,-1,"A"
NA,1982,"Telford United","Dagenham","3-0",3,0,5,5,3,3,"H"
NA,1982,"Trowbridge Town","Dagenham","2-2",2,2,5,5,4,0,"D"
NA,1982,"Wealdstone","Dagenham","3-1",3,1,5,5,4,2,"H"
NA,1982,"Weymouth","Dagenham","0-1",0,1,5,5,1,-1,"A"
NA,1982,"Worcester City","Dagenham","1-4",1,4,5,5,5,-3,"A"
NA,1982,"Yeovil","Dagenham","2-0",2,0,5,5,2,2,"H"
NA,1982,"Altrincham","Enfield","2-2",2,2,5,5,4,0,"D"
NA,1982,"Bangor City","Enfield","0-0",0,0,5,5,0,0,"D"
NA,1982,"Barnet","Enfield","1-3",1,3,5,5,4,-2,"A"
NA,1982,"Barrow","Enfield","0-3",0,3,5,5,3,-3,"A"
NA,1982,"Bath City","Enfield","2-2",2,2,5,5,4,0,"D"
NA,1982,"Boston United","Enfield","0-2",0,2,5,5,2,-2,"A"
NA,1982,"Dagenham","Enfield","1-0",1,0,5,5,1,1,"H"
NA,1982,"Frickley Athletic","Enfield","5-2",5,2,5,5,7,3,"H"
NA,1982,"Kettering Town","Enfield","0-2",0,2,5,5,2,-2,"A"
NA,1982,"Maidstone United","Enfield","1-1",1,1,5,5,2,0,"D"
NA,1982,"Northwich Victoria","Enfield","3-1",3,1,5,5,4,2,"H"
NA,1982,"Nuneaton Town","Enfield","0-2",0,2,5,5,2,-2,"A"
NA,1982,"Runcorn","Enfield","2-2",2,2,5,5,4,0,"D"
NA,1982,"Scarborough","Enfield","0-2",0,2,5,5,2,-2,"A"
NA,1982,"Stafford Rangers","Enfield","0-3",0,3,5,5,3,-3,"A"
NA,1982,"Telford United","Enfield","4-3",4,3,5,5,7,1,"H"
NA,1982,"Trowbridge Town","Enfield","2-1",2,1,5,5,3,1,"H"
NA,1982,"Wealdstone","Enfield","1-3",1,3,5,5,4,-2,"A"
NA,1982,"Weymouth","Enfield","1-0",1,0,5,5,1,1,"H"
NA,1982,"Worcester City","Enfield","1-1",1,1,5,5,2,0,"D"
NA,1982,"Yeovil","Enfield","1-3",1,3,5,5,4,-2,"A"
NA,1982,"Altrincham","Frickley Athletic","2-2",2,2,5,5,4,0,"D"
NA,1982,"Bangor City","Frickley Athletic","1-0",1,0,5,5,1,1,"H"
NA,1982,"Barnet","Frickley Athletic","4-1",4,1,5,5,5,3,"H"
NA,1982,"Barrow","Frickley Athletic","2-0",2,0,5,5,2,2,"H"
NA,1982,"Bath City","Frickley Athletic","4-3",4,3,5,5,7,1,"H"
NA,1982,"Boston United","Frickley Athletic","2-1",2,1,5,5,3,1,"H"
NA,1982,"Dagenham","Frickley Athletic","4-1",4,1,5,5,5,3,"H"
NA,1982,"Enfield","Frickley Athletic","2-2",2,2,5,5,4,0,"D"
NA,1982,"Kettering Town","Frickley Athletic","4-1",4,1,5,5,5,3,"H"
NA,1982,"Maidstone United","Frickley Athletic","4-0",4,0,5,5,4,4,"H"
NA,1982,"Northwich Victoria","Frickley Athletic","2-1",2,1,5,5,3,1,"H"
NA,1982,"Nuneaton Town","Frickley Athletic","5-1",5,1,5,5,6,4,"H"
NA,1982,"Runcorn","Frickley Athletic","3-3",3,3,5,5,6,0,"D"
NA,1982,"Scarborough","Frickley Athletic","1-2",1,2,5,5,3,-1,"A"
NA,1982,"Stafford Rangers","Frickley Athletic","1-1",1,1,5,5,2,0,"D"
NA,1982,"Telford United","Frickley Athletic","1-1",1,1,5,5,2,0,"D"
NA,1982,"Trowbridge Town","Frickley Athletic","2-0",2,0,5,5,2,2,"H"
NA,1982,"Wealdstone","Frickley Athletic","2-0",2,0,5,5,2,2,"H"
NA,1982,"Weymouth","Frickley Athletic","0-0",0,0,5,5,0,0,"D"
NA,1982,"Worcester City","Frickley Athletic","4-4",4,4,5,5,8,0,"D"
NA,1982,"Yeovil","Frickley Athletic","2-1",2,1,5,5,3,1,"H"
NA,1982,"Altrincham","Kettering Town","3-1",3,1,5,5,4,2,"H"
NA,1982,"Bangor City","Kettering Town","4-2",4,2,5,5,6,2,"H"
NA,1982,"Barnet","Kettering Town","2-3",2,3,5,5,5,-1,"A"
NA,1982,"Barrow","Kettering Town","2-0",2,0,5,5,2,2,"H"
NA,1982,"Bath City","Kettering Town","2-1",2,1,5,5,3,1,"H"
NA,1982,"Boston United","Kettering Town","2-1",2,1,5,5,3,1,"H"
NA,1982,"Dagenham","Kettering Town","2-3",2,3,5,5,5,-1,"A"
NA,1982,"Enfield","Kettering Town","5-2",5,2,5,5,7,3,"H"
NA,1982,"Frickley Athletic","Kettering Town","3-2",3,2,5,5,5,1,"H"
NA,1982,"Maidstone United","Kettering Town","5-1",5,1,5,5,6,4,"H"
NA,1982,"Northwich Victoria","Kettering Town","2-1",2,1,5,5,3,1,"H"
NA,1982,"Nuneaton Town","Kettering Town","0-0",0,0,5,5,0,0,"D"
NA,1982,"Runcorn","Kettering Town","6-0",6,0,5,5,6,6,"H"
NA,1982,"Scarborough","Kettering Town","3-0",3,0,5,5,3,3,"H"
NA,1982,"Stafford Rangers","Kettering Town","1-1",1,1,5,5,2,0,"D"
NA,1982,"Telford United","Kettering Town","2-1",2,1,5,5,3,1,"H"
NA,1982,"Trowbridge Town","Kettering Town","2-1",2,1,5,5,3,1,"H"
NA,1982,"Wealdstone","Kettering Town","4-0",4,0,5,5,4,4,"H"
NA,1982,"Weymouth","Kettering Town","1-1",1,1,5,5,2,0,"D"
NA,1982,"Worcester City","Kettering Town","2-0",2,0,5,5,2,2,"H"
NA,1982,"Yeovil","Kettering Town","2-1",2,1,5,5,3,1,"H"
NA,1982,"Altrincham","Maidstone United","0-2",0,2,5,5,2,-2,"A"
NA,1982,"Bangor City","Maidstone United","2-2",2,2,5,5,4,0,"D"
NA,1982,"Barnet","Maidstone United","1-3",1,3,5,5,4,-2,"A"
NA,1982,"Barrow","Maidstone United","0-3",0,3,5,5,3,-3,"A"
NA,1982,"Bath City","Maidstone United","0-1",0,1,5,5,1,-1,"A"
NA,1982,"Boston United","Maidstone United","1-0",1,0,5,5,1,1,"H"
NA,1982,"Dagenham","Maidstone United","0-1",0,1,5,5,1,-1,"A"
NA,1982,"Enfield","Maidstone United","1-0",1,0,5,5,1,1,"H"
NA,1982,"Frickley Athletic","Maidstone United","2-1",2,1,5,5,3,1,"H"
NA,1982,"Kettering Town","Maidstone United","1-3",1,3,5,5,4,-2,"A"
NA,1982,"Northwich Victoria","Maidstone United","2-1",2,1,5,5,3,1,"H"
NA,1982,"Nuneaton Town","Maidstone United","2-2",2,2,5,5,4,0,"D"
NA,1982,"Runcorn","Maidstone United","1-1",1,1,5,5,2,0,"D"
NA,1982,"Scarborough","Maidstone United","2-1",2,1,5,5,3,1,"H"
NA,1982,"Stafford Rangers","Maidstone United","2-3",2,3,5,5,5,-1,"A"
NA,1982,"Telford United","Maidstone United","3-1",3,1,5,5,4,2,"H"
NA,1982,"Trowbridge Town","Maidstone United","0-2",0,2,5,5,2,-2,"A"
NA,1982,"Wealdstone","Maidstone United","0-0",0,0,5,5,0,0,"D"
NA,1982,"Weymouth","Maidstone United","0-0",0,0,5,5,0,0,"D"
NA,1982,"Worcester City","Maidstone United","1-1",1,1,5,5,2,0,"D"
NA,1982,"Yeovil","Maidstone United","0-0",0,0,5,5,0,0,"D"
NA,1982,"Altrincham","Northwich Victoria","3-0",3,0,5,5,3,3,"H"
NA,1982,"Bangor City","Northwich Victoria","1-1",1,1,5,5,2,0,"D"
NA,1982,"Barnet","Northwich Victoria","4-2",4,2,5,5,6,2,"H"
NA,1982,"Barrow","Northwich Victoria","0-0",0,0,5,5,0,0,"D"
NA,1982,"Bath City","Northwich Victoria","3-0",3,0,5,5,3,3,"H"
NA,1982,"Boston United","Northwich Victoria","1-0",1,0,5,5,1,1,"H"
NA,1982,"Dagenham","Northwich Victoria","3-1",3,1,5,5,4,2,"H"
NA,1982,"Enfield","Northwich Victoria","2-1",2,1,5,5,3,1,"H"
NA,1982,"Frickley Athletic","Northwich Victoria","0-0",0,0,5,5,0,0,"D"
NA,1982,"Kettering Town","Northwich Victoria","1-4",1,4,5,5,5,-3,"A"
NA,1982,"Maidstone United","Northwich Victoria","1-0",1,0,5,5,1,1,"H"
NA,1982,"Nuneaton Town","Northwich Victoria","2-1",2,1,5,5,3,1,"H"
NA,1982,"Runcorn","Northwich Victoria","1-1",1,1,5,5,2,0,"D"
NA,1982,"Scarborough","Northwich Victoria","5-1",5,1,5,5,6,4,"H"
NA,1982,"Stafford Rangers","Northwich Victoria","1-1",1,1,5,5,2,0,"D"
NA,1982,"Telford United","Northwich Victoria","3-0",3,0,5,5,3,3,"H"
NA,1982,"Trowbridge Town","Northwich Victoria","0-2",0,2,5,5,2,-2,"A"
NA,1982,"Wealdstone","Northwich Victoria","2-1",2,1,5,5,3,1,"H"
NA,1982,"Weymouth","Northwich Victoria","3-0",3,0,5,5,3,3,"H"
NA,1982,"Worcester City","Northwich Victoria","3-0",3,0,5,5,3,3,"H"
NA,1982,"Yeovil","Northwich Victoria","2-4",2,4,5,5,6,-2,"A"
NA,1982,"Altrincham","Nuneaton Town","1-2",1,2,5,5,3,-1,"A"
NA,1982,"Bangor City","Nuneaton Town","5-2",5,2,5,5,7,3,"H"
NA,1982,"Barnet","Nuneaton Town","1-0",1,0,5,5,1,1,"H"
NA,1982,"Barrow","Nuneaton Town","2-2",2,2,5,5,4,0,"D"
NA,1982,"Bath City","Nuneaton Town","3-0",3,0,5,5,3,3,"H"
NA,1982,"Boston United","Nuneaton Town","1-1",1,1,5,5,2,0,"D"
NA,1982,"Dagenham","Nuneaton Town","0-0",0,0,5,5,0,0,"D"
NA,1982,"Enfield","Nuneaton Town","1-1",1,1,5,5,2,0,"D"
NA,1982,"Frickley Athletic","Nuneaton Town","2-1",2,1,5,5,3,1,"H"
NA,1982,"Kettering Town","Nuneaton Town","0-0",0,0,5,5,0,0,"D"
NA,1982,"Maidstone United","Nuneaton Town","2-0",2,0,5,5,2,2,"H"
NA,1982,"Northwich Victoria","Nuneaton Town","2-2",2,2,5,5,4,0,"D"
NA,1982,"Runcorn","Nuneaton Town","3-1",3,1,5,5,4,2,"H"
NA,1982,"Scarborough","Nuneaton Town","3-0",3,0,5,5,3,3,"H"
NA,1982,"Stafford Rangers","Nuneaton Town","1-2",1,2,5,5,3,-1,"A"
NA,1982,"Telford United","Nuneaton Town","2-0",2,0,5,5,2,2,"H"
NA,1982,"Trowbridge Town","Nuneaton Town","0-2",0,2,5,5,2,-2,"A"
NA,1982,"Wealdstone","Nuneaton Town","1-2",1,2,5,5,3,-1,"A"
NA,1982,"Weymouth","Nuneaton Town","3-0",3,0,5,5,3,3,"H"
NA,1982,"Worcester City","Nuneaton Town","1-1",1,1,5,5,2,0,"D"
NA,1982,"Yeovil","Nuneaton Town","6-2",6,2,5,5,8,4,"H"
NA,1982,"Altrincham","Runcorn","2-1",2,1,5,5,3,1,"H"
NA,1982,"Bangor City","Runcorn","1-2",1,2,5,5,3,-1,"A"
NA,1982,"Barnet","Runcorn","2-0",2,0,5,5,2,2,"H"
NA,1982,"Barrow","Runcorn","1-2",1,2,5,5,3,-1,"A"
NA,1982,"Bath City","Runcorn","2-1",2,1,5,5,3,1,"H"
NA,1982,"Boston United","Runcorn","2-4",2,4,5,5,6,-2,"A"
NA,1982,"Dagenham","Runcorn","3-1",3,1,5,5,4,2,"H"
NA,1982,"Enfield","Runcorn","0-0",0,0,5,5,0,0,"D"
NA,1982,"Frickley Athletic","Runcorn","0-2",0,2,5,5,2,-2,"A"
NA,1982,"Kettering Town","Runcorn","3-1",3,1,5,5,4,2,"H"
NA,1982,"Maidstone United","Runcorn","2-0",2,0,5,5,2,2,"H"
NA,1982,"Northwich Victoria","Runcorn","2-0",2,0,5,5,2,2,"H"
NA,1982,"Nuneaton Town","Runcorn","0-2",0,2,5,5,2,-2,"A"
NA,1982,"Scarborough","Runcorn","3-2",3,2,5,5,5,1,"H"
NA,1982,"Stafford Rangers","Runcorn","0-1",0,1,5,5,1,-1,"A"
NA,1982,"Telford United","Runcorn","4-0",4,0,5,5,4,4,"H"
NA,1982,"Trowbridge Town","Runcorn","1-2",1,2,5,5,3,-1,"A"
NA,1982,"Wealdstone","Runcorn","1-0",1,0,5,5,1,1,"H"
NA,1982,"Weymouth","Runcorn","1-1",1,1,5,5,2,0,"D"
NA,1982,"Worcester City","Runcorn","1-0",1,0,5,5,1,1,"H"
NA,1982,"Yeovil","Runcorn","1-1",1,1,5,5,2,0,"D"
NA,1982,"Altrincham","Scarborough","2-1",2,1,5,5,3,1,"H"
NA,1982,"Bangor City","Scarborough","0-3",0,3,5,5,3,-3,"A"
NA,1982,"Barnet","Scarborough","2-3",2,3,5,5,5,-1,"A"
NA,1982,"Barrow","Scarborough","1-2",1,2,5,5,3,-1,"A"
NA,1982,"Bath City","Scarborough","2-3",2,3,5,5,5,-1,"A"
NA,1982,"Boston United","Scarborough","1-0",1,0,5,5,1,1,"H"
NA,1982,"Dagenham","Scarborough","1-1",1,1,5,5,2,0,"D"
NA,1982,"Enfield","Scarborough","5-3",5,3,5,5,8,2,"H"
NA,1982,"Frickley Athletic","Scarborough","2-1",2,1,5,5,3,1,"H"
NA,1982,"Kettering Town","Scarborough","2-2",2,2,5,5,4,0,"D"
NA,1982,"Maidstone United","Scarborough","6-0",6,0,5,5,6,6,"H"
NA,1982,"Northwich Victoria","Scarborough","1-1",1,1,5,5,2,0,"D"
NA,1982,"Nuneaton Town","Scarborough","0-2",0,2,5,5,2,-2,"A"
NA,1982,"Runcorn","Scarborough","2-1",2,1,5,5,3,1,"H"
NA,1982,"Stafford Rangers","Scarborough","0-0",0,0,5,5,0,0,"D"
NA,1982,"Telford United","Scarborough","0-2",0,2,5,5,2,-2,"A"
NA,1982,"Trowbridge Town","Scarborough","1-1",1,1,5,5,2,0,"D"
NA,1982,"Wealdstone","Scarborough","2-2",2,2,5,5,4,0,"D"
NA,1982,"Weymouth","Scarborough","2-0",2,0,5,5,2,2,"H"
NA,1982,"Worcester City","Scarborough","1-3",1,3,5,5,4,-2,"A"
NA,1982,"Yeovil","Scarborough","2-1",2,1,5,5,3,1,"H"
NA,1982,"Altrincham","Stafford Rangers","4-0",4,0,5,5,4,4,"H"
NA,1982,"Bangor City","Stafford Rangers","1-0",1,0,5,5,1,1,"H"
NA,1982,"Barnet","Stafford Rangers","1-0",1,0,5,5,1,1,"H"
NA,1982,"Barrow","Stafford Rangers","2-1",2,1,5,5,3,1,"H"
NA,1982,"Bath City","Stafford Rangers","5-1",5,1,5,5,6,4,"H"
NA,1982,"Boston United","Stafford Rangers","1-1",1,1,5,5,2,0,"D"
NA,1982,"Dagenham","Stafford Rangers","3-3",3,3,5,5,6,0,"D"
NA,1982,"Enfield","Stafford Rangers","0-1",0,1,5,5,1,-1,"A"
NA,1982,"Frickley Athletic","Stafford Rangers","3-0",3,0,5,5,3,3,"H"
NA,1982,"Kettering Town","Stafford Rangers","2-2",2,2,5,5,4,0,"D"
NA,1982,"Maidstone United","Stafford Rangers","1-0",1,0,5,5,1,1,"H"
NA,1982,"Northwich Victoria","Stafford Rangers","2-1",2,1,5,5,3,1,"H"
NA,1982,"Nuneaton Town","Stafford Rangers","1-1",1,1,5,5,2,0,"D"
NA,1982,"Runcorn","Stafford Rangers","4-1",4,1,5,5,5,3,"H"
NA,1982,"Scarborough","Stafford Rangers","2-1",2,1,5,5,3,1,"H"
NA,1982,"Telford United","Stafford Rangers","2-0",2,0,5,5,2,2,"H"
NA,1982,"Trowbridge Town","Stafford Rangers","5-3",5,3,5,5,8,2,"H"
NA,1982,"Wealdstone","Stafford Rangers","3-2",3,2,5,5,5,1,"H"
NA,1982,"Weymouth","Stafford Rangers","0-0",0,0,5,5,0,0,"D"
NA,1982,"Worcester City","Stafford Rangers","3-0",3,0,5,5,3,3,"H"
NA,1982,"Yeovil","Stafford Rangers","0-0",0,0,5,5,0,0,"D"
NA,1982,"Altrincham","Telford United","1-0",1,0,5,5,1,1,"H"
NA,1982,"Bangor City","Telford United","1-1",1,1,5,5,2,0,"D"
NA,1982,"Barnet","Telford United","0-2",0,2,5,5,2,-2,"A"
NA,1982,"Barrow","Telford United","0-5",0,5,5,5,5,-5,"A"
NA,1982,"Bath City","Telford United","0-0",0,0,5,5,0,0,"D"
NA,1982,"Boston United","Telford United","4-0",4,0,5,5,4,4,"H"
NA,1982,"Dagenham","Telford United","1-1",1,1,5,5,2,0,"D"
NA,1982,"Enfield","Telford United","6-2",6,2,5,5,8,4,"H"
NA,1982,"Frickley Athletic","Telford United","2-2",2,2,5,5,4,0,"D"
NA,1982,"Kettering Town","Telford United","1-2",1,2,5,5,3,-1,"A"
NA,1982,"Maidstone United","Telford United","1-0",1,0,5,5,1,1,"H"
NA,1982,"Northwich Victoria","Telford United","2-1",2,1,5,5,3,1,"H"
NA,1982,"Nuneaton Town","Telford United","2-1",2,1,5,5,3,1,"H"
NA,1982,"Runcorn","Telford United","0-0",0,0,5,5,0,0,"D"
NA,1982,"Scarborough","Telford United","1-1",1,1,5,5,2,0,"D"
NA,1982,"Stafford Rangers","Telford United","1-1",1,1,5,5,2,0,"D"
NA,1982,"Trowbridge Town","Telford United","2-0",2,0,5,5,2,2,"H"
NA,1982,"Wealdstone","Telford United","2-0",2,0,5,5,2,2,"H"
NA,1982,"Weymouth","Telford United","0-0",0,0,5,5,0,0,"D"
NA,1982,"Worcester City","Telford United","1-0",1,0,5,5,1,1,"H"
NA,1982,"Yeovil","Telford United","3-4",3,4,5,5,7,-1,"A"
NA,1982,"Altrincham","Trowbridge Town","2-0",2,0,5,5,2,2,"H"
NA,1982,"Bangor City","Trowbridge Town","4-3",4,3,5,5,7,1,"H"
NA,1982,"Barnet","Trowbridge Town","1-3",1,3,5,5,4,-2,"A"
NA,1982,"Barrow","Trowbridge Town","3-2",3,2,5,5,5,1,"H"
NA,1982,"Bath City","Trowbridge Town","2-0",2,0,5,5,2,2,"H"
NA,1982,"Boston United","Trowbridge Town","3-0",3,0,5,5,3,3,"H"
NA,1982,"Dagenham","Trowbridge Town","0-1",0,1,5,5,1,-1,"A"
NA,1982,"Enfield","Trowbridge Town","2-0",2,0,5,5,2,2,"H"
NA,1982,"Frickley Athletic","Trowbridge Town","2-2",2,2,5,5,4,0,"D"
NA,1982,"Kettering Town","Trowbridge Town","1-1",1,1,5,5,2,0,"D"
NA,1982,"Maidstone United","Trowbridge Town","6-0",6,0,5,5,6,6,"H"
NA,1982,"Northwich Victoria","Trowbridge Town","6-3",6,3,5,5,9,3,"H"
NA,1982,"Nuneaton Town","Trowbridge Town","2-0",2,0,5,5,2,2,"H"
NA,1982,"Runcorn","Trowbridge Town","3-2",3,2,5,5,5,1,"H"
NA,1982,"Scarborough","Trowbridge Town","5-2",5,2,5,5,7,3,"H"
NA,1982,"Stafford Rangers","Trowbridge Town","3-2",3,2,5,5,5,1,"H"
NA,1982,"Telford United","Trowbridge Town","3-1",3,1,5,5,4,2,"H"
NA,1982,"Wealdstone","Trowbridge Town","4-0",4,0,5,5,4,4,"H"
NA,1982,"Weymouth","Trowbridge Town","2-1",2,1,5,5,3,1,"H"
NA,1982,"Worcester City","Trowbridge Town","4-1",4,1,5,5,5,3,"H"
NA,1982,"Yeovil","Trowbridge Town","0-1",0,1,5,5,1,-1,"A"
NA,1982,"Altrincham","Wealdstone","0-1",0,1,5,5,1,-1,"A"
NA,1982,"Bangor City","Wealdstone","2-2",2,2,5,5,4,0,"D"
NA,1982,"Barnet","Wealdstone","0-0",0,0,5,5,0,0,"D"
NA,1982,"Barrow","Wealdstone","0-2",0,2,5,5,2,-2,"A"
NA,1982,"Bath City","Wealdstone","3-2",3,2,5,5,5,1,"H"
NA,1982,"Boston United","Wealdstone","0-0",0,0,5,5,0,0,"D"
NA,1982,"Dagenham","Wealdstone","1-2",1,2,5,5,3,-1,"A"
NA,1982,"Enfield","Wealdstone","0-1",0,1,5,5,1,-1,"A"
NA,1982,"Frickley Athletic","Wealdstone","2-2",2,2,5,5,4,0,"D"
NA,1982,"Kettering Town","Wealdstone","1-3",1,3,5,5,4,-2,"A"
NA,1982,"Maidstone United","Wealdstone","0-3",0,3,5,5,3,-3,"A"
NA,1982,"Northwich Victoria","Wealdstone","3-3",3,3,5,5,6,0,"D"
NA,1982,"Nuneaton Town","Wealdstone","1-1",1,1,5,5,2,0,"D"
NA,1982,"Runcorn","Wealdstone","2-1",2,1,5,5,3,1,"H"
NA,1982,"Scarborough","Wealdstone","1-2",1,2,5,5,3,-1,"A"
NA,1982,"Stafford Rangers","Wealdstone","2-1",2,1,5,5,3,1,"H"
NA,1982,"Telford United","Wealdstone","0-0",0,0,5,5,0,0,"D"
NA,1982,"Trowbridge Town","Wealdstone","0-0",0,0,5,5,0,0,"D"
NA,1982,"Weymouth","Wealdstone","4-1",4,1,5,5,5,3,"H"
NA,1982,"Worcester City","Wealdstone","1-3",1,3,5,5,4,-2,"A"
NA,1982,"Yeovil","Wealdstone","1-5",1,5,5,5,6,-4,"A"
NA,1982,"Altrincham","Weymouth","1-0",1,0,5,5,1,1,"H"
NA,1982,"Bangor City","Weymouth","4-3",4,3,5,5,7,1,"H"
NA,1982,"Barnet","Weymouth","1-2",1,2,5,5,3,-1,"A"
NA,1982,"Barrow","Weymouth","3-0",3,0,5,5,3,3,"H"
NA,1982,"Bath City","Weymouth","0-1",0,1,5,5,1,-1,"A"
NA,1982,"Boston United","Weymouth","3-2",3,2,5,5,5,1,"H"
NA,1982,"Dagenham","Weymouth","1-2",1,2,5,5,3,-1,"A"
NA,1982,"Enfield","Weymouth","2-1",2,1,5,5,3,1,"H"
NA,1982,"Frickley Athletic","Weymouth","1-2",1,2,5,5,3,-1,"A"
NA,1982,"Kettering Town","Weymouth","1-1",1,1,5,5,2,0,"D"
NA,1982,"Maidstone United","Weymouth","3-0",3,0,5,5,3,3,"H"
NA,1982,"Northwich Victoria","Weymouth","1-1",1,1,5,5,2,0,"D"
NA,1982,"Nuneaton Town","Weymouth","2-0",2,0,5,5,2,2,"H"
NA,1982,"Runcorn","Weymouth","1-0",1,0,5,5,1,1,"H"
NA,1982,"Scarborough","Weymouth","2-0",2,0,5,5,2,2,"H"
NA,1982,"Stafford Rangers","Weymouth","1-2",1,2,5,5,3,-1,"A"
NA,1982,"Telford United","Weymouth","2-0",2,0,5,5,2,2,"H"
NA,1982,"Trowbridge Town","Weymouth","0-0",0,0,5,5,0,0,"D"
NA,1982,"Wealdstone","Weymouth","2-4",2,4,5,5,6,-2,"A"
NA,1982,"Worcester City","Weymouth","3-3",3,3,5,5,6,0,"D"
NA,1982,"Yeovil","Weymouth","0-2",0,2,5,5,2,-2,"A"
NA,1982,"Altrincham","Worcester City","2-0",2,0,5,5,2,2,"H"
NA,1982,"Bangor City","Worcester City","0-2",0,2,5,5,2,-2,"A"
NA,1982,"Barnet","Worcester City","3-1",3,1,5,5,4,2,"H"
NA,1982,"Barrow","Worcester City","2-0",2,0,5,5,2,2,"H"
NA,1982,"Bath City","Worcester City","0-0",0,0,5,5,0,0,"D"
NA,1982,"Boston United","Worcester City","4-1",4,1,5,5,5,3,"H"
NA,1982,"Dagenham","Worcester City","3-3",3,3,5,5,6,0,"D"
NA,1982,"Enfield","Worcester City","4-0",4,0,5,5,4,4,"H"
NA,1982,"Frickley Athletic","Worcester City","2-0",2,0,5,5,2,2,"H"
NA,1982,"Kettering Town","Worcester City","4-1",4,1,5,5,5,3,"H"
NA,1982,"Maidstone United","Worcester City","5-0",5,0,5,5,5,5,"H"
NA,1982,"Northwich Victoria","Worcester City","3-0",3,0,5,5,3,3,"H"
NA,1982,"Nuneaton Town","Worcester City","2-0",2,0,5,5,2,2,"H"
NA,1982,"Runcorn","Worcester City","3-1",3,1,5,5,4,2,"H"
NA,1982,"Scarborough","Worcester City","4-1",4,1,5,5,5,3,"H"
NA,1982,"Stafford Rangers","Worcester City","0-0",0,0,5,5,0,0,"D"
NA,1982,"Telford United","Worcester City","2-0",2,0,5,5,2,2,"H"
NA,1982,"Trowbridge Town","Worcester City","2-3",2,3,5,5,5,-1,"A"
NA,1982,"Wealdstone","Worcester City","2-0",2,0,5,5,2,2,"H"
NA,1982,"Weymouth","Worcester City","4-2",4,2,5,5,6,2,"H"
NA,1982,"Yeovil","Worcester City","3-0",3,0,5,5,3,3,"H"
NA,1982,"Altrincham","Yeovil","4-1",4,1,5,5,5,3,"H"
NA,1982,"Bangor City","Yeovil","2-2",2,2,5,5,4,0,"D"
NA,1982,"Barnet","Yeovil","4-4",4,4,5,5,8,0,"D"
NA,1982,"Barrow","Yeovil","3-1",3,1,5,5,4,2,"H"
NA,1982,"Bath City","Yeovil","2-0",2,0,5,5,2,2,"H"
NA,1982,"Boston United","Yeovil","6-3",6,3,5,5,9,3,"H"
NA,1982,"Dagenham","Yeovil","3-0",3,0,5,5,3,3,"H"
NA,1982,"Enfield","Yeovil","3-1",3,1,5,5,4,2,"H"
NA,1982,"Frickley Athletic","Yeovil","3-0",3,0,5,5,3,3,"H"
NA,1982,"Kettering Town","Yeovil","5-2",5,2,5,5,7,3,"H"
NA,1982,"Maidstone United","Yeovil","2-1",2,1,5,5,3,1,"H"
NA,1982,"Northwich Victoria","Yeovil","5-0",5,0,5,5,5,5,"H"
NA,1982,"Nuneaton Town","Yeovil","3-1",3,1,5,5,4,2,"H"
NA,1982,"Runcorn","Yeovil","4-1",4,1,5,5,5,3,"H"
NA,1982,"Scarborough","Yeovil","2-2",2,2,5,5,4,0,"D"
NA,1982,"Stafford Rangers","Yeovil","1-3",1,3,5,5,4,-2,"A"
NA,1982,"Telford United","Yeovil","3-2",3,2,5,5,5,1,"H"
NA,1982,"Trowbridge Town","Yeovil","2-1",2,1,5,5,3,1,"H"
NA,1982,"Wealdstone","Yeovil","2-0",2,0,5,5,2,2,"H"
NA,1982,"Weymouth","Yeovil","2-0",2,0,5,5,2,2,"H"
NA,1982,"Worcester City","Yeovil","2-1",2,1,5,5,3,1,"H"
NA,1983,"Bangor City","Altrincham","1-3",1,3,5,5,4,-2,"A"
NA,1983,"Barnet","Altrincham","1-2",1,2,5,5,3,-1,"A"
NA,1983,"Bath City","Altrincham","0-0",0,0,5,5,0,0,"D"
NA,1983,"Boston United","Altrincham","2-2",2,2,5,5,4,0,"D"
NA,1983,"Dagenham","Altrincham","0-2",0,2,5,5,2,-2,"A"
NA,1983,"Enfield","Altrincham","0-1",0,1,5,5,1,-1,"A"
NA,1983,"Frickley Athletic","Altrincham","3-1",3,1,5,5,4,2,"H"
NA,1983,"Gateshead","Altrincham","0-1",0,1,5,5,1,-1,"A"
NA,1983,"Kettering Town","Altrincham","1-1",1,1,5,5,2,0,"D"
NA,1983,"Kidderminster Harriers","Altrincham","0-2",0,2,5,5,2,-2,"A"
NA,1983,"Maidstone United","Altrincham","1-0",1,0,5,5,1,1,"H"
NA,1983,"Northwich Victoria","Altrincham","1-1",1,1,5,5,2,0,"D"
NA,1983,"Nuneaton Town","Altrincham","0-1",0,1,5,5,1,-1,"A"
NA,1983,"Runcorn","Altrincham","0-0",0,0,5,5,0,0,"D"
NA,1983,"Scarborough","Altrincham","3-1",3,1,5,5,4,2,"H"
NA,1983,"Telford United","Altrincham","2-1",2,1,5,5,3,1,"H"
NA,1983,"Trowbridge Town","Altrincham","0-0",0,0,5,5,0,0,"D"
NA,1983,"Wealdstone","Altrincham","3-1",3,1,5,5,4,2,"H"
NA,1983,"Weymouth","Altrincham","0-1",0,1,5,5,1,-1,"A"
NA,1983,"Worcester City","Altrincham","0-1",0,1,5,5,1,-1,"A"
NA,1983,"Yeovil","Altrincham","1-2",1,2,5,5,3,-1,"A"
NA,1983,"Altrincham","Bangor City","2-1",2,1,5,5,3,1,"H"
NA,1983,"Barnet","Bangor City","3-1",3,1,5,5,4,2,"H"
NA,1983,"Bath City","Bangor City","5-1",5,1,5,5,6,4,"H"
NA,1983,"Boston United","Bangor City","3-2",3,2,5,5,5,1,"H"
NA,1983,"Dagenham","Bangor City","3-1",3,1,5,5,4,2,"H"
NA,1983,"Enfield","Bangor City","3-1",3,1,5,5,4,2,"H"
NA,1983,"Frickley Athletic","Bangor City","2-0",2,0,5,5,2,2,"H"
NA,1983,"Gateshead","Bangor City","2-1",2,1,5,5,3,1,"H"
NA,1983,"Kettering Town","Bangor City","1-3",1,3,5,5,4,-2,"A"
NA,1983,"Kidderminster Harriers","Bangor City","2-1",2,1,5,5,3,1,"H"
NA,1983,"Maidstone United","Bangor City","2-0",2,0,5,5,2,2,"H"
NA,1983,"Northwich Victoria","Bangor City","2-1",2,1,5,5,3,1,"H"
NA,1983,"Nuneaton Town","Bangor City","3-0",3,0,5,5,3,3,"H"
NA,1983,"Runcorn","Bangor City","0-2",0,2,5,5,2,-2,"A"
NA,1983,"Scarborough","Bangor City","3-0",3,0,5,5,3,3,"H"
NA,1983,"Telford United","Bangor City","2-1",2,1,5,5,3,1,"H"
NA,1983,"Trowbridge Town","Bangor City","1-2",1,2,5,5,3,-1,"A"
NA,1983,"Wealdstone","Bangor City","5-0",5,0,5,5,5,5,"H"
NA,1983,"Weymouth","Bangor City","5-0",5,0,5,5,5,5,"H"
NA,1983,"Worcester City","Bangor City","0-0",0,0,5,5,0,0,"D"
NA,1983,"Yeovil","Bangor City","1-1",1,1,5,5,2,0,"D"
NA,1983,"Altrincham","Barnet","3-2",3,2,5,5,5,1,"H"
NA,1983,"Bangor City","Barnet","0-1",0,1,5,5,1,-1,"A"
NA,1983,"Bath City","Barnet","0-1",0,1,5,5,1,-1,"A"
NA,1983,"Boston United","Barnet","0-0",0,0,5,5,0,0,"D"
NA,1983,"Dagenham","Barnet","3-1",3,1,5,5,4,2,"H"
NA,1983,"Enfield","Barnet","0-1",0,1,5,5,1,-1,"A"
NA,1983,"Frickley Athletic","Barnet","3-1",3,1,5,5,4,2,"H"
NA,1983,"Gateshead","Barnet","2-3",2,3,5,5,5,-1,"A"
NA,1983,"Kettering Town","Barnet","0-1",0,1,5,5,1,-1,"A"
NA,1983,"Kidderminster Harriers","Barnet","4-4",4,4,5,5,8,0,"D"
NA,1983,"Maidstone United","Barnet","1-1",1,1,5,5,2,0,"D"
NA,1983,"Northwich Victoria","Barnet","0-0",0,0,5,5,0,0,"D"
NA,1983,"Nuneaton Town","Barnet","2-2",2,2,5,5,4,0,"D"
NA,1983,"Runcorn","Barnet","2-0",2,0,5,5,2,2,"H"
NA,1983,"Scarborough","Barnet","1-0",1,0,5,5,1,1,"H"
NA,1983,"Telford United","Barnet","0-0",0,0,5,5,0,0,"D"
NA,1983,"Trowbridge Town","Barnet","0-4",0,4,5,5,4,-4,"A"
NA,1983,"Wealdstone","Barnet","3-0",3,0,5,5,3,3,"H"
NA,1983,"Weymouth","Barnet","2-2",2,2,5,5,4,0,"D"
NA,1983,"Worcester City","Barnet","2-0",2,0,5,5,2,2,"H"
NA,1983,"Yeovil","Barnet","2-4",2,4,5,5,6,-2,"A"
NA,1983,"Altrincham","Bath City","2-0",2,0,5,5,2,2,"H"
NA,1983,"Bangor City","Bath City","1-0",1,0,5,5,1,1,"H"
NA,1983,"Barnet","Bath City","1-2",1,2,5,5,3,-1,"A"
NA,1983,"Boston United","Bath City","0-0",0,0,5,5,0,0,"D"
NA,1983,"Dagenham","Bath City","3-1",3,1,5,5,4,2,"H"
NA,1983,"Enfield","Bath City","2-0",2,0,5,5,2,2,"H"
NA,1983,"Frickley Athletic","Bath City","1-2",1,2,5,5,3,-1,"A"
NA,1983,"Gateshead","Bath City","3-1",3,1,5,5,4,2,"H"
NA,1983,"Kettering Town","Bath City","0-0",0,0,5,5,0,0,"D"
NA,1983,"Kidderminster Harriers","Bath City","1-1",1,1,5,5,2,0,"D"
NA,1983,"Maidstone United","Bath City","1-1",1,1,5,5,2,0,"D"
NA,1983,"Northwich Victoria","Bath City","3-2",3,2,5,5,5,1,"H"
NA,1983,"Nuneaton Town","Bath City","5-2",5,2,5,5,7,3,"H"
NA,1983,"Runcorn","Bath City","2-1",2,1,5,5,3,1,"H"
NA,1983,"Scarborough","Bath City","0-0",0,0,5,5,0,0,"D"
NA,1983,"Telford United","Bath City","3-2",3,2,5,5,5,1,"H"
NA,1983,"Trowbridge Town","Bath City","1-2",1,2,5,5,3,-1,"A"
NA,1983,"Wealdstone","Bath City","0-3",0,3,5,5,3,-3,"A"
NA,1983,"Weymouth","Bath City","0-1",0,1,5,5,1,-1,"A"
NA,1983,"Worcester City","Bath City","2-4",2,4,5,5,6,-2,"A"
NA,1983,"Yeovil","Bath City","0-2",0,2,5,5,2,-2,"A"
NA,1983,"Altrincham","Boston United","3-0",3,0,5,5,3,3,"H"
NA,1983,"Bangor City","Boston United","0-0",0,0,5,5,0,0,"D"
NA,1983,"Barnet","Boston United","1-2",1,2,5,5,3,-1,"A"
NA,1983,"Bath City","Boston United","4-2",4,2,5,5,6,2,"H"
NA,1983,"Dagenham","Boston United","2-0",2,0,5,5,2,2,"H"
NA,1983,"Enfield","Boston United","1-0",1,0,5,5,1,1,"H"
NA,1983,"Frickley Athletic","Boston United","7-1",7,1,5,5,8,6,"H"
NA,1983,"Gateshead","Boston United","5-5",5,5,5,5,10,0,"D"
NA,1983,"Kettering Town","Boston United","2-1",2,1,5,5,3,1,"H"
NA,1983,"Kidderminster Harriers","Boston United","1-1",1,1,5,5,2,0,"D"
NA,1983,"Maidstone United","Boston United","2-2",2,2,5,5,4,0,"D"
NA,1983,"Northwich Victoria","Boston United","3-1",3,1,5,5,4,2,"H"
NA,1983,"Nuneaton Town","Boston United","4-0",4,0,5,5,4,4,"H"
NA,1983,"Runcorn","Boston United","3-1",3,1,5,5,4,2,"H"
NA,1983,"Scarborough","Boston United","2-0",2,0,5,5,2,2,"H"
NA,1983,"Telford United","Boston United","3-2",3,2,5,5,5,1,"H"
NA,1983,"Trowbridge Town","Boston United","0-2",0,2,5,5,2,-2,"A"
NA,1983,"Wealdstone","Boston United","1-1",1,1,5,5,2,0,"D"
NA,1983,"Weymouth","Boston United","0-2",0,2,5,5,2,-2,"A"
NA,1983,"Worcester City","Boston United","2-2",2,2,5,5,4,0,"D"
NA,1983,"Yeovil","Boston United","4-2",4,2,5,5,6,2,"H"
NA,1983,"Altrincham","Dagenham","4-0",4,0,5,5,4,4,"H"
NA,1983,"Bangor City","Dagenham","2-4",2,4,5,5,6,-2,"A"
NA,1983,"Barnet","Dagenham","3-1",3,1,5,5,4,2,"H"
NA,1983,"Bath City","Dagenham","0-1",0,1,5,5,1,-1,"A"
NA,1983,"Boston United","Dagenham","3-0",3,0,5,5,3,3,"H"
NA,1983,"Enfield","Dagenham","3-0",3,0,5,5,3,3,"H"
NA,1983,"Frickley Athletic","Dagenham","4-0",4,0,5,5,4,4,"H"
NA,1983,"Gateshead","Dagenham","1-1",1,1,5,5,2,0,"D"
NA,1983,"Kettering Town","Dagenham","2-2",2,2,5,5,4,0,"D"
NA,1983,"Kidderminster Harriers","Dagenham","4-2",4,2,5,5,6,2,"H"
NA,1983,"Maidstone United","Dagenham","2-0",2,0,5,5,2,2,"H"
NA,1983,"Northwich Victoria","Dagenham","3-1",3,1,5,5,4,2,"H"
NA,1983,"Nuneaton Town","Dagenham","1-1",1,1,5,5,2,0,"D"
NA,1983,"Runcorn","Dagenham","1-0",1,0,5,5,1,1,"H"
NA,1983,"Scarborough","Dagenham","0-0",0,0,5,5,0,0,"D"
NA,1983,"Telford United","Dagenham","3-1",3,1,5,5,4,2,"H"
NA,1983,"Trowbridge Town","Dagenham","1-4",1,4,5,5,5,-3,"A"
NA,1983,"Wealdstone","Dagenham","1-0",1,0,5,5,1,1,"H"
NA,1983,"Weymouth","Dagenham","3-1",3,1,5,5,4,2,"H"
NA,1983,"Worcester City","Dagenham","2-2",2,2,5,5,4,0,"D"
NA,1983,"Yeovil","Dagenham","0-2",0,2,5,5,2,-2,"A"
NA,1983,"Altrincham","Enfield","1-3",1,3,5,5,4,-2,"A"
NA,1983,"Bangor City","Enfield","2-1",2,1,5,5,3,1,"H"
NA,1983,"Barnet","Enfield","2-1",2,1,5,5,3,1,"H"
NA,1983,"Bath City","Enfield","3-2",3,2,5,5,5,1,"H"
NA,1983,"Boston United","Enfield","3-2",3,2,5,5,5,1,"H"
NA,1983,"Dagenham","Enfield","1-4",1,4,5,5,5,-3,"A"
NA,1983,"Frickley Athletic","Enfield","1-1",1,1,5,5,2,0,"D"
NA,1983,"Gateshead","Enfield","1-1",1,1,5,5,2,0,"D"
NA,1983,"Kettering Town","Enfield","1-0",1,0,5,5,1,1,"H"
NA,1983,"Kidderminster Harriers","Enfield","1-1",1,1,5,5,2,0,"D"
NA,1983,"Maidstone United","Enfield","1-1",1,1,5,5,2,0,"D"
NA,1983,"Northwich Victoria","Enfield","3-1",3,1,5,5,4,2,"H"
NA,1983,"Nuneaton Town","Enfield","4-0",4,0,5,5,4,4,"H"
NA,1983,"Runcorn","Enfield","0-0",0,0,5,5,0,0,"D"
NA,1983,"Scarborough","Enfield","0-4",0,4,5,5,4,-4,"A"
NA,1983,"Telford United","Enfield","0-3",0,3,5,5,3,-3,"A"
NA,1983,"Trowbridge Town","Enfield","0-0",0,0,5,5,0,0,"D"
NA,1983,"Wealdstone","Enfield","2-1",2,1,5,5,3,1,"H"
NA,1983,"Weymouth","Enfield","1-3",1,3,5,5,4,-2,"A"
NA,1983,"Worcester City","Enfield","1-3",1,3,5,5,4,-2,"A"
NA,1983,"Yeovil","Enfield","3-2",3,2,5,5,5,1,"H"
NA,1983,"Altrincham","Frickley Athletic","1-0",1,0,5,5,1,1,"H"
NA,1983,"Bangor City","Frickley Athletic","4-1",4,1,5,5,5,3,"H"
NA,1983,"Barnet","Frickley Athletic","3-2",3,2,5,5,5,1,"H"
NA,1983,"Bath City","Frickley Athletic","1-0",1,0,5,5,1,1,"H"
NA,1983,"Boston United","Frickley Athletic","2-2",2,2,5,5,4,0,"D"
NA,1983,"Dagenham","Frickley Athletic","1-1",1,1,5,5,2,0,"D"
NA,1983,"Enfield","Frickley Athletic","3-3",3,3,5,5,6,0,"D"
NA,1983,"Gateshead","Frickley Athletic","2-0",2,0,5,5,2,2,"H"
NA,1983,"Kettering Town","Frickley Athletic","0-1",0,1,5,5,1,-1,"A"
NA,1983,"Kidderminster Harriers","Frickley Athletic","1-1",1,1,5,5,2,0,"D"
NA,1983,"Maidstone United","Frickley Athletic","3-1",3,1,5,5,4,2,"H"
NA,1983,"Northwich Victoria","Frickley Athletic","1-1",1,1,5,5,2,0,"D"
NA,1983,"Nuneaton Town","Frickley Athletic","1-0",1,0,5,5,1,1,"H"
NA,1983,"Runcorn","Frickley Athletic","2-1",2,1,5,5,3,1,"H"
NA,1983,"Scarborough","Frickley Athletic","3-1",3,1,5,5,4,2,"H"
NA,1983,"Telford United","Frickley Athletic","0-1",0,1,5,5,1,-1,"A"
NA,1983,"Trowbridge Town","Frickley Athletic","0-1",0,1,5,5,1,-1,"A"
NA,1983,"Wealdstone","Frickley Athletic","0-0",0,0,5,5,0,0,"D"
NA,1983,"Weymouth","Frickley Athletic","0-2",0,2,5,5,2,-2,"A"
NA,1983,"Worcester City","Frickley Athletic","0-0",0,0,5,5,0,0,"D"
NA,1983,"Yeovil","Frickley Athletic","3-0",3,0,5,5,3,3,"H"
NA,1983,"Altrincham","Gateshead","5-0",5,0,5,5,5,5,"H"
NA,1983,"Bangor City","Gateshead","3-3",3,3,5,5,6,0,"D"
NA,1983,"Barnet","Gateshead","0-1",0,1,5,5,1,-1,"A"
NA,1983,"Bath City","Gateshead","1-1",1,1,5,5,2,0,"D"
NA,1983,"Boston United","Gateshead","0-4",0,4,5,5,4,-4,"A"
NA,1983,"Dagenham","Gateshead","1-2",1,2,5,5,3,-1,"A"
NA,1983,"Enfield","Gateshead","0-3",0,3,5,5,3,-3,"A"
NA,1983,"Frickley Athletic","Gateshead","4-1",4,1,5,5,5,3,"H"
NA,1983,"Kettering Town","Gateshead","3-0",3,0,5,5,3,3,"H"
NA,1983,"Kidderminster Harriers","Gateshead","1-0",1,0,5,5,1,1,"H"
NA,1983,"Maidstone United","Gateshead","1-0",1,0,5,5,1,1,"H"
NA,1983,"Northwich Victoria","Gateshead","3-1",3,1,5,5,4,2,"H"
NA,1983,"Nuneaton Town","Gateshead","3-2",3,2,5,5,5,1,"H"
NA,1983,"Runcorn","Gateshead","4-2",4,2,5,5,6,2,"H"
NA,1983,"Scarborough","Gateshead","1-1",1,1,5,5,2,0,"D"
NA,1983,"Telford United","Gateshead","4-0",4,0,5,5,4,4,"H"
NA,1983,"Trowbridge Town","Gateshead","0-2",0,2,5,5,2,-2,"A"
NA,1983,"Wealdstone","Gateshead","4-0",4,0,5,5,4,4,"H"
NA,1983,"Weymouth","Gateshead","2-0",2,0,5,5,2,2,"H"
NA,1983,"Worcester City","Gateshead","3-1",3,1,5,5,4,2,"H"
NA,1983,"Yeovil","Gateshead","0-0",0,0,5,5,0,0,"D"
NA,1983,"Altrincham","Kettering Town","1-1",1,1,5,5,2,0,"D"
NA,1983,"Bangor City","Kettering Town","3-1",3,1,5,5,4,2,"H"
NA,1983,"Barnet","Kettering Town","0-3",0,3,5,5,3,-3,"A"
NA,1983,"Bath City","Kettering Town","1-1",1,1,5,5,2,0,"D"
NA,1983,"Boston United","Kettering Town","3-1",3,1,5,5,4,2,"H"
NA,1983,"Dagenham","Kettering Town","2-0",2,0,5,5,2,2,"H"
NA,1983,"Enfield","Kettering Town","2-2",2,2,5,5,4,0,"D"
NA,1983,"Frickley Athletic","Kettering Town","1-1",1,1,5,5,2,0,"D"
NA,1983,"Gateshead","Kettering Town","1-2",1,2,5,5,3,-1,"A"
NA,1983,"Kidderminster Harriers","Kettering Town","3-1",3,1,5,5,4,2,"H"
NA,1983,"Maidstone United","Kettering Town","1-0",1,0,5,5,1,1,"H"
NA,1983,"Northwich Victoria","Kettering Town","4-0",4,0,5,5,4,4,"H"
NA,1983,"Nuneaton Town","Kettering Town","1-0",1,0,5,5,1,1,"H"
NA,1983,"Runcorn","Kettering Town","4-1",4,1,5,5,5,3,"H"
NA,1983,"Scarborough","Kettering Town","0-0",0,0,5,5,0,0,"D"
NA,1983,"Telford United","Kettering Town","1-0",1,0,5,5,1,1,"H"
NA,1983,"Trowbridge Town","Kettering Town","1-2",1,2,5,5,3,-1,"A"
NA,1983,"Wealdstone","Kettering Town","4-2",4,2,5,5,6,2,"H"
NA,1983,"Weymouth","Kettering Town","1-1",1,1,5,5,2,0,"D"
NA,1983,"Worcester City","Kettering Town","0-3",0,3,5,5,3,-3,"A"
NA,1983,"Yeovil","Kettering Town","2-0",2,0,5,5,2,2,"H"
NA,1983,"Altrincham","Kidderminster Harriers","0-1",0,1,5,5,1,-1,"A"
NA,1983,"Bangor City","Kidderminster Harriers","1-2",1,2,5,5,3,-1,"A"
NA,1983,"Barnet","Kidderminster Harriers","0-2",0,2,5,5,2,-2,"A"
NA,1983,"Bath City","Kidderminster Harriers","3-0",3,0,5,5,3,3,"H"
NA,1983,"Boston United","Kidderminster Harriers","2-3",2,3,5,5,5,-1,"A"
NA,1983,"Dagenham","Kidderminster Harriers","0-0",0,0,5,5,0,0,"D"
NA,1983,"Enfield","Kidderminster Harriers","0-1",0,1,5,5,1,-1,"A"
NA,1983,"Frickley Athletic","Kidderminster Harriers","0-2",0,2,5,5,2,-2,"A"
NA,1983,"Gateshead","Kidderminster Harriers","1-0",1,0,5,5,1,1,"H"
NA,1983,"Kettering Town","Kidderminster Harriers","4-2",4,2,5,5,6,2,"H"
NA,1983,"Maidstone United","Kidderminster Harriers","3-1",3,1,5,5,4,2,"H"
NA,1983,"Northwich Victoria","Kidderminster Harriers","4-2",4,2,5,5,6,2,"H"
NA,1983,"Nuneaton Town","Kidderminster Harriers","2-1",2,1,5,5,3,1,"H"
NA,1983,"Runcorn","Kidderminster Harriers","1-1",1,1,5,5,2,0,"D"
NA,1983,"Scarborough","Kidderminster Harriers","2-0",2,0,5,5,2,2,"H"
NA,1983,"Telford United","Kidderminster Harriers","3-0",3,0,5,5,3,3,"H"
NA,1983,"Trowbridge Town","Kidderminster Harriers","1-2",1,2,5,5,3,-1,"A"
NA,1983,"Wealdstone","Kidderminster Harriers","2-0",2,0,5,5,2,2,"H"
NA,1983,"Weymouth","Kidderminster Harriers","0-0",0,0,5,5,0,0,"D"
NA,1983,"Worcester City","Kidderminster Harriers","1-1",1,1,5,5,2,0,"D"
NA,1983,"Yeovil","Kidderminster Harriers","1-1",1,1,5,5,2,0,"D"
NA,1983,"Altrincham","Maidstone United","1-0",1,0,5,5,1,1,"H"
NA,1983,"Bangor City","Maidstone United","0-2",0,2,5,5,2,-2,"A"
NA,1983,"Barnet","Maidstone United","0-4",0,4,5,5,4,-4,"A"
NA,1983,"Bath City","Maidstone United","1-2",1,2,5,5,3,-1,"A"
NA,1983,"Boston United","Maidstone United","1-0",1,0,5,5,1,1,"H"
NA,1983,"Dagenham","Maidstone United","0-1",0,1,5,5,1,-1,"A"
NA,1983,"Enfield","Maidstone United","0-3",0,3,5,5,3,-3,"A"
NA,1983,"Frickley Athletic","Maidstone United","2-0",2,0,5,5,2,2,"H"
NA,1983,"Gateshead","Maidstone United","0-2",0,2,5,5,2,-2,"A"
NA,1983,"Kettering Town","Maidstone United","0-2",0,2,5,5,2,-2,"A"
NA,1983,"Kidderminster Harriers","Maidstone United","0-0",0,0,5,5,0,0,"D"
NA,1983,"Northwich Victoria","Maidstone United","1-1",1,1,5,5,2,0,"D"
NA,1983,"Nuneaton Town","Maidstone United","2-2",2,2,5,5,4,0,"D"
NA,1983,"Runcorn","Maidstone United","0-0",0,0,5,5,0,0,"D"
NA,1983,"Scarborough","Maidstone United","1-1",1,1,5,5,2,0,"D"
NA,1983,"Telford United","Maidstone United","3-1",3,1,5,5,4,2,"H"
NA,1983,"Trowbridge Town","Maidstone United","1-2",1,2,5,5,3,-1,"A"
NA,1983,"Wealdstone","Maidstone United","1-2",1,2,5,5,3,-1,"A"
NA,1983,"Weymouth","Maidstone United","1-3",1,3,5,5,4,-2,"A"
NA,1983,"Worcester City","Maidstone United","3-0",3,0,5,5,3,3,"H"
NA,1983,"Yeovil","Maidstone United","1-3",1,3,5,5,4,-2,"A"
NA,1983,"Altrincham","Northwich Victoria","1-1",1,1,5,5,2,0,"D"
NA,1983,"Bangor City","Northwich Victoria","0-1",0,1,5,5,1,-1,"A"
NA,1983,"Barnet","Northwich Victoria","2-1",2,1,5,5,3,1,"H"
NA,1983,"Bath City","Northwich Victoria","2-0",2,0,5,5,2,2,"H"
NA,1983,"Boston United","Northwich Victoria","3-1",3,1,5,5,4,2,"H"
NA,1983,"Dagenham","Northwich Victoria","3-1",3,1,5,5,4,2,"H"
NA,1983,"Enfield","Northwich Victoria","1-2",1,2,5,5,3,-1,"A"
NA,1983,"Frickley Athletic","Northwich Victoria","4-1",4,1,5,5,5,3,"H"
NA,1983,"Gateshead","Northwich Victoria","1-3",1,3,5,5,4,-2,"A"
NA,1983,"Kettering Town","Northwich Victoria","1-0",1,0,5,5,1,1,"H"
NA,1983,"Kidderminster Harriers","Northwich Victoria","2-2",2,2,5,5,4,0,"D"
NA,1983,"Maidstone United","Northwich Victoria","0-1",0,1,5,5,1,-1,"A"
NA,1983,"Nuneaton Town","Northwich Victoria","1-0",1,0,5,5,1,1,"H"
NA,1983,"Runcorn","Northwich Victoria","0-0",0,0,5,5,0,0,"D"
NA,1983,"Scarborough","Northwich Victoria","1-1",1,1,5,5,2,0,"D"
NA,1983,"Telford United","Northwich Victoria","0-2",0,2,5,5,2,-2,"A"
NA,1983,"Trowbridge Town","Northwich Victoria","1-1",1,1,5,5,2,0,"D"
NA,1983,"Wealdstone","Northwich Victoria","1-0",1,0,5,5,1,1,"H"
NA,1983,"Weymouth","Northwich Victoria","1-1",1,1,5,5,2,0,"D"
NA,1983,"Worcester City","Northwich Victoria","2-0",2,0,5,5,2,2,"H"
NA,1983,"Yeovil","Northwich Victoria","2-0",2,0,5,5,2,2,"H"
NA,1983,"Altrincham","Nuneaton Town","0-1",0,1,5,5,1,-1,"A"
NA,1983,"Bangor City","Nuneaton Town","1-2",1,2,5,5,3,-1,"A"
NA,1983,"Barnet","Nuneaton Town","1-2",1,2,5,5,3,-1,"A"
NA,1983,"Bath City","Nuneaton Town","0-1",0,1,5,5,1,-1,"A"
NA,1983,"Boston United","Nuneaton Town","3-0",3,0,5,5,3,3,"H"
NA,1983,"Dagenham","Nuneaton Town","4-2",4,2,5,5,6,2,"H"
NA,1983,"Enfield","Nuneaton Town","0-1",0,1,5,5,1,-1,"A"
NA,1983,"Frickley Athletic","Nuneaton Town","1-3",1,3,5,5,4,-2,"A"
NA,1983,"Gateshead","Nuneaton Town","1-1",1,1,5,5,2,0,"D"
NA,1983,"Kettering Town","Nuneaton Town","3-4",3,4,5,5,7,-1,"A"
NA,1983,"Kidderminster Harriers","Nuneaton Town","3-3",3,3,5,5,6,0,"D"
NA,1983,"Maidstone United","Nuneaton Town","1-0",1,0,5,5,1,1,"H"
NA,1983,"Northwich Victoria","Nuneaton Town","1-1",1,1,5,5,2,0,"D"
NA,1983,"Runcorn","Nuneaton Town","0-1",0,1,5,5,1,-1,"A"
NA,1983,"Scarborough","Nuneaton Town","1-0",1,0,5,5,1,1,"H"
NA,1983,"Telford United","Nuneaton Town","1-0",1,0,5,5,1,1,"H"
NA,1983,"Trowbridge Town","Nuneaton Town","0-2",0,2,5,5,2,-2,"A"
NA,1983,"Wealdstone","Nuneaton Town","0-0",0,0,5,5,0,0,"D"
NA,1983,"Weymouth","Nuneaton Town","0-1",0,1,5,5,1,-1,"A"
NA,1983,"Worcester City","Nuneaton Town","1-1",1,1,5,5,2,0,"D"
NA,1983,"Yeovil","Nuneaton Town","1-0",1,0,5,5,1,1,"H"
NA,1983,"Altrincham","Runcorn","1-3",1,3,5,5,4,-2,"A"
NA,1983,"Bangor City","Runcorn","2-3",2,3,5,5,5,-1,"A"
NA,1983,"Barnet","Runcorn","2-0",2,0,5,5,2,2,"H"
NA,1983,"Bath City","Runcorn","1-1",1,1,5,5,2,0,"D"
NA,1983,"Boston United","Runcorn","1-2",1,2,5,5,3,-1,"A"
NA,1983,"Dagenham","Runcorn","0-2",0,2,5,5,2,-2,"A"
NA,1983,"Enfield","Runcorn","0-1",0,1,5,5,1,-1,"A"
NA,1983,"Frickley Athletic","Runcorn","2-1",2,1,5,5,3,1,"H"
NA,1983,"Gateshead","Runcorn","1-1",1,1,5,5,2,0,"D"
NA,1983,"Kettering Town","Runcorn","1-0",1,0,5,5,1,1,"H"
NA,1983,"Kidderminster Harriers","Runcorn","0-2",0,2,5,5,2,-2,"A"
NA,1983,"Maidstone United","Runcorn","1-1",1,1,5,5,2,0,"D"
NA,1983,"Northwich Victoria","Runcorn","0-1",0,1,5,5,1,-1,"A"
NA,1983,"Nuneaton Town","Runcorn","2-2",2,2,5,5,4,0,"D"
NA,1983,"Scarborough","Runcorn","2-1",2,1,5,5,3,1,"H"
NA,1983,"Telford United","Runcorn","1-1",1,1,5,5,2,0,"D"
NA,1983,"Trowbridge Town","Runcorn","0-1",0,1,5,5,1,-1,"A"
NA,1983,"Wealdstone","Runcorn","4-2",4,2,5,5,6,2,"H"
NA,1983,"Weymouth","Runcorn","3-1",3,1,5,5,4,2,"H"
NA,1983,"Worcester City","Runcorn","3-0",3,0,5,5,3,3,"H"
NA,1983,"Yeovil","Runcorn","0-1",0,1,5,5,1,-1,"A"
NA,1983,"Altrincham","Scarborough","2-0",2,0,5,5,2,2,"H"
NA,1983,"Bangor City","Scarborough","1-1",1,1,5,5,2,0,"D"
NA,1983,"Barnet","Scarborough","0-1",0,1,5,5,1,-1,"A"
NA,1983,"Bath City","Scarborough","4-1",4,1,5,5,5,3,"H"
NA,1983,"Boston United","Scarborough","1-1",1,1,5,5,2,0,"D"
NA,1983,"Dagenham","Scarborough","1-1",1,1,5,5,2,0,"D"
NA,1983,"Enfield","Scarborough","2-1",2,1,5,5,3,1,"H"
NA,1983,"Frickley Athletic","Scarborough","2-1",2,1,5,5,3,1,"H"
NA,1983,"Gateshead","Scarborough","1-1",1,1,5,5,2,0,"D"
NA,1983,"Kettering Town","Scarborough","2-3",2,3,5,5,5,-1,"A"
NA,1983,"Kidderminster Harriers","Scarborough","1-3",1,3,5,5,4,-2,"A"
NA,1983,"Maidstone United","Scarborough","1-1",1,1,5,5,2,0,"D"
NA,1983,"Northwich Victoria","Scarborough","3-1",3,1,5,5,4,2,"H"
NA,1983,"Nuneaton Town","Scarborough","3-0",3,0,5,5,3,3,"H"
NA,1983,"Runcorn","Scarborough","2-0",2,0,5,5,2,2,"H"
NA,1983,"Telford United","Scarborough","1-0",1,0,5,5,1,1,"H"
NA,1983,"Trowbridge Town","Scarborough","1-0",1,0,5,5,1,1,"H"
NA,1983,"Wealdstone","Scarborough","1-1",1,1,5,5,2,0,"D"
NA,1983,"Weymouth","Scarborough","6-1",6,1,5,5,7,5,"H"
NA,1983,"Worcester City","Scarborough","3-0",3,0,5,5,3,3,"H"
NA,1983,"Yeovil","Scarborough","1-2",1,2,5,5,3,-1,"A"
NA,1983,"Altrincham","Telford United","1-1",1,1,5,5,2,0,"D"
NA,1983,"Bangor City","Telford United","4-0",4,0,5,5,4,4,"H"
NA,1983,"Barnet","Telford United","0-0",0,0,5,5,0,0,"D"
NA,1983,"Bath City","Telford United","1-1",1,1,5,5,2,0,"D"
NA,1983,"Boston United","Telford United","2-3",2,3,5,5,5,-1,"A"
NA,1983,"Dagenham","Telford United","1-2",1,2,5,5,3,-1,"A"
NA,1983,"Enfield","Telford United","3-1",3,1,5,5,4,2,"H"
NA,1983,"Frickley Athletic","Telford United","1-1",1,1,5,5,2,0,"D"
NA,1983,"Gateshead","Telford United","2-1",2,1,5,5,3,1,"H"
NA,1983,"Kettering Town","Telford United","4-1",4,1,5,5,5,3,"H"
NA,1983,"Kidderminster Harriers","Telford United","1-0",1,0,5,5,1,1,"H"
NA,1983,"Maidstone United","Telford United","6-0",6,0,5,5,6,6,"H"
NA,1983,"Northwich Victoria","Telford United","0-0",0,0,5,5,0,0,"D"
NA,1983,"Nuneaton Town","Telford United","1-1",1,1,5,5,2,0,"D"
NA,1983,"Runcorn","Telford United","0-0",0,0,5,5,0,0,"D"
NA,1983,"Scarborough","Telford United","3-0",3,0,5,5,3,3,"H"
NA,1983,"Trowbridge Town","Telford United","2-2",2,2,5,5,4,0,"D"
NA,1983,"Wealdstone","Telford United","4-0",4,0,5,5,4,4,"H"
NA,1983,"Weymouth","Telford United","2-3",2,3,5,5,5,-1,"A"
NA,1983,"Worcester City","Telford United","0-1",0,1,5,5,1,-1,"A"
NA,1983,"Yeovil","Telford United","1-0",1,0,5,5,1,1,"H"
NA,1983,"Altrincham","Trowbridge Town","4-0",4,0,5,5,4,4,"H"
NA,1983,"Bangor City","Trowbridge Town","4-0",4,0,5,5,4,4,"H"
NA,1983,"Barnet","Trowbridge Town","2-1",2,1,5,5,3,1,"H"
NA,1983,"Bath City","Trowbridge Town","2-1",2,1,5,5,3,1,"H"
NA,1983,"Boston United","Trowbridge Town","2-0",2,0,5,5,2,2,"H"
NA,1983,"Dagenham","Trowbridge Town","6-2",6,2,5,5,8,4,"H"
NA,1983,"Enfield","Trowbridge Town","2-1",2,1,5,5,3,1,"H"
NA,1983,"Frickley Athletic","Trowbridge Town","2-0",2,0,5,5,2,2,"H"
NA,1983,"Gateshead","Trowbridge Town","2-2",2,2,5,5,4,0,"D"
NA,1983,"Kettering Town","Trowbridge Town","3-2",3,2,5,5,5,1,"H"
NA,1983,"Kidderminster Harriers","Trowbridge Town","1-1",1,1,5,5,2,0,"D"
NA,1983,"Maidstone United","Trowbridge Town","4-1",4,1,5,5,5,3,"H"
NA,1983,"Northwich Victoria","Trowbridge Town","0-2",0,2,5,5,2,-2,"A"
NA,1983,"Nuneaton Town","Trowbridge Town","2-1",2,1,5,5,3,1,"H"
NA,1983,"Runcorn","Trowbridge Town","2-0",2,0,5,5,2,2,"H"
NA,1983,"Scarborough","Trowbridge Town","0-0",0,0,5,5,0,0,"D"
NA,1983,"Telford United","Trowbridge Town","1-0",1,0,5,5,1,1,"H"
NA,1983,"Wealdstone","Trowbridge Town","6-0",6,0,5,5,6,6,"H"
NA,1983,"Weymouth","Trowbridge Town","0-1",0,1,5,5,1,-1,"A"
NA,1983,"Worcester City","Trowbridge Town","5-2",5,2,5,5,7,3,"H"
NA,1983,"Yeovil","Trowbridge Town","3-1",3,1,5,5,4,2,"H"
NA,1983,"Altrincham","Wealdstone","1-0",1,0,5,5,1,1,"H"
NA,1983,"Bangor City","Wealdstone","0-0",0,0,5,5,0,0,"D"
NA,1983,"Barnet","Wealdstone","1-1",1,1,5,5,2,0,"D"
NA,1983,"Bath City","Wealdstone","0-0",0,0,5,5,0,0,"D"
NA,1983,"Boston United","Wealdstone","1-1",1,1,5,5,2,0,"D"
NA,1983,"Dagenham","Wealdstone","1-0",1,0,5,5,1,1,"H"
NA,1983,"Enfield","Wealdstone","0-2",0,2,5,5,2,-2,"A"
NA,1983,"Frickley Athletic","Wealdstone","2-5",2,5,5,5,7,-3,"A"
NA,1983,"Gateshead","Wealdstone","1-1",1,1,5,5,2,0,"D"
NA,1983,"Kettering Town","Wealdstone","1-2",1,2,5,5,3,-1,"A"
NA,1983,"Kidderminster Harriers","Wealdstone","3-1",3,1,5,5,4,2,"H"
NA,1983,"Maidstone United","Wealdstone","2-1",2,1,5,5,3,1,"H"
NA,1983,"Northwich Victoria","Wealdstone","1-1",1,1,5,5,2,0,"D"
NA,1983,"Nuneaton Town","Wealdstone","1-1",1,1,5,5,2,0,"D"
NA,1983,"Runcorn","Wealdstone","4-2",4,2,5,5,6,2,"H"
NA,1983,"Scarborough","Wealdstone","1-1",1,1,5,5,2,0,"D"
NA,1983,"Telford United","Wealdstone","0-1",0,1,5,5,1,-1,"A"
NA,1983,"Trowbridge Town","Wealdstone","1-2",1,2,5,5,3,-1,"A"
NA,1983,"Weymouth","Wealdstone","0-4",0,4,5,5,4,-4,"A"
NA,1983,"Worcester City","Wealdstone","1-1",1,1,5,5,2,0,"D"
NA,1983,"Yeovil","Wealdstone","0-0",0,0,5,5,0,0,"D"
NA,1983,"Altrincham","Weymouth","2-1",2,1,5,5,3,1,"H"
NA,1983,"Bangor City","Weymouth","1-3",1,3,5,5,4,-2,"A"
NA,1983,"Barnet","Weymouth","1-1",1,1,5,5,2,0,"D"
NA,1983,"Bath City","Weymouth","1-0",1,0,5,5,1,1,"H"
NA,1983,"Boston United","Weymouth","4-3",4,3,5,5,7,1,"H"
NA,1983,"Dagenham","Weymouth","1-2",1,2,5,5,3,-1,"A"
NA,1983,"Enfield","Weymouth","0-1",0,1,5,5,1,-1,"A"
NA,1983,"Frickley Athletic","Weymouth","1-2",1,2,5,5,3,-1,"A"
NA,1983,"Gateshead","Weymouth","3-0",3,0,5,5,3,3,"H"
NA,1983,"Kettering Town","Weymouth","0-2",0,2,5,5,2,-2,"A"
NA,1983,"Kidderminster Harriers","Weymouth","0-1",0,1,5,5,1,-1,"A"
NA,1983,"Maidstone United","Weymouth","2-2",2,2,5,5,4,0,"D"
NA,1983,"Northwich Victoria","Weymouth","1-0",1,0,5,5,1,1,"H"
NA,1983,"Nuneaton Town","Weymouth","3-0",3,0,5,5,3,3,"H"
NA,1983,"Runcorn","Weymouth","1-1",1,1,5,5,2,0,"D"
NA,1983,"Scarborough","Weymouth","1-1",1,1,5,5,2,0,"D"
NA,1983,"Telford United","Weymouth","0-1",0,1,5,5,1,-1,"A"
NA,1983,"Trowbridge Town","Weymouth","1-2",1,2,5,5,3,-1,"A"
NA,1983,"Wealdstone","Weymouth","2-0",2,0,5,5,2,2,"H"
NA,1983,"Worcester City","Weymouth","1-0",1,0,5,5,1,1,"H"
NA,1983,"Yeovil","Weymouth","6-3",6,3,5,5,9,3,"H"
NA,1983,"Altrincham","Worcester City","3-4",3,4,5,5,7,-1,"A"
NA,1983,"Bangor City","Worcester City","2-4",2,4,5,5,6,-2,"A"
NA,1983,"Barnet","Worcester City","2-0",2,0,5,5,2,2,"H"
NA,1983,"Bath City","Worcester City","0-0",0,0,5,5,0,0,"D"
NA,1983,"Boston United","Worcester City","0-1",0,1,5,5,1,-1,"A"
NA,1983,"Dagenham","Worcester City","0-1",0,1,5,5,1,-1,"A"
NA,1983,"Enfield","Worcester City","2-2",2,2,5,5,4,0,"D"
NA,1983,"Frickley Athletic","Worcester City","3-1",3,1,5,5,4,2,"H"
NA,1983,"Gateshead","Worcester City","1-1",1,1,5,5,2,0,"D"
NA,1983,"Kettering Town","Worcester City","0-1",0,1,5,5,1,-1,"A"
NA,1983,"Kidderminster Harriers","Worcester City","2-1",2,1,5,5,3,1,"H"
NA,1983,"Maidstone United","Worcester City","1-1",1,1,5,5,2,0,"D"
NA,1983,"Northwich Victoria","Worcester City","1-0",1,0,5,5,1,1,"H"
NA,1983,"Nuneaton Town","Worcester City","1-0",1,0,5,5,1,1,"H"
NA,1983,"Runcorn","Worcester City","2-1",2,1,5,5,3,1,"H"
NA,1983,"Scarborough","Worcester City","4-4",4,4,5,5,8,0,"D"
NA,1983,"Telford United","Worcester City","2-0",2,0,5,5,2,2,"H"
NA,1983,"Trowbridge Town","Worcester City","2-1",2,1,5,5,3,1,"H"
NA,1983,"Wealdstone","Worcester City","3-1",3,1,5,5,4,2,"H"
NA,1983,"Weymouth","Worcester City","0-2",0,2,5,5,2,-2,"A"
NA,1983,"Yeovil","Worcester City","2-2",2,2,5,5,4,0,"D"
NA,1983,"Altrincham","Yeovil","2-1",2,1,5,5,3,1,"H"
NA,1983,"Bangor City","Yeovil","3-0",3,0,5,5,3,3,"H"
NA,1983,"Barnet","Yeovil","2-0",2,0,5,5,2,2,"H"
NA,1983,"Bath City","Yeovil","3-1",3,1,5,5,4,2,"H"
NA,1983,"Boston United","Yeovil","3-2",3,2,5,5,5,1,"H"
NA,1983,"Dagenham","Yeovil","1-0",1,0,5,5,1,1,"H"
NA,1983,"Enfield","Yeovil","3-0",3,0,5,5,3,3,"H"
NA,1983,"Frickley Athletic","Yeovil","3-0",3,0,5,5,3,3,"H"
NA,1983,"Gateshead","Yeovil","4-2",4,2,5,5,6,2,"H"
NA,1983,"Kettering Town","Yeovil","2-3",2,3,5,5,5,-1,"A"
NA,1983,"Kidderminster Harriers","Yeovil","1-2",1,2,5,5,3,-1,"A"
NA,1983,"Maidstone United","Yeovil","4-0",4,0,5,5,4,4,"H"
NA,1983,"Northwich Victoria","Yeovil","0-0",0,0,5,5,0,0,"D"
NA,1983,"Nuneaton Town","Yeovil","2-1",2,1,5,5,3,1,"H"
NA,1983,"Runcorn","Yeovil","4-4",4,4,5,5,8,0,"D"
NA,1983,"Scarborough","Yeovil","3-0",3,0,5,5,3,3,"H"
NA,1983,"Telford United","Yeovil","2-2",2,2,5,5,4,0,"D"
NA,1983,"Trowbridge Town","Yeovil","1-0",1,0,5,5,1,1,"H"
NA,1983,"Wealdstone","Yeovil","1-0",1,0,5,5,1,1,"H"
NA,1983,"Weymouth","Yeovil","1-3",1,3,5,5,4,-2,"A"
NA,1983,"Worcester City","Yeovil","4-0",4,0,5,5,4,4,"H"
NA,1984,"Barnet","Altrincham","1-0",1,0,5,5,1,1,"H"
NA,1984,"Barrow","Altrincham","0-2",0,2,5,5,2,-2,"A"
NA,1984,"Bath City","Altrincham","1-0",1,0,5,5,1,1,"H"
NA,1984,"Boston United","Altrincham","0-0",0,0,5,5,0,0,"D"
NA,1984,"Dagenham","Altrincham","1-1",1,1,5,5,2,0,"D"
NA,1984,"Dartford","Altrincham","1-0",1,0,5,5,1,1,"H"
NA,1984,"Enfield","Altrincham","3-3",3,3,5,5,6,0,"D"
NA,1984,"Frickley Athletic","Altrincham","2-1",2,1,5,5,3,1,"H"
NA,1984,"Gateshead","Altrincham","0-1",0,1,5,5,1,-1,"A"
NA,1984,"Kettering Town","Altrincham","1-2",1,2,5,5,3,-1,"A"
NA,1984,"Kidderminster Harriers","Altrincham","0-2",0,2,5,5,2,-2,"A"
NA,1984,"Maidstone United","Altrincham","3-0",3,0,5,5,3,3,"H"
NA,1984,"Northwich Victoria","Altrincham","1-2",1,2,5,5,3,-1,"A"
NA,1984,"Nuneaton Town","Altrincham","4-1",4,1,5,5,5,3,"H"
NA,1984,"Runcorn","Altrincham","1-2",1,2,5,5,3,-1,"A"
NA,1984,"Scarborough","Altrincham","2-1",2,1,5,5,3,1,"H"
NA,1984,"Telford United","Altrincham","0-2",0,2,5,5,2,-2,"A"
NA,1984,"Wealdstone","Altrincham","1-0",1,0,5,5,1,1,"H"
NA,1984,"Weymouth","Altrincham","2-1",2,1,5,5,3,1,"H"
NA,1984,"Worcester City","Altrincham","1-1",1,1,5,5,2,0,"D"
NA,1984,"Yeovil","Altrincham","1-2",1,2,5,5,3,-1,"A"
NA,1984,"Altrincham","Barnet","0-2",0,2,5,5,2,-2,"A"
NA,1984,"Barrow","Barnet","1-0",1,0,5,5,1,1,"H"
NA,1984,"Bath City","Barnet","2-1",2,1,5,5,3,1,"H"
NA,1984,"Boston United","Barnet","2-1",2,1,5,5,3,1,"H"
NA,1984,"Dagenham","Barnet","0-0",0,0,5,5,0,0,"D"
NA,1984,"Dartford","Barnet","2-0",2,0,5,5,2,2,"H"
NA,1984,"Enfield","Barnet","3-3",3,3,5,5,6,0,"D"
NA,1984,"Frickley Athletic","Barnet","3-1",3,1,5,5,4,2,"H"
NA,1984,"Gateshead","Barnet","0-2",0,2,5,5,2,-2,"A"
NA,1984,"Kettering Town","Barnet","4-0",4,0,5,5,4,4,"H"
NA,1984,"Kidderminster Harriers","Barnet","1-4",1,4,5,5,5,-3,"A"
NA,1984,"Maidstone United","Barnet","1-0",1,0,5,5,1,1,"H"
NA,1984,"Northwich Victoria","Barnet","2-0",2,0,5,5,2,2,"H"
NA,1984,"Nuneaton Town","Barnet","1-1",1,1,5,5,2,0,"D"
NA,1984,"Runcorn","Barnet","2-1",2,1,5,5,3,1,"H"
NA,1984,"Scarborough","Barnet","1-1",1,1,5,5,2,0,"D"
NA,1984,"Telford United","Barnet","1-0",1,0,5,5,1,1,"H"
NA,1984,"Wealdstone","Barnet","1-2",1,2,5,5,3,-1,"A"
NA,1984,"Weymouth","Barnet","3-0",3,0,5,5,3,3,"H"
NA,1984,"Worcester City","Barnet","1-2",1,2,5,5,3,-1,"A"
NA,1984,"Yeovil","Barnet","2-1",2,1,5,5,3,1,"H"
NA,1984,"Altrincham","Barrow","2-0",2,0,5,5,2,2,"H"
NA,1984,"Barnet","Barrow","4-0",4,0,5,5,4,4,"H"
NA,1984,"Bath City","Barrow","1-2",1,2,5,5,3,-1,"A"
NA,1984,"Boston United","Barrow","1-3",1,3,5,5,4,-2,"A"
NA,1984,"Dagenham","Barrow","1-1",1,1,5,5,2,0,"D"
NA,1984,"Dartford","Barrow","2-0",2,0,5,5,2,2,"H"
NA,1984,"Enfield","Barrow","0-0",0,0,5,5,0,0,"D"
NA,1984,"Frickley Athletic","Barrow","2-2",2,2,5,5,4,0,"D"
NA,1984,"Gateshead","Barrow","1-2",1,2,5,5,3,-1,"A"
NA,1984,"Kettering Town","Barrow","0-0",0,0,5,5,0,0,"D"
NA,1984,"Kidderminster Harriers","Barrow","0-1",0,1,5,5,1,-1,"A"
NA,1984,"Maidstone United","Barrow","2-0",2,0,5,5,2,2,"H"
NA,1984,"Northwich Victoria","Barrow","1-0",1,0,5,5,1,1,"H"
NA,1984,"Nuneaton Town","Barrow","5-2",5,2,5,5,7,3,"H"
NA,1984,"Runcorn","Barrow","0-0",0,0,5,5,0,0,"D"
NA,1984,"Scarborough","Barrow","1-1",1,1,5,5,2,0,"D"
NA,1984,"Telford United","Barrow","3-1",3,1,5,5,4,2,"H"
NA,1984,"Wealdstone","Barrow","2-2",2,2,5,5,4,0,"D"
NA,1984,"Weymouth","Barrow","3-1",3,1,5,5,4,2,"H"
NA,1984,"Worcester City","Barrow","3-2",3,2,5,5,5,1,"H"
NA,1984,"Yeovil","Barrow","1-2",1,2,5,5,3,-1,"A"
NA,1984,"Altrincham","Bath City","0-0",0,0,5,5,0,0,"D"
NA,1984,"Barnet","Bath City","2-1",2,1,5,5,3,1,"H"
NA,1984,"Barrow","Bath City","0-1",0,1,5,5,1,-1,"A"
NA,1984,"Boston United","Bath City","1-2",1,2,5,5,3,-1,"A"
NA,1984,"Dagenham","Bath City","0-0",0,0,5,5,0,0,"D"
NA,1984,"Dartford","Bath City","1-3",1,3,5,5,4,-2,"A"
NA,1984,"Enfield","Bath City","1-1",1,1,5,5,2,0,"D"
NA,1984,"Frickley Athletic","Bath City","2-0",2,0,5,5,2,2,"H"
NA,1984,"Gateshead","Bath City","1-1",1,1,5,5,2,0,"D"
NA,1984,"Kettering Town","Bath City","1-2",1,2,5,5,3,-1,"A"
NA,1984,"Kidderminster Harriers","Bath City","2-2",2,2,5,5,4,0,"D"
NA,1984,"Maidstone United","Bath City","2-0",2,0,5,5,2,2,"H"
NA,1984,"Northwich Victoria","Bath City","3-1",3,1,5,5,4,2,"H"
NA,1984,"Nuneaton Town","Bath City","0-0",0,0,5,5,0,0,"D"
NA,1984,"Runcorn","Bath City","0-0",0,0,5,5,0,0,"D"
NA,1984,"Scarborough","Bath City","2-0",2,0,5,5,2,2,"H"
NA,1984,"Telford United","Bath City","3-1",3,1,5,5,4,2,"H"
NA,1984,"Wealdstone","Bath City","0-1",0,1,5,5,1,-1,"A"
NA,1984,"Weymouth","Bath City","2-2",2,2,5,5,4,0,"D"
NA,1984,"Worcester City","Bath City","1-2",1,2,5,5,3,-1,"A"
NA,1984,"Yeovil","Bath City","3-2",3,2,5,5,5,1,"H"
NA,1984,"Altrincham","Boston United","7-2",7,2,5,5,9,5,"H"
NA,1984,"Barnet","Boston United","1-0",1,0,5,5,1,1,"H"
NA,1984,"Barrow","Boston United","1-1",1,1,5,5,2,0,"D"
NA,1984,"Bath City","Boston United","2-1",2,1,5,5,3,1,"H"
NA,1984,"Dagenham","Boston United","1-2",1,2,5,5,3,-1,"A"
NA,1984,"Dartford","Boston United","1-1",1,1,5,5,2,0,"D"
NA,1984,"Enfield","Boston United","1-1",1,1,5,5,2,0,"D"
NA,1984,"Frickley Athletic","Boston United","2-1",2,1,5,5,3,1,"H"
NA,1984,"Gateshead","Boston United","1-2",1,2,5,5,3,-1,"A"
NA,1984,"Kettering Town","Boston United","2-1",2,1,5,5,3,1,"H"
NA,1984,"Kidderminster Harriers","Boston United","2-0",2,0,5,5,2,2,"H"
NA,1984,"Maidstone United","Boston United","2-2",2,2,5,5,4,0,"D"
NA,1984,"Northwich Victoria","Boston United","1-0",1,0,5,5,1,1,"H"
NA,1984,"Nuneaton Town","Boston United","4-2",4,2,5,5,6,2,"H"
NA,1984,"Runcorn","Boston United","1-2",1,2,5,5,3,-1,"A"
NA,1984,"Scarborough","Boston United","1-0",1,0,5,5,1,1,"H"
NA,1984,"Telford United","Boston United","1-1",1,1,5,5,2,0,"D"
NA,1984,"Wealdstone","Boston United","0-1",0,1,5,5,1,-1,"A"
NA,1984,"Weymouth","Boston United","2-1",2,1,5,5,3,1,"H"
NA,1984,"Worcester City","Boston United","2-1",2,1,5,5,3,1,"H"
NA,1984,"Yeovil","Boston United","2-4",2,4,5,5,6,-2,"A"
NA,1984,"Altrincham","Dagenham","3-1",3,1,5,5,4,2,"H"
NA,1984,"Barnet","Dagenham","0-0",0,0,5,5,0,0,"D"
NA,1984,"Barrow","Dagenham","3-1",3,1,5,5,4,2,"H"
NA,1984,"Bath City","Dagenham","2-0",2,0,5,5,2,2,"H"
NA,1984,"Boston United","Dagenham","4-1",4,1,5,5,5,3,"H"
NA,1984,"Dartford","Dagenham","3-0",3,0,5,5,3,3,"H"
NA,1984,"Enfield","Dagenham","3-2",3,2,5,5,5,1,"H"
NA,1984,"Frickley Athletic","Dagenham","0-2",0,2,5,5,2,-2,"A"
NA,1984,"Gateshead","Dagenham","2-1",2,1,5,5,3,1,"H"
NA,1984,"Kettering Town","Dagenham","0-1",0,1,5,5,1,-1,"A"
NA,1984,"Kidderminster Harriers","Dagenham","5-1",5,1,5,5,6,4,"H"
NA,1984,"Maidstone United","Dagenham","0-1",0,1,5,5,1,-1,"A"
NA,1984,"Northwich Victoria","Dagenham","0-1",0,1,5,5,1,-1,"A"
NA,1984,"Nuneaton Town","Dagenham","2-2",2,2,5,5,4,0,"D"
NA,1984,"Runcorn","Dagenham","3-0",3,0,5,5,3,3,"H"
NA,1984,"Scarborough","Dagenham","5-0",5,0,5,5,5,5,"H"
NA,1984,"Telford United","Dagenham","1-1",1,1,5,5,2,0,"D"
NA,1984,"Wealdstone","Dagenham","0-0",0,0,5,5,0,0,"D"
NA,1984,"Weymouth","Dagenham","1-0",1,0,5,5,1,1,"H"
NA,1984,"Worcester City","Dagenham","1-3",1,3,5,5,4,-2,"A"
NA,1984,"Yeovil","Dagenham","2-1",2,1,5,5,3,1,"H"
NA,1984,"Altrincham","Dartford","2-1",2,1,5,5,3,1,"H"
NA,1984,"Barnet","Dartford","0-1",0,1,5,5,1,-1,"A"
NA,1984,"Barrow","Dartford","0-0",0,0,5,5,0,0,"D"
NA,1984,"Bath City","Dartford","1-0",1,0,5,5,1,1,"H"
NA,1984,"Boston United","Dartford","2-0",2,0,5,5,2,2,"H"
NA,1984,"Dagenham","Dartford","0-1",0,1,5,5,1,-1,"A"
NA,1984,"Enfield","Dartford","0-1",0,1,5,5,1,-1,"A"
NA,1984,"Frickley Athletic","Dartford","2-4",2,4,5,5,6,-2,"A"
NA,1984,"Gateshead","Dartford","0-0",0,0,5,5,0,0,"D"
NA,1984,"Kettering Town","Dartford","0-2",0,2,5,5,2,-2,"A"
NA,1984,"Kidderminster Harriers","Dartford","1-1",1,1,5,5,2,0,"D"
NA,1984,"Maidstone United","Dartford","2-1",2,1,5,5,3,1,"H"
NA,1984,"Northwich Victoria","Dartford","0-1",0,1,5,5,1,-1,"A"
NA,1984,"Nuneaton Town","Dartford","5-1",5,1,5,5,6,4,"H"
NA,1984,"Runcorn","Dartford","1-1",1,1,5,5,2,0,"D"
NA,1984,"Scarborough","Dartford","1-3",1,3,5,5,4,-2,"A"
NA,1984,"Telford United","Dartford","1-2",1,2,5,5,3,-1,"A"
NA,1984,"Wealdstone","Dartford","0-0",0,0,5,5,0,0,"D"
NA,1984,"Weymouth","Dartford","1-2",1,2,5,5,3,-1,"A"
NA,1984,"Worcester City","Dartford","2-5",2,5,5,5,7,-3,"A"
NA,1984,"Yeovil","Dartford","2-2",2,2,5,5,4,0,"D"
NA,1984,"Altrincham","Enfield","3-2",3,2,5,5,5,1,"H"
NA,1984,"Barnet","Enfield","3-2",3,2,5,5,5,1,"H"
NA,1984,"Barrow","Enfield","1-1",1,1,5,5,2,0,"D"
NA,1984,"Bath City","Enfield","1-0",1,0,5,5,1,1,"H"
NA,1984,"Boston United","Enfield","3-2",3,2,5,5,5,1,"H"
NA,1984,"Dagenham","Enfield","0-3",0,3,5,5,3,-3,"A"
NA,1984,"Dartford","Enfield","1-2",1,2,5,5,3,-1,"A"
NA,1984,"Frickley Athletic","Enfield","1-0",1,0,5,5,1,1,"H"
NA,1984,"Gateshead","Enfield","0-5",0,5,5,5,5,-5,"A"
NA,1984,"Kettering Town","Enfield","4-3",4,3,5,5,7,1,"H"
NA,1984,"Kidderminster Harriers","Enfield","1-3",1,3,5,5,4,-2,"A"
NA,1984,"Maidstone United","Enfield","2-2",2,2,5,5,4,0,"D"
NA,1984,"Northwich Victoria","Enfield","1-1",1,1,5,5,2,0,"D"
NA,1984,"Nuneaton Town","Enfield","2-2",2,2,5,5,4,0,"D"
NA,1984,"Runcorn","Enfield","1-1",1,1,5,5,2,0,"D"
NA,1984,"Scarborough","Enfield","2-3",2,3,5,5,5,-1,"A"
NA,1984,"Telford United","Enfield","2-0",2,0,5,5,2,2,"H"
NA,1984,"Wealdstone","Enfield","1-2",1,2,5,5,3,-1,"A"
NA,1984,"Weymouth","Enfield","4-2",4,2,5,5,6,2,"H"
NA,1984,"Worcester City","Enfield","1-0",1,0,5,5,1,1,"H"
NA,1984,"Yeovil","Enfield","0-0",0,0,5,5,0,0,"D"
NA,1984,"Altrincham","Frickley Athletic","3-4",3,4,5,5,7,-1,"A"
NA,1984,"Barnet","Frickley Athletic","1-2",1,2,5,5,3,-1,"A"
NA,1984,"Barrow","Frickley Athletic","6-0",6,0,5,5,6,6,"H"
NA,1984,"Bath City","Frickley Athletic","3-0",3,0,5,5,3,3,"H"
NA,1984,"Boston United","Frickley Athletic","2-1",2,1,5,5,3,1,"H"
NA,1984,"Dagenham","Frickley Athletic","4-1",4,1,5,5,5,3,"H"
NA,1984,"Dartford","Frickley Athletic","0-2",0,2,5,5,2,-2,"A"
NA,1984,"Enfield","Frickley Athletic","1-0",1,0,5,5,1,1,"H"
NA,1984,"Gateshead","Frickley Athletic","3-2",3,2,5,5,5,1,"H"
NA,1984,"Kettering Town","Frickley Athletic","5-0",5,0,5,5,5,5,"H"
NA,1984,"Kidderminster Harriers","Frickley Athletic","2-4",2,4,5,5,6,-2,"A"
NA,1984,"Maidstone United","Frickley Athletic","1-1",1,1,5,5,2,0,"D"
NA,1984,"Northwich Victoria","Frickley Athletic","3-0",3,0,5,5,3,3,"H"
NA,1984,"Nuneaton Town","Frickley Athletic","0-0",0,0,5,5,0,0,"D"
NA,1984,"Runcorn","Frickley Athletic","0-0",0,0,5,5,0,0,"D"
NA,1984,"Scarborough","Frickley Athletic","1-2",1,2,5,5,3,-1,"A"
NA,1984,"Telford United","Frickley Athletic","5-3",5,3,5,5,8,2,"H"
NA,1984,"Wealdstone","Frickley Athletic","1-1",1,1,5,5,2,0,"D"
NA,1984,"Weymouth","Frickley Athletic","2-1",2,1,5,5,3,1,"H"
NA,1984,"Worcester City","Frickley Athletic","2-1",2,1,5,5,3,1,"H"
NA,1984,"Yeovil","Frickley Athletic","1-2",1,2,5,5,3,-1,"A"
NA,1984,"Altrincham","Gateshead","2-0",2,0,5,5,2,2,"H"
NA,1984,"Barnet","Gateshead","1-1",1,1,5,5,2,0,"D"
NA,1984,"Barrow","Gateshead","0-1",0,1,5,5,1,-1,"A"
NA,1984,"Bath City","Gateshead","1-1",1,1,5,5,2,0,"D"
NA,1984,"Boston United","Gateshead","1-1",1,1,5,5,2,0,"D"
NA,1984,"Dagenham","Gateshead","0-2",0,2,5,5,2,-2,"A"
NA,1984,"Dartford","Gateshead","1-2",1,2,5,5,3,-1,"A"
NA,1984,"Enfield","Gateshead","3-1",3,1,5,5,4,2,"H"
NA,1984,"Frickley Athletic","Gateshead","1-0",1,0,5,5,1,1,"H"
NA,1984,"Kettering Town","Gateshead","1-1",1,1,5,5,2,0,"D"
NA,1984,"Kidderminster Harriers","Gateshead","3-0",3,0,5,5,3,3,"H"
NA,1984,"Maidstone United","Gateshead","1-0",1,0,5,5,1,1,"H"
NA,1984,"Northwich Victoria","Gateshead","2-0",2,0,5,5,2,2,"H"
NA,1984,"Nuneaton Town","Gateshead","3-0",3,0,5,5,3,3,"H"
NA,1984,"Runcorn","Gateshead","1-1",1,1,5,5,2,0,"D"
NA,1984,"Scarborough","Gateshead","5-1",5,1,5,5,6,4,"H"
NA,1984,"Telford United","Gateshead","1-1",1,1,5,5,2,0,"D"
NA,1984,"Wealdstone","Gateshead","4-2",4,2,5,5,6,2,"H"
NA,1984,"Weymouth","Gateshead","5-4",5,4,5,5,9,1,"H"
NA,1984,"Worcester City","Gateshead","4-1",4,1,5,5,5,3,"H"
NA,1984,"Yeovil","Gateshead","0-4",0,4,5,5,4,-4,"A"
NA,1984,"Altrincham","Kettering Town","2-1",2,1,5,5,3,1,"H"
NA,1984,"Barnet","Kettering Town","4-2",4,2,5,5,6,2,"H"
NA,1984,"Barrow","Kettering Town","0-1",0,1,5,5,1,-1,"A"
NA,1984,"Bath City","Kettering Town","1-6",1,6,5,5,7,-5,"A"
NA,1984,"Boston United","Kettering Town","3-1",3,1,5,5,4,2,"H"
NA,1984,"Dagenham","Kettering Town","2-1",2,1,5,5,3,1,"H"
NA,1984,"Dartford","Kettering Town","0-1",0,1,5,5,1,-1,"A"
NA,1984,"Enfield","Kettering Town","5-3",5,3,5,5,8,2,"H"
NA,1984,"Frickley Athletic","Kettering Town","3-0",3,0,5,5,3,3,"H"
NA,1984,"Gateshead","Kettering Town","1-4",1,4,5,5,5,-3,"A"
NA,1984,"Kidderminster Harriers","Kettering Town","2-2",2,2,5,5,4,0,"D"
NA,1984,"Maidstone United","Kettering Town","3-0",3,0,5,5,3,3,"H"
NA,1984,"Northwich Victoria","Kettering Town","1-2",1,2,5,5,3,-1,"A"
NA,1984,"Nuneaton Town","Kettering Town","1-1",1,1,5,5,2,0,"D"
NA,1984,"Runcorn","Kettering Town","2-2",2,2,5,5,4,0,"D"
NA,1984,"Scarborough","Kettering Town","0-0",0,0,5,5,0,0,"D"
NA,1984,"Telford United","Kettering Town","1-1",1,1,5,5,2,0,"D"
NA,1984,"Wealdstone","Kettering Town","1-0",1,0,5,5,1,1,"H"
NA,1984,"Weymouth","Kettering Town","3-0",3,0,5,5,3,3,"H"
NA,1984,"Worcester City","Kettering Town","1-2",1,2,5,5,3,-1,"A"
NA,1984,"Yeovil","Kettering Town","1-1",1,1,5,5,2,0,"D"
NA,1984,"Altrincham","Kidderminster Harriers","2-1",2,1,5,5,3,1,"H"
NA,1984,"Barnet","Kidderminster Harriers","2-4",2,4,5,5,6,-2,"A"
NA,1984,"Barrow","Kidderminster Harriers","3-1",3,1,5,5,4,2,"H"
NA,1984,"Bath City","Kidderminster Harriers","0-2",0,2,5,5,2,-2,"A"
NA,1984,"Boston United","Kidderminster Harriers","2-3",2,3,5,5,5,-1,"A"
NA,1984,"Dagenham","Kidderminster Harriers","2-2",2,2,5,5,4,0,"D"
NA,1984,"Dartford","Kidderminster Harriers","2-1",2,1,5,5,3,1,"H"
NA,1984,"Enfield","Kidderminster Harriers","5-2",5,2,5,5,7,3,"H"
NA,1984,"Frickley Athletic","Kidderminster Harriers","3-0",3,0,5,5,3,3,"H"
NA,1984,"Gateshead","Kidderminster Harriers","4-1",4,1,5,5,5,3,"H"
NA,1984,"Kettering Town","Kidderminster Harriers","2-2",2,2,5,5,4,0,"D"
NA,1984,"Maidstone United","Kidderminster Harriers","1-4",1,4,5,5,5,-3,"A"
NA,1984,"Northwich Victoria","Kidderminster Harriers","0-2",0,2,5,5,2,-2,"A"
NA,1984,"Nuneaton Town","Kidderminster Harriers","1-1",1,1,5,5,2,0,"D"
NA,1984,"Runcorn","Kidderminster Harriers","1-2",1,2,5,5,3,-1,"A"
NA,1984,"Scarborough","Kidderminster Harriers","2-1",2,1,5,5,3,1,"H"
NA,1984,"Telford United","Kidderminster Harriers","3-2",3,2,5,5,5,1,"H"
NA,1984,"Wealdstone","Kidderminster Harriers","5-2",5,2,5,5,7,3,"H"
NA,1984,"Weymouth","Kidderminster Harriers","0-2",0,2,5,5,2,-2,"A"
NA,1984,"Worcester City","Kidderminster Harriers","1-2",1,2,5,5,3,-1,"A"
NA,1984,"Yeovil","Kidderminster Harriers","0-0",0,0,5,5,0,0,"D"
NA,1984,"Altrincham","Maidstone United","2-0",2,0,5,5,2,2,"H"
NA,1984,"Barnet","Maidstone United","0-0",0,0,5,5,0,0,"D"
NA,1984,"Barrow","Maidstone United","0-2",0,2,5,5,2,-2,"A"
NA,1984,"Bath City","Maidstone United","1-0",1,0,5,5,1,1,"H"
NA,1984,"Boston United","Maidstone United","1-0",1,0,5,5,1,1,"H"
NA,1984,"Dagenham","Maidstone United","4-1",4,1,5,5,5,3,"H"
NA,1984,"Dartford","Maidstone United","1-1",1,1,5,5,2,0,"D"
NA,1984,"Enfield","Maidstone United","1-2",1,2,5,5,3,-1,"A"
NA,1984,"Frickley Athletic","Maidstone United","1-3",1,3,5,5,4,-2,"A"
NA,1984,"Gateshead","Maidstone United","2-1",2,1,5,5,3,1,"H"
NA,1984,"Kettering Town","Maidstone United","2-0",2,0,5,5,2,2,"H"
NA,1984,"Kidderminster Harriers","Maidstone United","2-1",2,1,5,5,3,1,"H"
NA,1984,"Northwich Victoria","Maidstone United","0-0",0,0,5,5,0,0,"D"
NA,1984,"Nuneaton Town","Maidstone United","3-2",3,2,5,5,5,1,"H"
NA,1984,"Runcorn","Maidstone United","1-4",1,4,5,5,5,-3,"A"
NA,1984,"Scarborough","Maidstone United","1-0",1,0,5,5,1,1,"H"
NA,1984,"Telford United","Maidstone United","0-0",0,0,5,5,0,0,"D"
NA,1984,"Wealdstone","Maidstone United","1-1",1,1,5,5,2,0,"D"
NA,1984,"Weymouth","Maidstone United","0-1",0,1,5,5,1,-1,"A"
NA,1984,"Worcester City","Maidstone United","1-1",1,1,5,5,2,0,"D"
NA,1984,"Yeovil","Maidstone United","3-0",3,0,5,5,3,3,"H"
NA,1984,"Altrincham","Northwich Victoria","1-2",1,2,5,5,3,-1,"A"
NA,1984,"Barnet","Northwich Victoria","1-1",1,1,5,5,2,0,"D"
NA,1984,"Barrow","Northwich Victoria","0-0",0,0,5,5,0,0,"D"
NA,1984,"Bath City","Northwich Victoria","0-3",0,3,5,5,3,-3,"A"
NA,1984,"Boston United","Northwich Victoria","3-4",3,4,5,5,7,-1,"A"
NA,1984,"Dagenham","Northwich Victoria","2-1",2,1,5,5,3,1,"H"
NA,1984,"Dartford","Northwich Victoria","1-0",1,0,5,5,1,1,"H"
NA,1984,"Enfield","Northwich Victoria","3-2",3,2,5,5,5,1,"H"
NA,1984,"Frickley Athletic","Northwich Victoria","4-0",4,0,5,5,4,4,"H"
NA,1984,"Gateshead","Northwich Victoria","2-6",2,6,5,5,8,-4,"A"
NA,1984,"Kettering Town","Northwich Victoria","2-2",2,2,5,5,4,0,"D"
NA,1984,"Kidderminster Harriers","Northwich Victoria","3-1",3,1,5,5,4,2,"H"
NA,1984,"Maidstone United","Northwich Victoria","1-0",1,0,5,5,1,1,"H"
NA,1984,"Nuneaton Town","Northwich Victoria","2-2",2,2,5,5,4,0,"D"
NA,1984,"Runcorn","Northwich Victoria","0-0",0,0,5,5,0,0,"D"
NA,1984,"Scarborough","Northwich Victoria","0-0",0,0,5,5,0,0,"D"
NA,1984,"Telford United","Northwich Victoria","0-1",0,1,5,5,1,-1,"A"
NA,1984,"Wealdstone","Northwich Victoria","1-1",1,1,5,5,2,0,"D"
NA,1984,"Weymouth","Northwich Victoria","1-0",1,0,5,5,1,1,"H"
NA,1984,"Worcester City","Northwich Victoria","0-1",0,1,5,5,1,-1,"A"
NA,1984,"Yeovil","Northwich Victoria","0-1",0,1,5,5,1,-1,"A"
NA,1984,"Altrincham","Nuneaton Town","1-0",1,0,5,5,1,1,"H"
NA,1984,"Barnet","Nuneaton Town","1-1",1,1,5,5,2,0,"D"
NA,1984,"Barrow","Nuneaton Town","0-0",0,0,5,5,0,0,"D"
NA,1984,"Bath City","Nuneaton Town","1-0",1,0,5,5,1,1,"H"
NA,1984,"Boston United","Nuneaton Town","2-3",2,3,5,5,5,-1,"A"
NA,1984,"Dagenham","Nuneaton Town","2-1",2,1,5,5,3,1,"H"
NA,1984,"Dartford","Nuneaton Town","2-2",2,2,5,5,4,0,"D"
NA,1984,"Enfield","Nuneaton Town","1-0",1,0,5,5,1,1,"H"
NA,1984,"Frickley Athletic","Nuneaton Town","1-1",1,1,5,5,2,0,"D"
NA,1984,"Gateshead","Nuneaton Town","0-2",0,2,5,5,2,-2,"A"
NA,1984,"Kettering Town","Nuneaton Town","1-1",1,1,5,5,2,0,"D"
NA,1984,"Kidderminster Harriers","Nuneaton Town","3-4",3,4,5,5,7,-1,"A"
NA,1984,"Maidstone United","Nuneaton Town","2-2",2,2,5,5,4,0,"D"
NA,1984,"Northwich Victoria","Nuneaton Town","1-0",1,0,5,5,1,1,"H"
NA,1984,"Runcorn","Nuneaton Town","1-0",1,0,5,5,1,1,"H"
NA,1984,"Scarborough","Nuneaton Town","3-2",3,2,5,5,5,1,"H"
NA,1984,"Telford United","Nuneaton Town","2-1",2,1,5,5,3,1,"H"
NA,1984,"Wealdstone","Nuneaton Town","3-1",3,1,5,5,4,2,"H"
NA,1984,"Weymouth","Nuneaton Town","1-3",1,3,5,5,4,-2,"A"
NA,1984,"Worcester City","Nuneaton Town","1-4",1,4,5,5,5,-3,"A"
NA,1984,"Yeovil","Nuneaton Town","1-2",1,2,5,5,3,-1,"A"
NA,1984,"Altrincham","Runcorn","0-1",0,1,5,5,1,-1,"A"
NA,1984,"Barnet","Runcorn","1-1",1,1,5,5,2,0,"D"
NA,1984,"Barrow","Runcorn","1-1",1,1,5,5,2,0,"D"
NA,1984,"Bath City","Runcorn","0-1",0,1,5,5,1,-1,"A"
NA,1984,"Boston United","Runcorn","2-0",2,0,5,5,2,2,"H"
NA,1984,"Dagenham","Runcorn","2-1",2,1,5,5,3,1,"H"
NA,1984,"Dartford","Runcorn","1-1",1,1,5,5,2,0,"D"
NA,1984,"Enfield","Runcorn","1-1",1,1,5,5,2,0,"D"
NA,1984,"Frickley Athletic","Runcorn","1-1",1,1,5,5,2,0,"D"
NA,1984,"Gateshead","Runcorn","0-3",0,3,5,5,3,-3,"A"
NA,1984,"Kettering Town","Runcorn","3-0",3,0,5,5,3,3,"H"
NA,1984,"Kidderminster Harriers","Runcorn","0-1",0,1,5,5,1,-1,"A"
NA,1984,"Maidstone United","Runcorn","5-1",5,1,5,5,6,4,"H"
NA,1984,"Northwich Victoria","Runcorn","0-1",0,1,5,5,1,-1,"A"
NA,1984,"Nuneaton Town","Runcorn","2-1",2,1,5,5,3,1,"H"
NA,1984,"Scarborough","Runcorn","0-0",0,0,5,5,0,0,"D"
NA,1984,"Telford United","Runcorn","3-1",3,1,5,5,4,2,"H"
NA,1984,"Wealdstone","Runcorn","1-0",1,0,5,5,1,1,"H"
NA,1984,"Weymouth","Runcorn","0-2",0,2,5,5,2,-2,"A"
NA,1984,"Worcester City","Runcorn","2-0",2,0,5,5,2,2,"H"
NA,1984,"Yeovil","Runcorn","1-3",1,3,5,5,4,-2,"A"
NA,1984,"Altrincham","Scarborough","3-0",3,0,5,5,3,3,"H"
NA,1984,"Barnet","Scarborough","1-2",1,2,5,5,3,-1,"A"
NA,1984,"Barrow","Scarborough","1-1",1,1,5,5,2,0,"D"
NA,1984,"Bath City","Scarborough","2-1",2,1,5,5,3,1,"H"
NA,1984,"Boston United","Scarborough","3-3",3,3,5,5,6,0,"D"
NA,1984,"Dagenham","Scarborough","0-2",0,2,5,5,2,-2,"A"
NA,1984,"Dartford","Scarborough","3-1",3,1,5,5,4,2,"H"
NA,1984,"Enfield","Scarborough","3-4",3,4,5,5,7,-1,"A"
NA,1984,"Frickley Athletic","Scarborough","2-3",2,3,5,5,5,-1,"A"
NA,1984,"Gateshead","Scarborough","3-1",3,1,5,5,4,2,"H"
NA,1984,"Kettering Town","Scarborough","0-1",0,1,5,5,1,-1,"A"
NA,1984,"Kidderminster Harriers","Scarborough","3-2",3,2,5,5,5,1,"H"
NA,1984,"Maidstone United","Scarborough","2-2",2,2,5,5,4,0,"D"
NA,1984,"Northwich Victoria","Scarborough","1-1",1,1,5,5,2,0,"D"
NA,1984,"Nuneaton Town","Scarborough","5-2",5,2,5,5,7,3,"H"
NA,1984,"Runcorn","Scarborough","1-1",1,1,5,5,2,0,"D"
NA,1984,"Telford United","Scarborough","1-2",1,2,5,5,3,-1,"A"
NA,1984,"Wealdstone","Scarborough","1-0",1,0,5,5,1,1,"H"
NA,1984,"Weymouth","Scarborough","1-2",1,2,5,5,3,-1,"A"
NA,1984,"Worcester City","Scarborough","4-1",4,1,5,5,5,3,"H"
NA,1984,"Yeovil","Scarborough","2-2",2,2,5,5,4,0,"D"
NA,1984,"Altrincham","Telford United","0-1",0,1,5,5,1,-1,"A"
NA,1984,"Barnet","Telford United","0-1",0,1,5,5,1,-1,"A"
NA,1984,"Barrow","Telford United","2-1",2,1,5,5,3,1,"H"
NA,1984,"Bath City","Telford United","2-1",2,1,5,5,3,1,"H"
NA,1984,"Boston United","Telford United","1-3",1,3,5,5,4,-2,"A"
NA,1984,"Dagenham","Telford United","1-0",1,0,5,5,1,1,"H"
NA,1984,"Dartford","Telford United","0-0",0,0,5,5,0,0,"D"
NA,1984,"Enfield","Telford United","0-0",0,0,5,5,0,0,"D"
NA,1984,"Frickley Athletic","Telford United","1-2",1,2,5,5,3,-1,"A"
NA,1984,"Gateshead","Telford United","1-1",1,1,5,5,2,0,"D"
NA,1984,"Kettering Town","Telford United","4-2",4,2,5,5,6,2,"H"
NA,1984,"Kidderminster Harriers","Telford United","0-2",0,2,5,5,2,-2,"A"
NA,1984,"Maidstone United","Telford United","0-0",0,0,5,5,0,0,"D"
NA,1984,"Northwich Victoria","Telford United","1-0",1,0,5,5,1,1,"H"
NA,1984,"Nuneaton Town","Telford United","2-1",2,1,5,5,3,1,"H"
NA,1984,"Runcorn","Telford United","3-0",3,0,5,5,3,3,"H"
NA,1984,"Scarborough","Telford United","4-1",4,1,5,5,5,3,"H"
NA,1984,"Wealdstone","Telford United","2-2",2,2,5,5,4,0,"D"
NA,1984,"Weymouth","Telford United","3-2",3,2,5,5,5,1,"H"
NA,1984,"Worcester City","Telford United","0-0",0,0,5,5,0,0,"D"
NA,1984,"Yeovil","Telford United","3-3",3,3,5,5,6,0,"D"
NA,1984,"Altrincham","Wealdstone","1-2",1,2,5,5,3,-1,"A"
NA,1984,"Barnet","Wealdstone","7-0",7,0,5,5,7,7,"H"
NA,1984,"Barrow","Wealdstone","2-1",2,1,5,5,3,1,"H"
NA,1984,"Bath City","Wealdstone","3-1",3,1,5,5,4,2,"H"
NA,1984,"Boston United","Wealdstone","1-1",1,1,5,5,2,0,"D"
NA,1984,"Dagenham","Wealdstone","1-2",1,2,5,5,3,-1,"A"
NA,1984,"Dartford","Wealdstone","2-3",2,3,5,5,5,-1,"A"
NA,1984,"Enfield","Wealdstone","2-0",2,0,5,5,2,2,"H"
NA,1984,"Frickley Athletic","Wealdstone","0-2",0,2,5,5,2,-2,"A"
NA,1984,"Gateshead","Wealdstone","1-2",1,2,5,5,3,-1,"A"
NA,1984,"Kettering Town","Wealdstone","0-1",0,1,5,5,1,-1,"A"
NA,1984,"Kidderminster Harriers","Wealdstone","0-3",0,3,5,5,3,-3,"A"
NA,1984,"Maidstone United","Wealdstone","0-1",0,1,5,5,1,-1,"A"
NA,1984,"Northwich Victoria","Wealdstone","0-2",0,2,5,5,2,-2,"A"
NA,1984,"Nuneaton Town","Wealdstone","1-0",1,0,5,5,1,1,"H"
NA,1984,"Runcorn","Wealdstone","2-0",2,0,5,5,2,2,"H"
NA,1984,"Scarborough","Wealdstone","1-1",1,1,5,5,2,0,"D"
NA,1984,"Telford United","Wealdstone","4-2",4,2,5,5,6,2,"H"
NA,1984,"Weymouth","Wealdstone","0-3",0,3,5,5,3,-3,"A"
NA,1984,"Worcester City","Wealdstone","0-4",0,4,5,5,4,-4,"A"
NA,1984,"Yeovil","Wealdstone","0-2",0,2,5,5,2,-2,"A"
NA,1984,"Altrincham","Weymouth","2-0",2,0,5,5,2,2,"H"
NA,1984,"Barnet","Weymouth","0-0",0,0,5,5,0,0,"D"
NA,1984,"Barrow","Weymouth","3-3",3,3,5,5,6,0,"D"
NA,1984,"Bath City","Weymouth","2-1",2,1,5,5,3,1,"H"
NA,1984,"Boston United","Weymouth","2-2",2,2,5,5,4,0,"D"
NA,1984,"Dagenham","Weymouth","2-2",2,2,5,5,4,0,"D"
NA,1984,"Dartford","Weymouth","1-1",1,1,5,5,2,0,"D"
NA,1984,"Enfield","Weymouth","2-1",2,1,5,5,3,1,"H"
NA,1984,"Frickley Athletic","Weymouth","2-0",2,0,5,5,2,2,"H"
NA,1984,"Gateshead","Weymouth","2-2",2,2,5,5,4,0,"D"
NA,1984,"Kettering Town","Weymouth","1-1",1,1,5,5,2,0,"D"
NA,1984,"Kidderminster Harriers","Weymouth","3-3",3,3,5,5,6,0,"D"
NA,1984,"Maidstone United","Weymouth","1-4",1,4,5,5,5,-3,"A"
NA,1984,"Northwich Victoria","Weymouth","0-3",0,3,5,5,3,-3,"A"
NA,1984,"Nuneaton Town","Weymouth","4-2",4,2,5,5,6,2,"H"
NA,1984,"Runcorn","Weymouth","3-1",3,1,5,5,4,2,"H"
NA,1984,"Scarborough","Weymouth","0-0",0,0,5,5,0,0,"D"
NA,1984,"Telford United","Weymouth","0-0",0,0,5,5,0,0,"D"
NA,1984,"Wealdstone","Weymouth","3-2",3,2,5,5,5,1,"H"
NA,1984,"Worcester City","Weymouth","1-1",1,1,5,5,2,0,"D"
NA,1984,"Yeovil","Weymouth","0-0",0,0,5,5,0,0,"D"
NA,1984,"Altrincham","Worcester City","1-1",1,1,5,5,2,0,"D"
NA,1984,"Barnet","Worcester City","2-0",2,0,5,5,2,2,"H"
NA,1984,"Barrow","Worcester City","1-0",1,0,5,5,1,1,"H"
NA,1984,"Bath City","Worcester City","3-1",3,1,5,5,4,2,"H"
NA,1984,"Boston United","Worcester City","4-1",4,1,5,5,5,3,"H"
NA,1984,"Dagenham","Worcester City","1-3",1,3,5,5,4,-2,"A"
NA,1984,"Dartford","Worcester City","2-3",2,3,5,5,5,-1,"A"
NA,1984,"Enfield","Worcester City","6-0",6,0,5,5,6,6,"H"
NA,1984,"Frickley Athletic","Worcester City","2-1",2,1,5,5,3,1,"H"
NA,1984,"Gateshead","Worcester City","2-2",2,2,5,5,4,0,"D"
NA,1984,"Kettering Town","Worcester City","1-0",1,0,5,5,1,1,"H"
NA,1984,"Kidderminster Harriers","Worcester City","4-1",4,1,5,5,5,3,"H"
NA,1984,"Maidstone United","Worcester City","4-0",4,0,5,5,4,4,"H"
NA,1984,"Northwich Victoria","Worcester City","2-2",2,2,5,5,4,0,"D"
NA,1984,"Nuneaton Town","Worcester City","3-0",3,0,5,5,3,3,"H"
NA,1984,"Runcorn","Worcester City","1-2",1,2,5,5,3,-1,"A"
NA,1984,"Scarborough","Worcester City","1-2",1,2,5,5,3,-1,"A"
NA,1984,"Telford United","Worcester City","1-1",1,1,5,5,2,0,"D"
NA,1984,"Wealdstone","Worcester City","3-3",3,3,5,5,6,0,"D"
NA,1984,"Weymouth","Worcester City","3-1",3,1,5,5,4,2,"H"
NA,1984,"Yeovil","Worcester City","1-2",1,2,5,5,3,-1,"A"
NA,1984,"Altrincham","Yeovil","2-0",2,0,5,5,2,2,"H"
NA,1984,"Barnet","Yeovil","4-1",4,1,5,5,5,3,"H"
NA,1984,"Barrow","Yeovil","2-2",2,2,5,5,4,0,"D"
NA,1984,"Bath City","Yeovil","1-0",1,0,5,5,1,1,"H"
NA,1984,"Boston United","Yeovil","3-0",3,0,5,5,3,3,"H"
NA,1984,"Dagenham","Yeovil","2-0",2,0,5,5,2,2,"H"
NA,1984,"Dartford","Yeovil","1-1",1,1,5,5,2,0,"D"
NA,1984,"Enfield","Yeovil","4-0",4,0,5,5,4,4,"H"
NA,1984,"Frickley Athletic","Yeovil","3-1",3,1,5,5,4,2,"H"
NA,1984,"Gateshead","Yeovil","1-1",1,1,5,5,2,0,"D"
NA,1984,"Kettering Town","Yeovil","3-0",3,0,5,5,3,3,"H"
NA,1984,"Kidderminster Harriers","Yeovil","3-0",3,0,5,5,3,3,"H"
NA,1984,"Maidstone United","Yeovil","3-3",3,3,5,5,6,0,"D"
NA,1984,"Northwich Victoria","Yeovil","2-0",2,0,5,5,2,2,"H"
NA,1984,"Nuneaton Town","Yeovil","5-0",5,0,5,5,5,5,"H"
NA,1984,"Runcorn","Yeovil","3-0",3,0,5,5,3,3,"H"
NA,1984,"Scarborough","Yeovil","2-1",2,1,5,5,3,1,"H"
NA,1984,"Telford United","Yeovil","3-1",3,1,5,5,4,2,"H"
NA,1984,"Wealdstone","Yeovil","0-3",0,3,5,5,3,-3,"A"
NA,1984,"Weymouth","Yeovil","4-2",4,2,5,5,6,2,"H"
NA,1984,"Worcester City","Yeovil","0-2",0,2,5,5,2,-2,"A"
NA,1985,"Barnet","Altrincham","2-2",2,2,5,5,4,0,"D"
NA,1985,"Barrow","Altrincham","0-1",0,1,5,5,1,-1,"A"
NA,1985,"Bath City","Altrincham","0-2",0,2,5,5,2,-2,"A"
NA,1985,"Boston United","Altrincham","1-3",1,3,5,5,4,-2,"A"
NA,1985,"Cheltenham","Altrincham","2-0",2,0,5,5,2,2,"H"
NA,1985,"Dagenham","Altrincham","1-3",1,3,5,5,4,-2,"A"
NA,1985,"Dartford","Altrincham","3-2",3,2,5,5,5,1,"H"
NA,1985,"Enfield","Altrincham","1-1",1,1,5,5,2,0,"D"
NA,1985,"Frickley Athletic","Altrincham","0-0",0,0,5,5,0,0,"D"
NA,1985,"Kettering Town","Altrincham","2-2",2,2,5,5,4,0,"D"
NA,1985,"Kidderminster Harriers","Altrincham","0-2",0,2,5,5,2,-2,"A"
NA,1985,"Maidstone United","Altrincham","1-2",1,2,5,5,3,-1,"A"
NA,1985,"Northwich Victoria","Altrincham","1-2",1,2,5,5,3,-1,"A"
NA,1985,"Nuneaton Town","Altrincham","0-0",0,0,5,5,0,0,"D"
NA,1985,"Runcorn","Altrincham","2-1",2,1,5,5,3,1,"H"
NA,1985,"Scarborough","Altrincham","1-0",1,0,5,5,1,1,"H"
NA,1985,"Stafford Rangers","Altrincham","1-1",1,1,5,5,2,0,"D"
NA,1985,"Telford United","Altrincham","2-1",2,1,5,5,3,1,"H"
NA,1985,"Wealdstone","Altrincham","2-2",2,2,5,5,4,0,"D"
NA,1985,"Weymouth","Altrincham","0-0",0,0,5,5,0,0,"D"
NA,1985,"Wycombe Wanderers","Altrincham","0-1",0,1,5,5,1,-1,"A"
NA,1985,"Altrincham","Barnet","2-0",2,0,5,5,2,2,"H"
NA,1985,"Barrow","Barnet","0-1",0,1,5,5,1,-1,"A"
NA,1985,"Bath City","Barnet","1-1",1,1,5,5,2,0,"D"
NA,1985,"Boston United","Barnet","1-2",1,2,5,5,3,-1,"A"
NA,1985,"Cheltenham","Barnet","2-1",2,1,5,5,3,1,"H"
NA,1985,"Dagenham","Barnet","2-1",2,1,5,5,3,1,"H"
NA,1985,"Dartford","Barnet","5-3",5,3,5,5,8,2,"H"
NA,1985,"Enfield","Barnet","1-0",1,0,5,5,1,1,"H"
NA,1985,"Frickley Athletic","Barnet","3-3",3,3,5,5,6,0,"D"
NA,1985,"Kettering Town","Barnet","1-1",1,1,5,5,2,0,"D"
NA,1985,"Kidderminster Harriers","Barnet","0-2",0,2,5,5,2,-2,"A"
NA,1985,"Maidstone United","Barnet","2-2",2,2,5,5,4,0,"D"
NA,1985,"Northwich Victoria","Barnet","0-1",0,1,5,5,1,-1,"A"
NA,1985,"Nuneaton Town","Barnet","4-1",4,1,5,5,5,3,"H"
NA,1985,"Runcorn","Barnet","0-0",0,0,5,5,0,0,"D"
NA,1985,"Scarborough","Barnet","3-1",3,1,5,5,4,2,"H"
NA,1985,"Stafford Rangers","Barnet","0-0",0,0,5,5,0,0,"D"
NA,1985,"Telford United","Barnet","2-2",2,2,5,5,4,0,"D"
NA,1985,"Wealdstone","Barnet","2-0",2,0,5,5,2,2,"H"
NA,1985,"Weymouth","Barnet","4-2",4,2,5,5,6,2,"H"
NA,1985,"Wycombe Wanderers","Barnet","2-0",2,0,5,5,2,2,"H"
NA,1985,"Altrincham","Barrow","2-0",2,0,5,5,2,2,"H"
NA,1985,"Barnet","Barrow","4-1",4,1,5,5,5,3,"H"
NA,1985,"Bath City","Barrow","6-0",6,0,5,5,6,6,"H"
NA,1985,"Boston United","Barrow","2-1",2,1,5,5,3,1,"H"
NA,1985,"Cheltenham","Barrow","2-0",2,0,5,5,2,2,"H"
NA,1985,"Dagenham","Barrow","3-0",3,0,5,5,3,3,"H"
NA,1985,"Dartford","Barrow","3-2",3,2,5,5,5,1,"H"
NA,1985,"Enfield","Barrow","4-0",4,0,5,5,4,4,"H"
NA,1985,"Frickley Athletic","Barrow","2-0",2,0,5,5,2,2,"H"
NA,1985,"Kettering Town","Barrow","4-2",4,2,5,5,6,2,"H"
NA,1985,"Kidderminster Harriers","Barrow","2-1",2,1,5,5,3,1,"H"
NA,1985,"Maidstone United","Barrow","0-0",0,0,5,5,0,0,"D"
NA,1985,"Northwich Victoria","Barrow","0-1",0,1,5,5,1,-1,"A"
NA,1985,"Nuneaton Town","Barrow","0-1",0,1,5,5,1,-1,"A"
NA,1985,"Runcorn","Barrow","3-1",3,1,5,5,4,2,"H"
NA,1985,"Scarborough","Barrow","3-1",3,1,5,5,4,2,"H"
NA,1985,"Stafford Rangers","Barrow","1-0",1,0,5,5,1,1,"H"
NA,1985,"Telford United","Barrow","3-1",3,1,5,5,4,2,"H"
NA,1985,"Wealdstone","Barrow","4-0",4,0,5,5,4,4,"H"
NA,1985,"Weymouth","Barrow","3-2",3,2,5,5,5,1,"H"
NA,1985,"Wycombe Wanderers","Barrow","1-1",1,1,5,5,2,0,"D"
NA,1985,"Altrincham","Bath City","1-2",1,2,5,5,3,-1,"A"
NA,1985,"Barnet","Bath City","1-0",1,0,5,5,1,1,"H"
NA,1985,"Barrow","Bath City","1-1",1,1,5,5,2,0,"D"
NA,1985,"Boston United","Bath City","1-1",1,1,5,5,2,0,"D"
NA,1985,"Cheltenham","Bath City","1-2",1,2,5,5,3,-1,"A"
NA,1985,"Dagenham","Bath City","0-1",0,1,5,5,1,-1,"A"
NA,1985,"Dartford","Bath City","1-2",1,2,5,5,3,-1,"A"
NA,1985,"Enfield","Bath City","3-1",3,1,5,5,4,2,"H"
NA,1985,"Frickley Athletic","Bath City","2-1",2,1,5,5,3,1,"H"
NA,1985,"Kettering Town","Bath City","2-0",2,0,5,5,2,2,"H"
NA,1985,"Kidderminster Harriers","Bath City","3-1",3,1,5,5,4,2,"H"
NA,1985,"Maidstone United","Bath City","3-2",3,2,5,5,5,1,"H"
NA,1985,"Northwich Victoria","Bath City","1-2",1,2,5,5,3,-1,"A"
NA,1985,"Nuneaton Town","Bath City","2-3",2,3,5,5,5,-1,"A"
NA,1985,"Runcorn","Bath City","2-0",2,0,5,5,2,2,"H"
NA,1985,"Scarborough","Bath City","2-1",2,1,5,5,3,1,"H"
NA,1985,"Stafford Rangers","Bath City","1-0",1,0,5,5,1,1,"H"
NA,1985,"Telford United","Bath City","1-0",1,0,5,5,1,1,"H"
NA,1985,"Wealdstone","Bath City","0-1",0,1,5,5,1,-1,"A"
NA,1985,"Weymouth","Bath City","0-0",0,0,5,5,0,0,"D"
NA,1985,"Wycombe Wanderers","Bath City","1-4",1,4,5,5,5,-3,"A"
NA,1985,"Altrincham","Boston United","1-3",1,3,5,5,4,-2,"A"
NA,1985,"Barnet","Boston United","3-0",3,0,5,5,3,3,"H"
NA,1985,"Barrow","Boston United","2-1",2,1,5,5,3,1,"H"
NA,1985,"Bath City","Boston United","2-0",2,0,5,5,2,2,"H"
NA,1985,"Cheltenham","Boston United","2-1",2,1,5,5,3,1,"H"
NA,1985,"Dagenham","Boston United","2-2",2,2,5,5,4,0,"D"
NA,1985,"Dartford","Boston United","0-1",0,1,5,5,1,-1,"A"
NA,1985,"Enfield","Boston United","3-0",3,0,5,5,3,3,"H"
NA,1985,"Frickley Athletic","Boston United","5-1",5,1,5,5,6,4,"H"
NA,1985,"Kettering Town","Boston United","3-1",3,1,5,5,4,2,"H"
NA,1985,"Kidderminster Harriers","Boston United","3-2",3,2,5,5,5,1,"H"
NA,1985,"Maidstone United","Boston United","1-2",1,2,5,5,3,-1,"A"
NA,1985,"Northwich Victoria","Boston United","3-4",3,4,5,5,7,-1,"A"
NA,1985,"Nuneaton Town","Boston United","0-1",0,1,5,5,1,-1,"A"
NA,1985,"Runcorn","Boston United","3-0",3,0,5,5,3,3,"H"
NA,1985,"Scarborough","Boston United","2-1",2,1,5,5,3,1,"H"
NA,1985,"Stafford Rangers","Boston United","2-1",2,1,5,5,3,1,"H"
NA,1985,"Telford United","Boston United","2-1",2,1,5,5,3,1,"H"
NA,1985,"Wealdstone","Boston United","7-2",7,2,5,5,9,5,"H"
NA,1985,"Weymouth","Boston United","0-0",0,0,5,5,0,0,"D"
NA,1985,"Wycombe Wanderers","Boston United","4-1",4,1,5,5,5,3,"H"
NA,1985,"Altrincham","Cheltenham","4-1",4,1,5,5,5,3,"H"
NA,1985,"Barnet","Cheltenham","2-2",2,2,5,5,4,0,"D"
NA,1985,"Barrow","Cheltenham","2-2",2,2,5,5,4,0,"D"
NA,1985,"Bath City","Cheltenham","1-1",1,1,5,5,2,0,"D"
NA,1985,"Boston United","Cheltenham","1-2",1,2,5,5,3,-1,"A"
NA,1985,"Dagenham","Cheltenham","1-3",1,3,5,5,4,-2,"A"
NA,1985,"Dartford","Cheltenham","3-3",3,3,5,5,6,0,"D"
NA,1985,"Enfield","Cheltenham","1-0",1,0,5,5,1,1,"H"
NA,1985,"Frickley Athletic","Cheltenham","2-1",2,1,5,5,3,1,"H"
NA,1985,"Kettering Town","Cheltenham","2-1",2,1,5,5,3,1,"H"
NA,1985,"Kidderminster Harriers","Cheltenham","5-1",5,1,5,5,6,4,"H"
NA,1985,"Maidstone United","Cheltenham","1-0",1,0,5,5,1,1,"H"
NA,1985,"Northwich Victoria","Cheltenham","3-1",3,1,5,5,4,2,"H"
NA,1985,"Nuneaton Town","Cheltenham","0-1",0,1,5,5,1,-1,"A"
NA,1985,"Runcorn","Cheltenham","5-0",5,0,5,5,5,5,"H"
NA,1985,"Scarborough","Cheltenham","2-1",2,1,5,5,3,1,"H"
NA,1985,"Stafford Rangers","Cheltenham","2-0",2,0,5,5,2,2,"H"
NA,1985,"Telford United","Cheltenham","3-0",3,0,5,5,3,3,"H"
NA,1985,"Wealdstone","Cheltenham","0-0",0,0,5,5,0,0,"D"
NA,1985,"Weymouth","Cheltenham","0-0",0,0,5,5,0,0,"D"
NA,1985,"Wycombe Wanderers","Cheltenham","3-3",3,3,5,5,6,0,"D"
NA,1985,"Altrincham","Dagenham","3-1",3,1,5,5,4,2,"H"
NA,1985,"Barnet","Dagenham","4-1",4,1,5,5,5,3,"H"
NA,1985,"Barrow","Dagenham","1-0",1,0,5,5,1,1,"H"
NA,1985,"Bath City","Dagenham","1-1",1,1,5,5,2,0,"D"
NA,1985,"Boston United","Dagenham","3-0",3,0,5,5,3,3,"H"
NA,1985,"Cheltenham","Dagenham","2-2",2,2,5,5,4,0,"D"
NA,1985,"Dartford","Dagenham","1-1",1,1,5,5,2,0,"D"
NA,1985,"Enfield","Dagenham","3-1",3,1,5,5,4,2,"H"
NA,1985,"Frickley Athletic","Dagenham","3-2",3,2,5,5,5,1,"H"
NA,1985,"Kettering Town","Dagenham","0-2",0,2,5,5,2,-2,"A"
NA,1985,"Kidderminster Harriers","Dagenham","2-0",2,0,5,5,2,2,"H"
NA,1985,"Maidstone United","Dagenham","2-1",2,1,5,5,3,1,"H"
NA,1985,"Northwich Victoria","Dagenham","0-1",0,1,5,5,1,-1,"A"
NA,1985,"Nuneaton Town","Dagenham","1-2",1,2,5,5,3,-1,"A"
NA,1985,"Runcorn","Dagenham","1-1",1,1,5,5,2,0,"D"
NA,1985,"Scarborough","Dagenham","2-1",2,1,5,5,3,1,"H"
NA,1985,"Stafford Rangers","Dagenham","3-1",3,1,5,5,4,2,"H"
NA,1985,"Telford United","Dagenham","2-1",2,1,5,5,3,1,"H"
NA,1985,"Wealdstone","Dagenham","0-4",0,4,5,5,4,-4,"A"
NA,1985,"Weymouth","Dagenham","2-1",2,1,5,5,3,1,"H"
NA,1985,"Wycombe Wanderers","Dagenham","1-1",1,1,5,5,2,0,"D"
NA,1985,"Altrincham","Dartford","0-0",0,0,5,5,0,0,"D"
NA,1985,"Barnet","Dartford","2-0",2,0,5,5,2,2,"H"
NA,1985,"Barrow","Dartford","1-2",1,2,5,5,3,-1,"A"
NA,1985,"Bath City","Dartford","2-0",2,0,5,5,2,2,"H"
NA,1985,"Boston United","Dartford","3-0",3,0,5,5,3,3,"H"
NA,1985,"Cheltenham","Dartford","3-1",3,1,5,5,4,2,"H"
NA,1985,"Dagenham","Dartford","2-1",2,1,5,5,3,1,"H"
NA,1985,"Enfield","Dartford","1-0",1,0,5,5,1,1,"H"
NA,1985,"Frickley Athletic","Dartford","1-0",1,0,5,5,1,1,"H"
NA,1985,"Kettering Town","Dartford","2-2",2,2,5,5,4,0,"D"
NA,1985,"Kidderminster Harriers","Dartford","4-1",4,1,5,5,5,3,"H"
NA,1985,"Maidstone United","Dartford","3-0",3,0,5,5,3,3,"H"
NA,1985,"Northwich Victoria","Dartford","2-0",2,0,5,5,2,2,"H"
NA,1985,"Nuneaton Town","Dartford","3-1",3,1,5,5,4,2,"H"
NA,1985,"Runcorn","Dartford","5-0",5,0,5,5,5,5,"H"
NA,1985,"Scarborough","Dartford","1-1",1,1,5,5,2,0,"D"
NA,1985,"Stafford Rangers","Dartford","5-1",5,1,5,5,6,4,"H"
NA,1985,"Telford United","Dartford","2-1",2,1,5,5,3,1,"H"
NA,1985,"Wealdstone","Dartford","2-1",2,1,5,5,3,1,"H"
NA,1985,"Weymouth","Dartford","2-1",2,1,5,5,3,1,"H"
NA,1985,"Wycombe Wanderers","Dartford","3-2",3,2,5,5,5,1,"H"
NA,1985,"Altrincham","Enfield","1-4",1,4,5,5,5,-3,"A"
NA,1985,"Barnet","Enfield","0-1",0,1,5,5,1,-1,"A"
NA,1985,"Barrow","Enfield","1-2",1,2,5,5,3,-1,"A"
NA,1985,"Bath City","Enfield","0-2",0,2,5,5,2,-2,"A"
NA,1985,"Boston United","Enfield","1-2",1,2,5,5,3,-1,"A"
NA,1985,"Cheltenham","Enfield","2-0",2,0,5,5,2,2,"H"
NA,1985,"Dagenham","Enfield","0-2",0,2,5,5,2,-2,"A"
NA,1985,"Dartford","Enfield","2-3",2,3,5,5,5,-1,"A"
NA,1985,"Frickley Athletic","Enfield","1-4",1,4,5,5,5,-3,"A"
NA,1985,"Kettering Town","Enfield","2-1",2,1,5,5,3,1,"H"
NA,1985,"Kidderminster Harriers","Enfield","1-2",1,2,5,5,3,-1,"A"
NA,1985,"Maidstone United","Enfield","3-3",3,3,5,5,6,0,"D"
NA,1985,"Northwich Victoria","Enfield","2-2",2,2,5,5,4,0,"D"
NA,1985,"Nuneaton Town","Enfield","1-5",1,5,5,5,6,-4,"A"
NA,1985,"Runcorn","Enfield","1-1",1,1,5,5,2,0,"D"
NA,1985,"Scarborough","Enfield","1-3",1,3,5,5,4,-2,"A"
NA,1985,"Stafford Rangers","Enfield","1-1",1,1,5,5,2,0,"D"
NA,1985,"Telford United","Enfield","2-2",2,2,5,5,4,0,"D"
NA,1985,"Wealdstone","Enfield","2-4",2,4,5,5,6,-2,"A"
NA,1985,"Weymouth","Enfield","2-2",2,2,5,5,4,0,"D"
NA,1985,"Wycombe Wanderers","Enfield","1-0",1,0,5,5,1,1,"H"
NA,1985,"Altrincham","Frickley Athletic","1-0",1,0,5,5,1,1,"H"
NA,1985,"Barnet","Frickley Athletic","1-2",1,2,5,5,3,-1,"A"
NA,1985,"Barrow","Frickley Athletic","2-2",2,2,5,5,4,0,"D"
NA,1985,"Bath City","Frickley Athletic","1-2",1,2,5,5,3,-1,"A"
NA,1985,"Boston United","Frickley Athletic","0-3",0,3,5,5,3,-3,"A"
NA,1985,"Cheltenham","Frickley Athletic","1-1",1,1,5,5,2,0,"D"
NA,1985,"Dagenham","Frickley Athletic","0-0",0,0,5,5,0,0,"D"
NA,1985,"Dartford","Frickley Athletic","1-2",1,2,5,5,3,-1,"A"
NA,1985,"Enfield","Frickley Athletic","3-1",3,1,5,5,4,2,"H"
NA,1985,"Kettering Town","Frickley Athletic","2-0",2,0,5,5,2,2,"H"
NA,1985,"Kidderminster Harriers","Frickley Athletic","1-0",1,0,5,5,1,1,"H"
NA,1985,"Maidstone United","Frickley Athletic","3-2",3,2,5,5,5,1,"H"
NA,1985,"Northwich Victoria","Frickley Athletic","2-3",2,3,5,5,5,-1,"A"
NA,1985,"Nuneaton Town","Frickley Athletic","0-1",0,1,5,5,1,-1,"A"
NA,1985,"Runcorn","Frickley Athletic","2-2",2,2,5,5,4,0,"D"
NA,1985,"Scarborough","Frickley Athletic","2-3",2,3,5,5,5,-1,"A"
NA,1985,"Stafford Rangers","Frickley Athletic","0-0",0,0,5,5,0,0,"D"
NA,1985,"Telford United","Frickley Athletic","2-1",2,1,5,5,3,1,"H"
NA,1985,"Wealdstone","Frickley Athletic","2-0",2,0,5,5,2,2,"H"
NA,1985,"Weymouth","Frickley Athletic","2-3",2,3,5,5,5,-1,"A"
NA,1985,"Wycombe Wanderers","Frickley Athletic","1-3",1,3,5,5,4,-2,"A"
NA,1985,"Altrincham","Kettering Town","2-2",2,2,5,5,4,0,"D"
NA,1985,"Barnet","Kettering Town","3-0",3,0,5,5,3,3,"H"
NA,1985,"Barrow","Kettering Town","1-0",1,0,5,5,1,1,"H"
NA,1985,"Bath City","Kettering Town","1-1",1,1,5,5,2,0,"D"
NA,1985,"Boston United","Kettering Town","4-1",4,1,5,5,5,3,"H"
NA,1985,"Cheltenham","Kettering Town","5-1",5,1,5,5,6,4,"H"
NA,1985,"Dagenham","Kettering Town","1-0",1,0,5,5,1,1,"H"
NA,1985,"Dartford","Kettering Town","0-2",0,2,5,5,2,-2,"A"
NA,1985,"Enfield","Kettering Town","1-1",1,1,5,5,2,0,"D"
NA,1985,"Frickley Athletic","Kettering Town","3-0",3,0,5,5,3,3,"H"
NA,1985,"Kidderminster Harriers","Kettering Town","0-0",0,0,5,5,0,0,"D"
NA,1985,"Maidstone United","Kettering Town","0-0",0,0,5,5,0,0,"D"
NA,1985,"Northwich Victoria","Kettering Town","0-0",0,0,5,5,0,0,"D"
NA,1985,"Nuneaton Town","Kettering Town","0-3",0,3,5,5,3,-3,"A"
NA,1985,"Runcorn","Kettering Town","0-1",0,1,5,5,1,-1,"A"
NA,1985,"Scarborough","Kettering Town","2-3",2,3,5,5,5,-1,"A"
NA,1985,"Stafford Rangers","Kettering Town","0-0",0,0,5,5,0,0,"D"
NA,1985,"Telford United","Kettering Town","2-2",2,2,5,5,4,0,"D"
NA,1985,"Wealdstone","Kettering Town","3-1",3,1,5,5,4,2,"H"
NA,1985,"Weymouth","Kettering Town","1-0",1,0,5,5,1,1,"H"
NA,1985,"Wycombe Wanderers","Kettering Town","0-0",0,0,5,5,0,0,"D"
NA,1985,"Altrincham","Kidderminster Harriers","2-1",2,1,5,5,3,1,"H"
NA,1985,"Barnet","Kidderminster Harriers","0-1",0,1,5,5,1,-1,"A"
NA,1985,"Barrow","Kidderminster Harriers","3-4",3,4,5,5,7,-1,"A"
NA,1985,"Bath City","Kidderminster Harriers","2-4",2,4,5,5,6,-2,"A"
NA,1985,"Boston United","Kidderminster Harriers","2-1",2,1,5,5,3,1,"H"
NA,1985,"Cheltenham","Kidderminster Harriers","2-6",2,6,5,5,8,-4,"A"
NA,1985,"Dagenham","Kidderminster Harriers","0-1",0,1,5,5,1,-1,"A"
NA,1985,"Dartford","Kidderminster Harriers","5-1",5,1,5,5,6,4,"H"
NA,1985,"Enfield","Kidderminster Harriers","2-2",2,2,5,5,4,0,"D"
NA,1985,"Frickley Athletic","Kidderminster Harriers","3-1",3,1,5,5,4,2,"H"
NA,1985,"Kettering Town","Kidderminster Harriers","2-2",2,2,5,5,4,0,"D"
NA,1985,"Maidstone United","Kidderminster Harriers","2-1",2,1,5,5,3,1,"H"
NA,1985,"Northwich Victoria","Kidderminster Harriers","0-0",0,0,5,5,0,0,"D"
NA,1985,"Nuneaton Town","Kidderminster Harriers","0-3",0,3,5,5,3,-3,"A"
NA,1985,"Runcorn","Kidderminster Harriers","0-2",0,2,5,5,2,-2,"A"
NA,1985,"Scarborough","Kidderminster Harriers","3-5",3,5,5,5,8,-2,"A"
NA,1985,"Stafford Rangers","Kidderminster Harriers","3-2",3,2,5,5,5,1,"H"
NA,1985,"Telford United","Kidderminster Harriers","0-1",0,1,5,5,1,-1,"A"
NA,1985,"Wealdstone","Kidderminster Harriers","0-3",0,3,5,5,3,-3,"A"
NA,1985,"Weymouth","Kidderminster Harriers","1-2",1,2,5,5,3,-1,"A"
NA,1985,"Wycombe Wanderers","Kidderminster Harriers","2-5",2,5,5,5,7,-3,"A"
NA,1985,"Altrincham","Maidstone United","1-0",1,0,5,5,1,1,"H"
NA,1985,"Barnet","Maidstone United","3-3",3,3,5,5,6,0,"D"
NA,1985,"Barrow","Maidstone United","1-1",1,1,5,5,2,0,"D"
NA,1985,"Bath City","Maidstone United","1-1",1,1,5,5,2,0,"D"
NA,1985,"Boston United","Maidstone United","2-2",2,2,5,5,4,0,"D"
NA,1985,"Cheltenham","Maidstone United","2-1",2,1,5,5,3,1,"H"
NA,1985,"Dagenham","Maidstone United","0-0",0,0,5,5,0,0,"D"
NA,1985,"Dartford","Maidstone United","1-1",1,1,5,5,2,0,"D"
NA,1985,"Enfield","Maidstone United","1-3",1,3,5,5,4,-2,"A"
NA,1985,"Frickley Athletic","Maidstone United","2-0",2,0,5,5,2,2,"H"
NA,1985,"Kettering Town","Maidstone United","2-0",2,0,5,5,2,2,"H"
NA,1985,"Kidderminster Harriers","Maidstone United","3-1",3,1,5,5,4,2,"H"
NA,1985,"Northwich Victoria","Maidstone United","1-0",1,0,5,5,1,1,"H"
NA,1985,"Nuneaton Town","Maidstone United","1-0",1,0,5,5,1,1,"H"
NA,1985,"Runcorn","Maidstone United","3-0",3,0,5,5,3,3,"H"
NA,1985,"Scarborough","Maidstone United","2-0",2,0,5,5,2,2,"H"
NA,1985,"Stafford Rangers","Maidstone United","2-1",2,1,5,5,3,1,"H"
NA,1985,"Telford United","Maidstone United","2-4",2,4,5,5,6,-2,"A"
NA,1985,"Wealdstone","Maidstone United","3-2",3,2,5,5,5,1,"H"
NA,1985,"Weymouth","Maidstone United","2-0",2,0,5,5,2,2,"H"
NA,1985,"Wycombe Wanderers","Maidstone United","2-2",2,2,5,5,4,0,"D"
NA,1985,"Altrincham","Northwich Victoria","2-1",2,1,5,5,3,1,"H"
NA,1985,"Barnet","Northwich Victoria","1-0",1,0,5,5,1,1,"H"
NA,1985,"Barrow","Northwich Victoria","1-2",1,2,5,5,3,-1,"A"
NA,1985,"Bath City","Northwich Victoria","0-0",0,0,5,5,0,0,"D"
NA,1985,"Boston United","Northwich Victoria","3-0",3,0,5,5,3,3,"H"
NA,1985,"Cheltenham","Northwich Victoria","2-0",2,0,5,5,2,2,"H"
NA,1985,"Dagenham","Northwich Victoria","1-0",1,0,5,5,1,1,"H"
NA,1985,"Dartford","Northwich Victoria","2-0",2,0,5,5,2,2,"H"
NA,1985,"Enfield","Northwich Victoria","1-0",1,0,5,5,1,1,"H"
NA,1985,"Frickley Athletic","Northwich Victoria","1-0",1,0,5,5,1,1,"H"
NA,1985,"Kettering Town","Northwich Victoria","2-1",2,1,5,5,3,1,"H"
NA,1985,"Kidderminster Harriers","Northwich Victoria","2-2",2,2,5,5,4,0,"D"
NA,1985,"Maidstone United","Northwich Victoria","0-1",0,1,5,5,1,-1,"A"
NA,1985,"Nuneaton Town","Northwich Victoria","1-3",1,3,5,5,4,-2,"A"
NA,1985,"Runcorn","Northwich Victoria","2-3",2,3,5,5,5,-1,"A"
NA,1985,"Scarborough","Northwich Victoria","0-0",0,0,5,5,0,0,"D"
NA,1985,"Stafford Rangers","Northwich Victoria","1-2",1,2,5,5,3,-1,"A"
NA,1985,"Telford United","Northwich Victoria","4-0",4,0,5,5,4,4,"H"
NA,1985,"Wealdstone","Northwich Victoria","0-0",0,0,5,5,0,0,"D"
NA,1985,"Weymouth","Northwich Victoria","2-2",2,2,5,5,4,0,"D"
NA,1985,"Wycombe Wanderers","Northwich Victoria","1-1",1,1,5,5,2,0,"D"
NA,1985,"Altrincham","Nuneaton Town","7-4",7,4,5,5,11,3,"H"
NA,1985,"Barnet","Nuneaton Town","0-1",0,1,5,5,1,-1,"A"
NA,1985,"Barrow","Nuneaton Town","2-0",2,0,5,5,2,2,"H"
NA,1985,"Bath City","Nuneaton Town","0-2",0,2,5,5,2,-2,"A"
NA,1985,"Boston United","Nuneaton Town","3-2",3,2,5,5,5,1,"H"
NA,1985,"Cheltenham","Nuneaton Town","5-3",5,3,5,5,8,2,"H"
NA,1985,"Dagenham","Nuneaton Town","3-2",3,2,5,5,5,1,"H"
NA,1985,"Dartford","Nuneaton Town","0-1",0,1,5,5,1,-1,"A"
NA,1985,"Enfield","Nuneaton Town","3-2",3,2,5,5,5,1,"H"
NA,1985,"Frickley Athletic","Nuneaton Town","2-2",2,2,5,5,4,0,"D"
NA,1985,"Kettering Town","Nuneaton Town","1-4",1,4,5,5,5,-3,"A"
NA,1985,"Kidderminster Harriers","Nuneaton Town","2-1",2,1,5,5,3,1,"H"
NA,1985,"Maidstone United","Nuneaton Town","5-1",5,1,5,5,6,4,"H"
NA,1985,"Northwich Victoria","Nuneaton Town","0-3",0,3,5,5,3,-3,"A"
NA,1985,"Runcorn","Nuneaton Town","3-1",3,1,5,5,4,2,"H"
NA,1985,"Scarborough","Nuneaton Town","2-1",2,1,5,5,3,1,"H"
NA,1985,"Stafford Rangers","Nuneaton Town","2-0",2,0,5,5,2,2,"H"
NA,1985,"Telford United","Nuneaton Town","1-1",1,1,5,5,2,0,"D"
NA,1985,"Wealdstone","Nuneaton Town","1-0",1,0,5,5,1,1,"H"
NA,1985,"Weymouth","Nuneaton Town","2-0",2,0,5,5,2,2,"H"
NA,1985,"Wycombe Wanderers","Nuneaton Town","2-0",2,0,5,5,2,2,"H"
NA,1985,"Altrincham","Runcorn","1-1",1,1,5,5,2,0,"D"
NA,1985,"Barnet","Runcorn","1-2",1,2,5,5,3,-1,"A"
NA,1985,"Barrow","Runcorn","0-4",0,4,5,5,4,-4,"A"
NA,1985,"Bath City","Runcorn","0-1",0,1,5,5,1,-1,"A"
NA,1985,"Boston United","Runcorn","2-1",2,1,5,5,3,1,"H"
NA,1985,"Cheltenham","Runcorn","1-1",1,1,5,5,2,0,"D"
NA,1985,"Dagenham","Runcorn","2-3",2,3,5,5,5,-1,"A"
NA,1985,"Dartford","Runcorn","0-1",0,1,5,5,1,-1,"A"
NA,1985,"Enfield","Runcorn","2-0",2,0,5,5,2,2,"H"
NA,1985,"Frickley Athletic","Runcorn","3-1",3,1,5,5,4,2,"H"
NA,1985,"Kettering Town","Runcorn","0-0",0,0,5,5,0,0,"D"
NA,1985,"Kidderminster Harriers","Runcorn","2-4",2,4,5,5,6,-2,"A"
NA,1985,"Maidstone United","Runcorn","1-1",1,1,5,5,2,0,"D"
NA,1985,"Northwich Victoria","Runcorn","1-1",1,1,5,5,2,0,"D"
NA,1985,"Nuneaton Town","Runcorn","1-0",1,0,5,5,1,1,"H"
NA,1985,"Scarborough","Runcorn","1-1",1,1,5,5,2,0,"D"
NA,1985,"Stafford Rangers","Runcorn","1-1",1,1,5,5,2,0,"D"
NA,1985,"Telford United","Runcorn","2-3",2,3,5,5,5,-1,"A"
NA,1985,"Wealdstone","Runcorn","1-1",1,1,5,5,2,0,"D"
NA,1985,"Weymouth","Runcorn","5-2",5,2,5,5,7,3,"H"
NA,1985,"Wycombe Wanderers","Runcorn","0-1",0,1,5,5,1,-1,"A"
NA,1985,"Altrincham","Scarborough","2-0",2,0,5,5,2,2,"H"
NA,1985,"Barnet","Scarborough","1-0",1,0,5,5,1,1,"H"
NA,1985,"Barrow","Scarborough","2-4",2,4,5,5,6,-2,"A"
NA,1985,"Bath City","Scarborough","0-0",0,0,5,5,0,0,"D"
NA,1985,"Boston United","Scarborough","2-1",2,1,5,5,3,1,"H"
NA,1985,"Cheltenham","Scarborough","5-1",5,1,5,5,6,4,"H"
NA,1985,"Dagenham","Scarborough","0-0",0,0,5,5,0,0,"D"
NA,1985,"Dartford","Scarborough","1-1",1,1,5,5,2,0,"D"
NA,1985,"Enfield","Scarborough","4-0",4,0,5,5,4,4,"H"
NA,1985,"Frickley Athletic","Scarborough","2-1",2,1,5,5,3,1,"H"
NA,1985,"Kettering Town","Scarborough","0-0",0,0,5,5,0,0,"D"
NA,1985,"Kidderminster Harriers","Scarborough","5-1",5,1,5,5,6,4,"H"
NA,1985,"Maidstone United","Scarborough","1-1",1,1,5,5,2,0,"D"
NA,1985,"Northwich Victoria","Scarborough","0-0",0,0,5,5,0,0,"D"
NA,1985,"Nuneaton Town","Scarborough","3-1",3,1,5,5,4,2,"H"
NA,1985,"Runcorn","Scarborough","0-0",0,0,5,5,0,0,"D"
NA,1985,"Stafford Rangers","Scarborough","0-3",0,3,5,5,3,-3,"A"
NA,1985,"Telford United","Scarborough","1-0",1,0,5,5,1,1,"H"
NA,1985,"Wealdstone","Scarborough","0-3",0,3,5,5,3,-3,"A"
NA,1985,"Weymouth","Scarborough","4-1",4,1,5,5,5,3,"H"
NA,1985,"Wycombe Wanderers","Scarborough","2-1",2,1,5,5,3,1,"H"
NA,1985,"Altrincham","Stafford Rangers","1-3",1,3,5,5,4,-2,"A"
NA,1985,"Barnet","Stafford Rangers","0-2",0,2,5,5,2,-2,"A"
NA,1985,"Barrow","Stafford Rangers","0-1",0,1,5,5,1,-1,"A"
NA,1985,"Bath City","Stafford Rangers","0-1",0,1,5,5,1,-1,"A"
NA,1985,"Boston United","Stafford Rangers","1-1",1,1,5,5,2,0,"D"
NA,1985,"Cheltenham","Stafford Rangers","2-0",2,0,5,5,2,2,"H"
NA,1985,"Dagenham","Stafford Rangers","1-1",1,1,5,5,2,0,"D"
NA,1985,"Dartford","Stafford Rangers","3-3",3,3,5,5,6,0,"D"
NA,1985,"Enfield","Stafford Rangers","3-1",3,1,5,5,4,2,"H"
NA,1985,"Frickley Athletic","Stafford Rangers","3-0",3,0,5,5,3,3,"H"
NA,1985,"Kettering Town","Stafford Rangers","0-1",0,1,5,5,1,-1,"A"
NA,1985,"Kidderminster Harriers","Stafford Rangers","1-1",1,1,5,5,2,0,"D"
NA,1985,"Maidstone United","Stafford Rangers","2-4",2,4,5,5,6,-2,"A"
NA,1985,"Northwich Victoria","Stafford Rangers","2-0",2,0,5,5,2,2,"H"
NA,1985,"Nuneaton Town","Stafford Rangers","3-0",3,0,5,5,3,3,"H"
NA,1985,"Runcorn","Stafford Rangers","3-0",3,0,5,5,3,3,"H"
NA,1985,"Scarborough","Stafford Rangers","2-4",2,4,5,5,6,-2,"A"
NA,1985,"Telford United","Stafford Rangers","0-0",0,0,5,5,0,0,"D"
NA,1985,"Wealdstone","Stafford Rangers","2-3",2,3,5,5,5,-1,"A"
NA,1985,"Weymouth","Stafford Rangers","1-1",1,1,5,5,2,0,"D"
NA,1985,"Wycombe Wanderers","Stafford Rangers","2-4",2,4,5,5,6,-2,"A"
NA,1985,"Altrincham","Telford United","1-0",1,0,5,5,1,1,"H"
NA,1985,"Barnet","Telford United","1-2",1,2,5,5,3,-1,"A"
NA,1985,"Barrow","Telford United","1-0",1,0,5,5,1,1,"H"
NA,1985,"Bath City","Telford United","3-0",3,0,5,5,3,3,"H"
NA,1985,"Boston United","Telford United","2-2",2,2,5,5,4,0,"D"
NA,1985,"Cheltenham","Telford United","1-1",1,1,5,5,2,0,"D"
NA,1985,"Dagenham","Telford United","1-4",1,4,5,5,5,-3,"A"
NA,1985,"Dartford","Telford United","2-1",2,1,5,5,3,1,"H"
NA,1985,"Enfield","Telford United","4-1",4,1,5,5,5,3,"H"
NA,1985,"Frickley Athletic","Telford United","3-1",3,1,5,5,4,2,"H"
NA,1985,"Kettering Town","Telford United","4-0",4,0,5,5,4,4,"H"
NA,1985,"Kidderminster Harriers","Telford United","3-0",3,0,5,5,3,3,"H"
NA,1985,"Maidstone United","Telford United","4-4",4,4,5,5,8,0,"D"
NA,1985,"Northwich Victoria","Telford United","0-1",0,1,5,5,1,-1,"A"
NA,1985,"Nuneaton Town","Telford United","1-1",1,1,5,5,2,0,"D"
NA,1985,"Runcorn","Telford United","1-0",1,0,5,5,1,1,"H"
NA,1985,"Scarborough","Telford United","3-1",3,1,5,5,4,2,"H"
NA,1985,"Stafford Rangers","Telford United","0-3",0,3,5,5,3,-3,"A"
NA,1985,"Wealdstone","Telford United","1-1",1,1,5,5,2,0,"D"
NA,1985,"Weymouth","Telford United","5-2",5,2,5,5,7,3,"H"
NA,1985,"Wycombe Wanderers","Telford United","1-2",1,2,5,5,3,-1,"A"
NA,1985,"Altrincham","Wealdstone","1-0",1,0,5,5,1,1,"H"
NA,1985,"Barnet","Wealdstone","1-0",1,0,5,5,1,1,"H"
NA,1985,"Barrow","Wealdstone","1-1",1,1,5,5,2,0,"D"
NA,1985,"Bath City","Wealdstone","2-3",2,3,5,5,5,-1,"A"
NA,1985,"Boston United","Wealdstone","1-0",1,0,5,5,1,1,"H"
NA,1985,"Cheltenham","Wealdstone","1-2",1,2,5,5,3,-1,"A"
NA,1985,"Dagenham","Wealdstone","0-2",0,2,5,5,2,-2,"A"
NA,1985,"Dartford","Wealdstone","1-2",1,2,5,5,3,-1,"A"
NA,1985,"Enfield","Wealdstone","1-0",1,0,5,5,1,1,"H"
NA,1985,"Frickley Athletic","Wealdstone","2-1",2,1,5,5,3,1,"H"
NA,1985,"Kettering Town","Wealdstone","2-1",2,1,5,5,3,1,"H"
NA,1985,"Kidderminster Harriers","Wealdstone","3-1",3,1,5,5,4,2,"H"
NA,1985,"Maidstone United","Wealdstone","0-1",0,1,5,5,1,-1,"A"
NA,1985,"Northwich Victoria","Wealdstone","2-2",2,2,5,5,4,0,"D"
NA,1985,"Nuneaton Town","Wealdstone","0-0",0,0,5,5,0,0,"D"
NA,1985,"Runcorn","Wealdstone","1-1",1,1,5,5,2,0,"D"
NA,1985,"Scarborough","Wealdstone","0-1",0,1,5,5,1,-1,"A"
NA,1985,"Stafford Rangers","Wealdstone","2-1",2,1,5,5,3,1,"H"
NA,1985,"Telford United","Wealdstone","2-1",2,1,5,5,3,1,"H"
NA,1985,"Weymouth","Wealdstone","4-2",4,2,5,5,6,2,"H"
NA,1985,"Wycombe Wanderers","Wealdstone","1-0",1,0,5,5,1,1,"H"
NA,1985,"Altrincham","Weymouth","3-1",3,1,5,5,4,2,"H"
NA,1985,"Barnet","Weymouth","2-2",2,2,5,5,4,0,"D"
NA,1985,"Barrow","Weymouth","3-4",3,4,5,5,7,-1,"A"
NA,1985,"Bath City","Weymouth","2-2",2,2,5,5,4,0,"D"
NA,1985,"Boston United","Weymouth","5-0",5,0,5,5,5,5,"H"
NA,1985,"Cheltenham","Weymouth","0-1",0,1,5,5,1,-1,"A"
NA,1985,"Dagenham","Weymouth","2-2",2,2,5,5,4,0,"D"
NA,1985,"Dartford","Weymouth","1-1",1,1,5,5,2,0,"D"
NA,1985,"Enfield","Weymouth","4-4",4,4,5,5,8,0,"D"
NA,1985,"Frickley Athletic","Weymouth","1-0",1,0,5,5,1,1,"H"
NA,1985,"Kettering Town","Weymouth","0-2",0,2,5,5,2,-2,"A"
NA,1985,"Kidderminster Harriers","Weymouth","1-2",1,2,5,5,3,-1,"A"
NA,1985,"Maidstone United","Weymouth","0-0",0,0,5,5,0,0,"D"
NA,1985,"Northwich Victoria","Weymouth","0-1",0,1,5,5,1,-1,"A"
NA,1985,"Nuneaton Town","Weymouth","3-0",3,0,5,5,3,3,"H"
NA,1985,"Runcorn","Weymouth","1-2",1,2,5,5,3,-1,"A"
NA,1985,"Scarborough","Weymouth","1-1",1,1,5,5,2,0,"D"
NA,1985,"Stafford Rangers","Weymouth","2-3",2,3,5,5,5,-1,"A"
NA,1985,"Telford United","Weymouth","4-1",4,1,5,5,5,3,"H"
NA,1985,"Wealdstone","Weymouth","1-0",1,0,5,5,1,1,"H"
NA,1985,"Wycombe Wanderers","Weymouth","0-3",0,3,5,5,3,-3,"A"
NA,1985,"Altrincham","Wycombe Wanderers","4-3",4,3,5,5,7,1,"H"
NA,1985,"Barnet","Wycombe Wanderers","0-1",0,1,5,5,1,-1,"A"
NA,1985,"Barrow","Wycombe Wanderers","1-1",1,1,5,5,2,0,"D"
NA,1985,"Bath City","Wycombe Wanderers","3-1",3,1,5,5,4,2,"H"
NA,1985,"Boston United","Wycombe Wanderers","1-1",1,1,5,5,2,0,"D"
NA,1985,"Cheltenham","Wycombe Wanderers","4-2",4,2,5,5,6,2,"H"
NA,1985,"Dagenham","Wycombe Wanderers","1-1",1,1,5,5,2,0,"D"
NA,1985,"Dartford","Wycombe Wanderers","1-0",1,0,5,5,1,1,"H"
NA,1985,"Enfield","Wycombe Wanderers","2-3",2,3,5,5,5,-1,"A"
NA,1985,"Frickley Athletic","Wycombe Wanderers","2-2",2,2,5,5,4,0,"D"
NA,1985,"Kettering Town","Wycombe Wanderers","4-1",4,1,5,5,5,3,"H"
NA,1985,"Kidderminster Harriers","Wycombe Wanderers","8-2",8,2,5,5,10,6,"H"
NA,1985,"Maidstone United","Wycombe Wanderers","1-1",1,1,5,5,2,0,"D"
NA,1985,"Northwich Victoria","Wycombe Wanderers","4-0",4,0,5,5,4,4,"H"
NA,1985,"Nuneaton Town","Wycombe Wanderers","3-0",3,0,5,5,3,3,"H"
NA,1985,"Runcorn","Wycombe Wanderers","2-1",2,1,5,5,3,1,"H"
NA,1985,"Scarborough","Wycombe Wanderers","1-2",1,2,5,5,3,-1,"A"
NA,1985,"Stafford Rangers","Wycombe Wanderers","1-1",1,1,5,5,2,0,"D"
NA,1985,"Telford United","Wycombe Wanderers","3-1",3,1,5,5,4,2,"H"
NA,1985,"Wealdstone","Wycombe Wanderers","2-0",2,0,5,5,2,2,"H"
NA,1985,"Weymouth","Wycombe Wanderers","1-1",1,1,5,5,2,0,"D"
NA,1986,"Barnet","Altrincham","1-0",1,0,5,5,1,1,"H"
NA,1986,"Bath City","Altrincham","1-1",1,1,5,5,2,0,"D"
NA,1986,"Boston United","Altrincham","4-2",4,2,5,5,6,2,"H"
NA,1986,"Cheltenham","Altrincham","1-1",1,1,5,5,2,0,"D"
NA,1986,"Dagenham","Altrincham","3-1",3,1,5,5,4,2,"H"
NA,1986,"Enfield","Altrincham","0-2",0,2,5,5,2,-2,"A"
NA,1986,"Frickley Athletic","Altrincham","2-2",2,2,5,5,4,0,"D"
NA,1986,"Gateshead","Altrincham","1-3",1,3,5,5,4,-2,"A"
NA,1986,"Kettering Town","Altrincham","0-2",0,2,5,5,2,-2,"A"
NA,1986,"Kidderminster Harriers","Altrincham","3-0",3,0,5,5,3,3,"H"
NA,1986,"Maidstone United","Altrincham","3-0",3,0,5,5,3,3,"H"
NA,1986,"Northwich Victoria","Altrincham","1-1",1,1,5,5,2,0,"D"
NA,1986,"Nuneaton Town","Altrincham","2-2",2,2,5,5,4,0,"D"
NA,1986,"Runcorn","Altrincham","1-1",1,1,5,5,2,0,"D"
NA,1986,"Scarborough","Altrincham","2-2",2,2,5,5,4,0,"D"
NA,1986,"Stafford Rangers","Altrincham","2-3",2,3,5,5,5,-1,"A"
NA,1986,"Sutton United","Altrincham","2-3",2,3,5,5,5,-1,"A"
NA,1986,"Telford United","Altrincham","4-0",4,0,5,5,4,4,"H"
NA,1986,"Wealdstone","Altrincham","0-2",0,2,5,5,2,-2,"A"
NA,1986,"Welling United","Altrincham","0-1",0,1,5,5,1,-1,"A"
NA,1986,"Weymouth","Altrincham","2-2",2,2,5,5,4,0,"D"
NA,1986,"Altrincham","Barnet","2-0",2,0,5,5,2,2,"H"
NA,1986,"Bath City","Barnet","0-1",0,1,5,5,1,-1,"A"
NA,1986,"Boston United","Barnet","0-3",0,3,5,5,3,-3,"A"
NA,1986,"Cheltenham","Barnet","1-2",1,2,5,5,3,-1,"A"
NA,1986,"Dagenham","Barnet","1-3",1,3,5,5,4,-2,"A"
NA,1986,"Enfield","Barnet","0-3",0,3,5,5,3,-3,"A"
NA,1986,"Frickley Athletic","Barnet","0-3",0,3,5,5,3,-3,"A"
NA,1986,"Gateshead","Barnet","1-5",1,5,5,5,6,-4,"A"
NA,1986,"Kettering Town","Barnet","1-1",1,1,5,5,2,0,"D"
NA,1986,"Kidderminster Harriers","Barnet","0-3",0,3,5,5,3,-3,"A"
NA,1986,"Maidstone United","Barnet","1-0",1,0,5,5,1,1,"H"
NA,1986,"Northwich Victoria","Barnet","1-2",1,2,5,5,3,-1,"A"
NA,1986,"Nuneaton Town","Barnet","1-3",1,3,5,5,4,-2,"A"
NA,1986,"Runcorn","Barnet","1-1",1,1,5,5,2,0,"D"
NA,1986,"Scarborough","Barnet","0-0",0,0,5,5,0,0,"D"
NA,1986,"Stafford Rangers","Barnet","0-3",0,3,5,5,3,-3,"A"
NA,1986,"Sutton United","Barnet","3-1",3,1,5,5,4,2,"H"
NA,1986,"Telford United","Barnet","0-1",0,1,5,5,1,-1,"A"
NA,1986,"Wealdstone","Barnet","0-0",0,0,5,5,0,0,"D"
NA,1986,"Welling United","Barnet","1-1",1,1,5,5,2,0,"D"
NA,1986,"Weymouth","Barnet","3-3",3,3,5,5,6,0,"D"
NA,1986,"Altrincham","Bath City","1-1",1,1,5,5,2,0,"D"
NA,1986,"Barnet","Bath City","2-1",2,1,5,5,3,1,"H"
NA,1986,"Boston United","Bath City","1-2",1,2,5,5,3,-1,"A"
NA,1986,"Cheltenham","Bath City","1-1",1,1,5,5,2,0,"D"
NA,1986,"Dagenham","Bath City","1-2",1,2,5,5,3,-1,"A"
NA,1986,"Enfield","Bath City","1-0",1,0,5,5,1,1,"H"
NA,1986,"Frickley Athletic","Bath City","2-2",2,2,5,5,4,0,"D"
NA,1986,"Gateshead","Bath City","1-2",1,2,5,5,3,-1,"A"
NA,1986,"Kettering Town","Bath City","2-0",2,0,5,5,2,2,"H"
NA,1986,"Kidderminster Harriers","Bath City","2-4",2,4,5,5,6,-2,"A"
NA,1986,"Maidstone United","Bath City","0-0",0,0,5,5,0,0,"D"
NA,1986,"Northwich Victoria","Bath City","1-1",1,1,5,5,2,0,"D"
NA,1986,"Nuneaton Town","Bath City","1-0",1,0,5,5,1,1,"H"
NA,1986,"Runcorn","Bath City","0-1",0,1,5,5,1,-1,"A"
NA,1986,"Scarborough","Bath City","1-1",1,1,5,5,2,0,"D"
NA,1986,"Stafford Rangers","Bath City","0-1",0,1,5,5,1,-1,"A"
NA,1986,"Sutton United","Bath City","7-2",7,2,5,5,9,5,"H"
NA,1986,"Telford United","Bath City","4-2",4,2,5,5,6,2,"H"
NA,1986,"Wealdstone","Bath City","1-2",1,2,5,5,3,-1,"A"
NA,1986,"Welling United","Bath City","1-1",1,1,5,5,2,0,"D"
NA,1986,"Weymouth","Bath City","1-2",1,2,5,5,3,-1,"A"
NA,1986,"Altrincham","Boston United","3-1",3,1,5,5,4,2,"H"
NA,1986,"Barnet","Boston United","5-1",5,1,5,5,6,4,"H"
NA,1986,"Bath City","Boston United","4-2",4,2,5,5,6,2,"H"
NA,1986,"Cheltenham","Boston United","1-3",1,3,5,5,4,-2,"A"
NA,1986,"Dagenham","Boston United","3-2",3,2,5,5,5,1,"H"
NA,1986,"Enfield","Boston United","2-3",2,3,5,5,5,-1,"A"
NA,1986,"Frickley Athletic","Boston United","0-1",0,1,5,5,1,-1,"A"
NA,1986,"Gateshead","Boston United","1-3",1,3,5,5,4,-2,"A"
NA,1986,"Kettering Town","Boston United","1-2",1,2,5,5,3,-1,"A"
NA,1986,"Kidderminster Harriers","Boston United","1-2",1,2,5,5,3,-1,"A"
NA,1986,"Maidstone United","Boston United","2-2",2,2,5,5,4,0,"D"
NA,1986,"Northwich Victoria","Boston United","4-0",4,0,5,5,4,4,"H"
NA,1986,"Nuneaton Town","Boston United","1-5",1,5,5,5,6,-4,"A"
NA,1986,"Runcorn","Boston United","3-1",3,1,5,5,4,2,"H"
NA,1986,"Scarborough","Boston United","0-0",0,0,5,5,0,0,"D"
NA,1986,"Stafford Rangers","Boston United","0-1",0,1,5,5,1,-1,"A"
NA,1986,"Sutton United","Boston United","3-1",3,1,5,5,4,2,"H"
NA,1986,"Telford United","Boston United","5-2",5,2,5,5,7,3,"H"
NA,1986,"Wealdstone","Boston United","0-4",0,4,5,5,4,-4,"A"
NA,1986,"Welling United","Boston United","4-2",4,2,5,5,6,2,"H"
NA,1986,"Weymouth","Boston United","3-4",3,4,5,5,7,-1,"A"
NA,1986,"Altrincham","Cheltenham","2-0",2,0,5,5,2,2,"H"
NA,1986,"Barnet","Cheltenham","0-1",0,1,5,5,1,-1,"A"
NA,1986,"Bath City","Cheltenham","0-0",0,0,5,5,0,0,"D"
NA,1986,"Boston United","Cheltenham","1-1",1,1,5,5,2,0,"D"
NA,1986,"Dagenham","Cheltenham","1-1",1,1,5,5,2,0,"D"
NA,1986,"Enfield","Cheltenham","2-2",2,2,5,5,4,0,"D"
NA,1986,"Frickley Athletic","Cheltenham","0-2",0,2,5,5,2,-2,"A"
NA,1986,"Gateshead","Cheltenham","1-1",1,1,5,5,2,0,"D"
NA,1986,"Kettering Town","Cheltenham","0-0",0,0,5,5,0,0,"D"
NA,1986,"Kidderminster Harriers","Cheltenham","5-1",5,1,5,5,6,4,"H"
NA,1986,"Maidstone United","Cheltenham","1-1",1,1,5,5,2,0,"D"
NA,1986,"Northwich Victoria","Cheltenham","1-0",1,0,5,5,1,1,"H"
NA,1986,"Nuneaton Town","Cheltenham","0-0",0,0,5,5,0,0,"D"
NA,1986,"Runcorn","Cheltenham","1-0",1,0,5,5,1,1,"H"
NA,1986,"Scarborough","Cheltenham","1-3",1,3,5,5,4,-2,"A"
NA,1986,"Stafford Rangers","Cheltenham","0-1",0,1,5,5,1,-1,"A"
NA,1986,"Sutton United","Cheltenham","0-0",0,0,5,5,0,0,"D"
NA,1986,"Telford United","Cheltenham","3-1",3,1,5,5,4,2,"H"
NA,1986,"Wealdstone","Cheltenham","1-0",1,0,5,5,1,1,"H"
NA,1986,"Welling United","Cheltenham","1-3",1,3,5,5,4,-2,"A"
NA,1986,"Weymouth","Cheltenham","4-3",4,3,5,5,7,1,"H"
NA,1986,"Altrincham","Dagenham","0-2",0,2,5,5,2,-2,"A"
NA,1986,"Barnet","Dagenham","1-0",1,0,5,5,1,1,"H"
NA,1986,"Bath City","Dagenham","2-0",2,0,5,5,2,2,"H"
NA,1986,"Boston United","Dagenham","1-0",1,0,5,5,1,1,"H"
NA,1986,"Cheltenham","Dagenham","6-1",6,1,5,5,7,5,"H"
NA,1986,"Enfield","Dagenham","1-0",1,0,5,5,1,1,"H"
NA,1986,"Frickley Athletic","Dagenham","1-3",1,3,5,5,4,-2,"A"
NA,1986,"Gateshead","Dagenham","3-2",3,2,5,5,5,1,"H"
NA,1986,"Kettering Town","Dagenham","3-1",3,1,5,5,4,2,"H"
NA,1986,"Kidderminster Harriers","Dagenham","4-2",4,2,5,5,6,2,"H"
NA,1986,"Maidstone United","Dagenham","2-1",2,1,5,5,3,1,"H"
NA,1986,"Northwich Victoria","Dagenham","2-3",2,3,5,5,5,-1,"A"
NA,1986,"Nuneaton Town","Dagenham","3-3",3,3,5,5,6,0,"D"
NA,1986,"Runcorn","Dagenham","4-0",4,0,5,5,4,4,"H"
NA,1986,"Scarborough","Dagenham","2-1",2,1,5,5,3,1,"H"
NA,1986,"Stafford Rangers","Dagenham","1-1",1,1,5,5,2,0,"D"
NA,1986,"Sutton United","Dagenham","1-0",1,0,5,5,1,1,"H"
NA,1986,"Telford United","Dagenham","0-2",0,2,5,5,2,-2,"A"
NA,1986,"Wealdstone","Dagenham","2-2",2,2,5,5,4,0,"D"
NA,1986,"Welling United","Dagenham","1-0",1,0,5,5,1,1,"H"
NA,1986,"Weymouth","Dagenham","3-0",3,0,5,5,3,3,"H"
NA,1986,"Altrincham","Enfield","0-1",0,1,5,5,1,-1,"A"
NA,1986,"Barnet","Enfield","1-0",1,0,5,5,1,1,"H"
NA,1986,"Bath City","Enfield","1-3",1,3,5,5,4,-2,"A"
NA,1986,"Boston United","Enfield","5-1",5,1,5,5,6,4,"H"
NA,1986,"Cheltenham","Enfield","2-0",2,0,5,5,2,2,"H"
NA,1986,"Dagenham","Enfield","0-3",0,3,5,5,3,-3,"A"
NA,1986,"Frickley Athletic","Enfield","1-4",1,4,5,5,5,-3,"A"
NA,1986,"Gateshead","Enfield","1-2",1,2,5,5,3,-1,"A"
NA,1986,"Kettering Town","Enfield","2-0",2,0,5,5,2,2,"H"
NA,1986,"Kidderminster Harriers","Enfield","3-4",3,4,5,5,7,-1,"A"
NA,1986,"Maidstone United","Enfield","0-2",0,2,5,5,2,-2,"A"
NA,1986,"Northwich Victoria","Enfield","2-0",2,0,5,5,2,2,"H"
NA,1986,"Nuneaton Town","Enfield","2-0",2,0,5,5,2,2,"H"
NA,1986,"Runcorn","Enfield","1-1",1,1,5,5,2,0,"D"
NA,1986,"Scarborough","Enfield","1-1",1,1,5,5,2,0,"D"
NA,1986,"Stafford Rangers","Enfield","0-3",0,3,5,5,3,-3,"A"
NA,1986,"Sutton United","Enfield","0-1",0,1,5,5,1,-1,"A"
NA,1986,"Telford United","Enfield","2-1",2,1,5,5,3,1,"H"
NA,1986,"Wealdstone","Enfield","0-3",0,3,5,5,3,-3,"A"
NA,1986,"Welling United","Enfield","2-3",2,3,5,5,5,-1,"A"
NA,1986,"Weymouth","Enfield","0-1",0,1,5,5,1,-1,"A"
NA,1986,"Altrincham","Frickley Athletic","1-1",1,1,5,5,2,0,"D"
NA,1986,"Barnet","Frickley Athletic","3-0",3,0,5,5,3,3,"H"
NA,1986,"Bath City","Frickley Athletic","4-2",4,2,5,5,6,2,"H"
NA,1986,"Boston United","Frickley Athletic","2-2",2,2,5,5,4,0,"D"
NA,1986,"Cheltenham","Frickley Athletic","2-0",2,0,5,5,2,2,"H"
NA,1986,"Dagenham","Frickley Athletic","0-1",0,1,5,5,1,-1,"A"
NA,1986,"Enfield","Frickley Athletic","0-0",0,0,5,5,0,0,"D"
NA,1986,"Gateshead","Frickley Athletic","2-0",2,0,5,5,2,2,"H"
NA,1986,"Kettering Town","Frickley Athletic","1-2",1,2,5,5,3,-1,"A"
NA,1986,"Kidderminster Harriers","Frickley Athletic","4-1",4,1,5,5,5,3,"H"
NA,1986,"Maidstone United","Frickley Athletic","1-0",1,0,5,5,1,1,"H"
NA,1986,"Northwich Victoria","Frickley Athletic","1-1",1,1,5,5,2,0,"D"
NA,1986,"Nuneaton Town","Frickley Athletic","2-1",2,1,5,5,3,1,"H"
NA,1986,"Runcorn","Frickley Athletic","1-0",1,0,5,5,1,1,"H"
NA,1986,"Scarborough","Frickley Athletic","4-2",4,2,5,5,6,2,"H"
NA,1986,"Stafford Rangers","Frickley Athletic","2-0",2,0,5,5,2,2,"H"
NA,1986,"Sutton United","Frickley Athletic","3-0",3,0,5,5,3,3,"H"
NA,1986,"Telford United","Frickley Athletic","4-1",4,1,5,5,5,3,"H"
NA,1986,"Wealdstone","Frickley Athletic","2-1",2,1,5,5,3,1,"H"
NA,1986,"Welling United","Frickley Athletic","3-2",3,2,5,5,5,1,"H"
NA,1986,"Weymouth","Frickley Athletic","3-2",3,2,5,5,5,1,"H"
NA,1986,"Altrincham","Gateshead","1-1",1,1,5,5,2,0,"D"
NA,1986,"Barnet","Gateshead","3-1",3,1,5,5,4,2,"H"
NA,1986,"Bath City","Gateshead","1-1",1,1,5,5,2,0,"D"
NA,1986,"Boston United","Gateshead","6-0",6,0,5,5,6,6,"H"
NA,1986,"Cheltenham","Gateshead","4-2",4,2,5,5,6,2,"H"
NA,1986,"Dagenham","Gateshead","0-0",0,0,5,5,0,0,"D"
NA,1986,"Enfield","Gateshead","1-1",1,1,5,5,2,0,"D"
NA,1986,"Frickley Athletic","Gateshead","3-1",3,1,5,5,4,2,"H"
NA,1986,"Kettering Town","Gateshead","5-1",5,1,5,5,6,4,"H"
NA,1986,"Kidderminster Harriers","Gateshead","3-1",3,1,5,5,4,2,"H"
NA,1986,"Maidstone United","Gateshead","3-0",3,0,5,5,3,3,"H"
NA,1986,"Northwich Victoria","Gateshead","1-2",1,2,5,5,3,-1,"A"
NA,1986,"Nuneaton Town","Gateshead","1-1",1,1,5,5,2,0,"D"
NA,1986,"Runcorn","Gateshead","4-0",4,0,5,5,4,4,"H"
NA,1986,"Scarborough","Gateshead","3-2",3,2,5,5,5,1,"H"
NA,1986,"Stafford Rangers","Gateshead","1-0",1,0,5,5,1,1,"H"
NA,1986,"Sutton United","Gateshead","3-0",3,0,5,5,3,3,"H"
NA,1986,"Telford United","Gateshead","2-1",2,1,5,5,3,1,"H"
NA,1986,"Wealdstone","Gateshead","2-2",2,2,5,5,4,0,"D"
NA,1986,"Welling United","Gateshead","3-4",3,4,5,5,7,-1,"A"
NA,1986,"Weymouth","Gateshead","0-1",0,1,5,5,1,-1,"A"
NA,1986,"Altrincham","Kettering Town","4-1",4,1,5,5,5,3,"H"
NA,1986,"Barnet","Kettering Town","1-2",1,2,5,5,3,-1,"A"
NA,1986,"Bath City","Kettering Town","1-2",1,2,5,5,3,-1,"A"
NA,1986,"Boston United","Kettering Town","2-1",2,1,5,5,3,1,"H"
NA,1986,"Cheltenham","Kettering Town","3-1",3,1,5,5,4,2,"H"
NA,1986,"Dagenham","Kettering Town","1-2",1,2,5,5,3,-1,"A"
NA,1986,"Enfield","Kettering Town","0-0",0,0,5,5,0,0,"D"
NA,1986,"Frickley Athletic","Kettering Town","0-1",0,1,5,5,1,-1,"A"
NA,1986,"Gateshead","Kettering Town","1-1",1,1,5,5,2,0,"D"
NA,1986,"Kidderminster Harriers","Kettering Town","2-1",2,1,5,5,3,1,"H"
NA,1986,"Maidstone United","Kettering Town","3-0",3,0,5,5,3,3,"H"
NA,1986,"Northwich Victoria","Kettering Town","0-0",0,0,5,5,0,0,"D"
NA,1986,"Nuneaton Town","Kettering Town","0-0",0,0,5,5,0,0,"D"
NA,1986,"Runcorn","Kettering Town","1-0",1,0,5,5,1,1,"H"
NA,1986,"Scarborough","Kettering Town","1-0",1,0,5,5,1,1,"H"
NA,1986,"Stafford Rangers","Kettering Town","2-2",2,2,5,5,4,0,"D"
NA,1986,"Sutton United","Kettering Town","8-0",8,0,5,5,8,8,"H"
NA,1986,"Telford United","Kettering Town","2-0",2,0,5,5,2,2,"H"
NA,1986,"Wealdstone","Kettering Town","2-1",2,1,5,5,3,1,"H"
NA,1986,"Welling United","Kettering Town","0-3",0,3,5,5,3,-3,"A"
NA,1986,"Weymouth","Kettering Town","2-0",2,0,5,5,2,2,"H"
NA,1986,"Altrincham","Kidderminster Harriers","3-1",3,1,5,5,4,2,"H"
NA,1986,"Barnet","Kidderminster Harriers","5-2",5,2,5,5,7,3,"H"
NA,1986,"Bath City","Kidderminster Harriers","3-2",3,2,5,5,5,1,"H"
NA,1986,"Boston United","Kidderminster Harriers","2-1",2,1,5,5,3,1,"H"
NA,1986,"Cheltenham","Kidderminster Harriers","1-2",1,2,5,5,3,-1,"A"
NA,1986,"Dagenham","Kidderminster Harriers","3-1",3,1,5,5,4,2,"H"
NA,1986,"Enfield","Kidderminster Harriers","3-0",3,0,5,5,3,3,"H"
NA,1986,"Frickley Athletic","Kidderminster Harriers","2-2",2,2,5,5,4,0,"D"
NA,1986,"Gateshead","Kidderminster Harriers","2-4",2,4,5,5,6,-2,"A"
NA,1986,"Kettering Town","Kidderminster Harriers","0-2",0,2,5,5,2,-2,"A"
NA,1986,"Maidstone United","Kidderminster Harriers","5-0",5,0,5,5,5,5,"H"
NA,1986,"Northwich Victoria","Kidderminster Harriers","1-2",1,2,5,5,3,-1,"A"
NA,1986,"Nuneaton Town","Kidderminster Harriers","1-2",1,2,5,5,3,-1,"A"
NA,1986,"Runcorn","Kidderminster Harriers","4-3",4,3,5,5,7,1,"H"
NA,1986,"Scarborough","Kidderminster Harriers","2-1",2,1,5,5,3,1,"H"
NA,1986,"Stafford Rangers","Kidderminster Harriers","4-1",4,1,5,5,5,3,"H"
NA,1986,"Sutton United","Kidderminster Harriers","3-1",3,1,5,5,4,2,"H"
NA,1986,"Telford United","Kidderminster Harriers","2-1",2,1,5,5,3,1,"H"
NA,1986,"Wealdstone","Kidderminster Harriers","0-3",0,3,5,5,3,-3,"A"
NA,1986,"Welling United","Kidderminster Harriers","1-0",1,0,5,5,1,1,"H"
NA,1986,"Weymouth","Kidderminster Harriers","2-1",2,1,5,5,3,1,"H"
NA,1986,"Altrincham","Maidstone United","4-0",4,0,5,5,4,4,"H"
NA,1986,"Barnet","Maidstone United","3-1",3,1,5,5,4,2,"H"
NA,1986,"Bath City","Maidstone United","1-0",1,0,5,5,1,1,"H"
NA,1986,"Boston United","Maidstone United","0-3",0,3,5,5,3,-3,"A"
NA,1986,"Cheltenham","Maidstone United","2-0",2,0,5,5,2,2,"H"
NA,1986,"Dagenham","Maidstone United","0-2",0,2,5,5,2,-2,"A"
NA,1986,"Enfield","Maidstone United","0-1",0,1,5,5,1,-1,"A"
NA,1986,"Frickley Athletic","Maidstone United","0-2",0,2,5,5,2,-2,"A"
NA,1986,"Gateshead","Maidstone United","1-4",1,4,5,5,5,-3,"A"
NA,1986,"Kettering Town","Maidstone United","1-2",1,2,5,5,3,-1,"A"
NA,1986,"Kidderminster Harriers","Maidstone United","2-2",2,2,5,5,4,0,"D"
NA,1986,"Northwich Victoria","Maidstone United","1-1",1,1,5,5,2,0,"D"
NA,1986,"Nuneaton Town","Maidstone United","2-0",2,0,5,5,2,2,"H"
NA,1986,"Runcorn","Maidstone United","3-2",3,2,5,5,5,1,"H"
NA,1986,"Scarborough","Maidstone United","0-0",0,0,5,5,0,0,"D"
NA,1986,"Stafford Rangers","Maidstone United","2-3",2,3,5,5,5,-1,"A"
NA,1986,"Sutton United","Maidstone United","3-1",3,1,5,5,4,2,"H"
NA,1986,"Telford United","Maidstone United","1-1",1,1,5,5,2,0,"D"
NA,1986,"Wealdstone","Maidstone United","0-0",0,0,5,5,0,0,"D"
NA,1986,"Welling United","Maidstone United","2-2",2,2,5,5,4,0,"D"
NA,1986,"Weymouth","Maidstone United","4-1",4,1,5,5,5,3,"H"
NA,1986,"Altrincham","Northwich Victoria","1-1",1,1,5,5,2,0,"D"
NA,1986,"Barnet","Northwich Victoria","4-0",4,0,5,5,4,4,"H"
NA,1986,"Bath City","Northwich Victoria","1-1",1,1,5,5,2,0,"D"
NA,1986,"Boston United","Northwich Victoria","0-1",0,1,5,5,1,-1,"A"
NA,1986,"Cheltenham","Northwich Victoria","5-2",5,2,5,5,7,3,"H"
NA,1986,"Dagenham","Northwich Victoria","3-3",3,3,5,5,6,0,"D"
NA,1986,"Enfield","Northwich Victoria","1-2",1,2,5,5,3,-1,"A"
NA,1986,"Frickley Athletic","Northwich Victoria","1-1",1,1,5,5,2,0,"D"
NA,1986,"Gateshead","Northwich Victoria","1-1",1,1,5,5,2,0,"D"
NA,1986,"Kettering Town","Northwich Victoria","1-0",1,0,5,5,1,1,"H"
NA,1986,"Kidderminster Harriers","Northwich Victoria","1-2",1,2,5,5,3,-1,"A"
NA,1986,"Maidstone United","Northwich Victoria","5-2",5,2,5,5,7,3,"H"
NA,1986,"Nuneaton Town","Northwich Victoria","0-1",0,1,5,5,1,-1,"A"
NA,1986,"Runcorn","Northwich Victoria","7-3",7,3,5,5,10,4,"H"
NA,1986,"Scarborough","Northwich Victoria","2-1",2,1,5,5,3,1,"H"
NA,1986,"Stafford Rangers","Northwich Victoria","4-1",4,1,5,5,5,3,"H"
NA,1986,"Sutton United","Northwich Victoria","2-1",2,1,5,5,3,1,"H"
NA,1986,"Telford United","Northwich Victoria","1-0",1,0,5,5,1,1,"H"
NA,1986,"Wealdstone","Northwich Victoria","1-1",1,1,5,5,2,0,"D"
NA,1986,"Welling United","Northwich Victoria","3-2",3,2,5,5,5,1,"H"
NA,1986,"Weymouth","Northwich Victoria","2-2",2,2,5,5,4,0,"D"
NA,1986,"Altrincham","Nuneaton Town","2-2",2,2,5,5,4,0,"D"
NA,1986,"Barnet","Nuneaton Town","4-1",4,1,5,5,5,3,"H"
NA,1986,"Bath City","Nuneaton Town","2-3",2,3,5,5,5,-1,"A"
NA,1986,"Boston United","Nuneaton Town","2-1",2,1,5,5,3,1,"H"
NA,1986,"Cheltenham","Nuneaton Town","1-1",1,1,5,5,2,0,"D"
NA,1986,"Dagenham","Nuneaton Town","3-1",3,1,5,5,4,2,"H"
NA,1986,"Enfield","Nuneaton Town","3-1",3,1,5,5,4,2,"H"
NA,1986,"Frickley Athletic","Nuneaton Town","1-1",1,1,5,5,2,0,"D"
NA,1986,"Gateshead","Nuneaton Town","3-2",3,2,5,5,5,1,"H"
NA,1986,"Kettering Town","Nuneaton Town","2-2",2,2,5,5,4,0,"D"
NA,1986,"Kidderminster Harriers","Nuneaton Town","3-0",3,0,5,5,3,3,"H"
NA,1986,"Maidstone United","Nuneaton Town","2-0",2,0,5,5,2,2,"H"
NA,1986,"Northwich Victoria","Nuneaton Town","1-2",1,2,5,5,3,-1,"A"
NA,1986,"Runcorn","Nuneaton Town","1-1",1,1,5,5,2,0,"D"
NA,1986,"Scarborough","Nuneaton Town","1-0",1,0,5,5,1,1,"H"
NA,1986,"Stafford Rangers","Nuneaton Town","3-1",3,1,5,5,4,2,"H"
NA,1986,"Sutton United","Nuneaton Town","2-3",2,3,5,5,5,-1,"A"
NA,1986,"Telford United","Nuneaton Town","1-1",1,1,5,5,2,0,"D"
NA,1986,"Wealdstone","Nuneaton Town","6-0",6,0,5,5,6,6,"H"
NA,1986,"Welling United","Nuneaton Town","1-2",1,2,5,5,3,-1,"A"
NA,1986,"Weymouth","Nuneaton Town","1-0",1,0,5,5,1,1,"H"
NA,1986,"Altrincham","Runcorn","0-0",0,0,5,5,0,0,"D"
NA,1986,"Barnet","Runcorn","3-0",3,0,5,5,3,3,"H"
NA,1986,"Bath City","Runcorn","1-2",1,2,5,5,3,-1,"A"
NA,1986,"Boston United","Runcorn","2-0",2,0,5,5,2,2,"H"
NA,1986,"Cheltenham","Runcorn","1-1",1,1,5,5,2,0,"D"
NA,1986,"Dagenham","Runcorn","3-2",3,2,5,5,5,1,"H"
NA,1986,"Enfield","Runcorn","5-0",5,0,5,5,5,5,"H"
NA,1986,"Frickley Athletic","Runcorn","0-2",0,2,5,5,2,-2,"A"
NA,1986,"Gateshead","Runcorn","1-3",1,3,5,5,4,-2,"A"
NA,1986,"Kettering Town","Runcorn","1-1",1,1,5,5,2,0,"D"
NA,1986,"Kidderminster Harriers","Runcorn","3-2",3,2,5,5,5,1,"H"
NA,1986,"Maidstone United","Runcorn","3-2",3,2,5,5,5,1,"H"
NA,1986,"Northwich Victoria","Runcorn","1-2",1,2,5,5,3,-1,"A"
NA,1986,"Nuneaton Town","Runcorn","1-0",1,0,5,5,1,1,"H"
NA,1986,"Scarborough","Runcorn","1-2",1,2,5,5,3,-1,"A"
NA,1986,"Stafford Rangers","Runcorn","2-0",2,0,5,5,2,2,"H"
NA,1986,"Sutton United","Runcorn","1-1",1,1,5,5,2,0,"D"
NA,1986,"Telford United","Runcorn","2-2",2,2,5,5,4,0,"D"
NA,1986,"Wealdstone","Runcorn","0-3",0,3,5,5,3,-3,"A"
NA,1986,"Welling United","Runcorn","3-0",3,0,5,5,3,3,"H"
NA,1986,"Weymouth","Runcorn","1-1",1,1,5,5,2,0,"D"
NA,1986,"Altrincham","Scarborough","1-0",1,0,5,5,1,1,"H"
NA,1986,"Barnet","Scarborough","2-2",2,2,5,5,4,0,"D"
NA,1986,"Bath City","Scarborough","0-3",0,3,5,5,3,-3,"A"
NA,1986,"Boston United","Scarborough","1-3",1,3,5,5,4,-2,"A"
NA,1986,"Cheltenham","Scarborough","2-3",2,3,5,5,5,-1,"A"
NA,1986,"Dagenham","Scarborough","0-2",0,2,5,5,2,-2,"A"
NA,1986,"Enfield","Scarborough","0-1",0,1,5,5,1,-1,"A"
NA,1986,"Frickley Athletic","Scarborough","0-2",0,2,5,5,2,-2,"A"
NA,1986,"Gateshead","Scarborough","0-1",0,1,5,5,1,-1,"A"
NA,1986,"Kettering Town","Scarborough","1-2",1,2,5,5,3,-1,"A"
NA,1986,"Kidderminster Harriers","Scarborough","0-1",0,1,5,5,1,-1,"A"
NA,1986,"Maidstone United","Scarborough","2-1",2,1,5,5,3,1,"H"
NA,1986,"Northwich Victoria","Scarborough","0-1",0,1,5,5,1,-1,"A"
NA,1986,"Nuneaton Town","Scarborough","3-0",3,0,5,5,3,3,"H"
NA,1986,"Runcorn","Scarborough","0-2",0,2,5,5,2,-2,"A"
NA,1986,"Stafford Rangers","Scarborough","0-0",0,0,5,5,0,0,"D"
NA,1986,"Sutton United","Scarborough","0-2",0,2,5,5,2,-2,"A"
NA,1986,"Telford United","Scarborough","0-0",0,0,5,5,0,0,"D"
NA,1986,"Wealdstone","Scarborough","1-3",1,3,5,5,4,-2,"A"
NA,1986,"Welling United","Scarborough","1-3",1,3,5,5,4,-2,"A"
NA,1986,"Weymouth","Scarborough","0-1",0,1,5,5,1,-1,"A"
NA,1986,"Altrincham","Stafford Rangers","2-0",2,0,5,5,2,2,"H"
NA,1986,"Barnet","Stafford Rangers","1-2",1,2,5,5,3,-1,"A"
NA,1986,"Bath City","Stafford Rangers","4-2",4,2,5,5,6,2,"H"
NA,1986,"Boston United","Stafford Rangers","2-0",2,0,5,5,2,2,"H"
NA,1986,"Cheltenham","Stafford Rangers","2-1",2,1,5,5,3,1,"H"
NA,1986,"Dagenham","Stafford Rangers","1-0",1,0,5,5,1,1,"H"
NA,1986,"Enfield","Stafford Rangers","2-0",2,0,5,5,2,2,"H"
NA,1986,"Frickley Athletic","Stafford Rangers","2-1",2,1,5,5,3,1,"H"
NA,1986,"Gateshead","Stafford Rangers","2-2",2,2,5,5,4,0,"D"
NA,1986,"Kettering Town","Stafford Rangers","2-2",2,2,5,5,4,0,"D"
NA,1986,"Kidderminster Harriers","Stafford Rangers","1-1",1,1,5,5,2,0,"D"
NA,1986,"Maidstone United","Stafford Rangers","2-3",2,3,5,5,5,-1,"A"
NA,1986,"Northwich Victoria","Stafford Rangers","1-1",1,1,5,5,2,0,"D"
NA,1986,"Nuneaton Town","Stafford Rangers","0-0",0,0,5,5,0,0,"D"
NA,1986,"Runcorn","Stafford Rangers","3-1",3,1,5,5,4,2,"H"
NA,1986,"Scarborough","Stafford Rangers","2-0",2,0,5,5,2,2,"H"
NA,1986,"Sutton United","Stafford Rangers","3-0",3,0,5,5,3,3,"H"
NA,1986,"Telford United","Stafford Rangers","0-0",0,0,5,5,0,0,"D"
NA,1986,"Wealdstone","Stafford Rangers","0-3",0,3,5,5,3,-3,"A"
NA,1986,"Welling United","Stafford Rangers","2-4",2,4,5,5,6,-2,"A"
NA,1986,"Weymouth","Stafford Rangers","1-3",1,3,5,5,4,-2,"A"
NA,1986,"Altrincham","Sutton United","2-1",2,1,5,5,3,1,"H"
NA,1986,"Barnet","Sutton United","1-2",1,2,5,5,3,-1,"A"
NA,1986,"Bath City","Sutton United","1-3",1,3,5,5,4,-2,"A"
NA,1986,"Boston United","Sutton United","0-0",0,0,5,5,0,0,"D"
NA,1986,"Cheltenham","Sutton United","1-2",1,2,5,5,3,-1,"A"
NA,1986,"Dagenham","Sutton United","2-1",2,1,5,5,3,1,"H"
NA,1986,"Enfield","Sutton United","0-0",0,0,5,5,0,0,"D"
NA,1986,"Frickley Athletic","Sutton United","1-1",1,1,5,5,2,0,"D"
NA,1986,"Gateshead","Sutton United","1-1",1,1,5,5,2,0,"D"
NA,1986,"Kettering Town","Sutton United","1-4",1,4,5,5,5,-3,"A"
NA,1986,"Kidderminster Harriers","Sutton United","0-0",0,0,5,5,0,0,"D"
NA,1986,"Maidstone United","Sutton United","0-1",0,1,5,5,1,-1,"A"
NA,1986,"Northwich Victoria","Sutton United","0-1",0,1,5,5,1,-1,"A"
NA,1986,"Nuneaton Town","Sutton United","1-1",1,1,5,5,2,0,"D"
NA,1986,"Runcorn","Sutton United","3-2",3,2,5,5,5,1,"H"
NA,1986,"Scarborough","Sutton United","2-1",2,1,5,5,3,1,"H"
NA,1986,"Stafford Rangers","Sutton United","4-2",4,2,5,5,6,2,"H"
NA,1986,"Telford United","Sutton United","0-2",0,2,5,5,2,-2,"A"
NA,1986,"Wealdstone","Sutton United","2-1",2,1,5,5,3,1,"H"
NA,1986,"Welling United","Sutton United","3-1",3,1,5,5,4,2,"H"
NA,1986,"Weymouth","Sutton United","2-2",2,2,5,5,4,0,"D"
NA,1986,"Altrincham","Telford United","2-1",2,1,5,5,3,1,"H"
NA,1986,"Barnet","Telford United","2-2",2,2,5,5,4,0,"D"
NA,1986,"Bath City","Telford United","3-1",3,1,5,5,4,2,"H"
NA,1986,"Boston United","Telford United","2-3",2,3,5,5,5,-1,"A"
NA,1986,"Cheltenham","Telford United","3-1",3,1,5,5,4,2,"H"
NA,1986,"Dagenham","Telford United","3-1",3,1,5,5,4,2,"H"
NA,1986,"Enfield","Telford United","3-1",3,1,5,5,4,2,"H"
NA,1986,"Frickley Athletic","Telford United","4-2",4,2,5,5,6,2,"H"
NA,1986,"Gateshead","Telford United","0-2",0,2,5,5,2,-2,"A"
NA,1986,"Kettering Town","Telford United","3-1",3,1,5,5,4,2,"H"
NA,1986,"Kidderminster Harriers","Telford United","0-4",0,4,5,5,4,-4,"A"
NA,1986,"Maidstone United","Telford United","0-0",0,0,5,5,0,0,"D"
NA,1986,"Northwich Victoria","Telford United","1-0",1,0,5,5,1,1,"H"
NA,1986,"Nuneaton Town","Telford United","0-2",0,2,5,5,2,-2,"A"
NA,1986,"Runcorn","Telford United","3-0",3,0,5,5,3,3,"H"
NA,1986,"Scarborough","Telford United","0-0",0,0,5,5,0,0,"D"
NA,1986,"Stafford Rangers","Telford United","1-1",1,1,5,5,2,0,"D"
NA,1986,"Sutton United","Telford United","2-2",2,2,5,5,4,0,"D"
NA,1986,"Wealdstone","Telford United","0-1",0,1,5,5,1,-1,"A"
NA,1986,"Welling United","Telford United","1-3",1,3,5,5,4,-2,"A"
NA,1986,"Weymouth","Telford United","3-0",3,0,5,5,3,3,"H"
NA,1986,"Altrincham","Wealdstone","1-2",1,2,5,5,3,-1,"A"
NA,1986,"Barnet","Wealdstone","2-1",2,1,5,5,3,1,"H"
NA,1986,"Bath City","Wealdstone","2-0",2,0,5,5,2,2,"H"
NA,1986,"Boston United","Wealdstone","2-0",2,0,5,5,2,2,"H"
NA,1986,"Cheltenham","Wealdstone","0-1",0,1,5,5,1,-1,"A"
NA,1986,"Dagenham","Wealdstone","1-0",1,0,5,5,1,1,"H"
NA,1986,"Enfield","Wealdstone","4-2",4,2,5,5,6,2,"H"
NA,1986,"Frickley Athletic","Wealdstone","3-1",3,1,5,5,4,2,"H"
NA,1986,"Gateshead","Wealdstone","1-1",1,1,5,5,2,0,"D"
NA,1986,"Kettering Town","Wealdstone","0-2",0,2,5,5,2,-2,"A"
NA,1986,"Kidderminster Harriers","Wealdstone","5-2",5,2,5,5,7,3,"H"
NA,1986,"Maidstone United","Wealdstone","1-0",1,0,5,5,1,1,"H"
NA,1986,"Northwich Victoria","Wealdstone","2-1",2,1,5,5,3,1,"H"
NA,1986,"Nuneaton Town","Wealdstone","1-1",1,1,5,5,2,0,"D"
NA,1986,"Runcorn","Wealdstone","1-1",1,1,5,5,2,0,"D"
NA,1986,"Scarborough","Wealdstone","2-1",2,1,5,5,3,1,"H"
NA,1986,"Stafford Rangers","Wealdstone","1-0",1,0,5,5,1,1,"H"
NA,1986,"Sutton United","Wealdstone","2-2",2,2,5,5,4,0,"D"
NA,1986,"Telford United","Wealdstone","1-3",1,3,5,5,4,-2,"A"
NA,1986,"Welling United","Wealdstone","1-1",1,1,5,5,2,0,"D"
NA,1986,"Weymouth","Wealdstone","3-2",3,2,5,5,5,1,"H"
NA,1986,"Altrincham","Welling United","1-1",1,1,5,5,2,0,"D"
NA,1986,"Barnet","Welling United","1-1",1,1,5,5,2,0,"D"
NA,1986,"Bath City","Welling United","1-1",1,1,5,5,2,0,"D"
NA,1986,"Boston United","Welling United","4-3",4,3,5,5,7,1,"H"
NA,1986,"Cheltenham","Welling United","2-0",2,0,5,5,2,2,"H"
NA,1986,"Dagenham","Welling United","1-1",1,1,5,5,2,0,"D"
NA,1986,"Enfield","Welling United","0-2",0,2,5,5,2,-2,"A"
NA,1986,"Frickley Athletic","Welling United","3-1",3,1,5,5,4,2,"H"
NA,1986,"Gateshead","Welling United","1-1",1,1,5,5,2,0,"D"
NA,1986,"Kettering Town","Welling United","5-1",5,1,5,5,6,4,"H"
NA,1986,"Kidderminster Harriers","Welling United","2-0",2,0,5,5,2,2,"H"
NA,1986,"Maidstone United","Welling United","4-0",4,0,5,5,4,4,"H"
NA,1986,"Northwich Victoria","Welling United","2-1",2,1,5,5,3,1,"H"
NA,1986,"Nuneaton Town","Welling United","1-2",1,2,5,5,3,-1,"A"
NA,1986,"Runcorn","Welling United","2-2",2,2,5,5,4,0,"D"
NA,1986,"Scarborough","Welling United","2-0",2,0,5,5,2,2,"H"
NA,1986,"Stafford Rangers","Welling United","3-1",3,1,5,5,4,2,"H"
NA,1986,"Sutton United","Welling United","2-0",2,0,5,5,2,2,"H"
NA,1986,"Telford United","Welling United","2-1",2,1,5,5,3,1,"H"
NA,1986,"Wealdstone","Welling United","3-1",3,1,5,5,4,2,"H"
NA,1986,"Weymouth","Welling United","3-2",3,2,5,5,5,1,"H"
NA,1986,"Altrincham","Weymouth","2-1",2,1,5,5,3,1,"H"
NA,1986,"Barnet","Weymouth","2-2",2,2,5,5,4,0,"D"
NA,1986,"Bath City","Weymouth","2-1",2,1,5,5,3,1,"H"
NA,1986,"Boston United","Weymouth","1-1",1,1,5,5,2,0,"D"
NA,1986,"Cheltenham","Weymouth","2-0",2,0,5,5,2,2,"H"
NA,1986,"Dagenham","Weymouth","2-0",2,0,5,5,2,2,"H"
NA,1986,"Enfield","Weymouth","4-0",4,0,5,5,4,4,"H"
NA,1986,"Frickley Athletic","Weymouth","2-2",2,2,5,5,4,0,"D"
NA,1986,"Gateshead","Weymouth","1-4",1,4,5,5,5,-3,"A"
NA,1986,"Kettering Town","Weymouth","3-0",3,0,5,5,3,3,"H"
NA,1986,"Kidderminster Harriers","Weymouth","1-1",1,1,5,5,2,0,"D"
NA,1986,"Maidstone United","Weymouth","3-1",3,1,5,5,4,2,"H"
NA,1986,"Northwich Victoria","Weymouth","1-1",1,1,5,5,2,0,"D"
NA,1986,"Nuneaton Town","Weymouth","0-4",0,4,5,5,4,-4,"A"
NA,1986,"Runcorn","Weymouth","1-1",1,1,5,5,2,0,"D"
NA,1986,"Scarborough","Weymouth","2-1",2,1,5,5,3,1,"H"
NA,1986,"Stafford Rangers","Weymouth","0-0",0,0,5,5,0,0,"D"
NA,1986,"Sutton United","Weymouth","2-3",2,3,5,5,5,-1,"A"
NA,1986,"Telford United","Weymouth","5-1",5,1,5,5,6,4,"H"
NA,1986,"Wealdstone","Weymouth","3-1",3,1,5,5,4,2,"H"
NA,1986,"Welling United","Weymouth","5-0",5,0,5,5,5,5,"H"
NA,1987,"Barnet","Altrincham","3-1",3,1,5,5,4,2,"H"
NA,1987,"Bath City","Altrincham","2-0",2,0,5,5,2,2,"H"
NA,1987,"Boston United","Altrincham","2-2",2,2,5,5,4,0,"D"
NA,1987,"Cheltenham","Altrincham","1-0",1,0,5,5,1,1,"H"
NA,1987,"Dagenham","Altrincham","3-2",3,2,5,5,5,1,"H"
NA,1987,"Enfield","Altrincham","1-1",1,1,5,5,2,0,"D"
NA,1987,"Fisher Athletic","Altrincham","3-2",3,2,5,5,5,1,"H"
NA,1987,"Kettering Town","Altrincham","1-2",1,2,5,5,3,-1,"A"
NA,1987,"Kidderminster Harriers","Altrincham","4-1",4,1,5,5,5,3,"H"
NA,1987,"Lincoln City","Altrincham","5-0",5,0,5,5,5,5,"H"
NA,1987,"Macclesfield","Altrincham","1-0",1,0,5,5,1,1,"H"
NA,1987,"Maidstone United","Altrincham","2-2",2,2,5,5,4,0,"D"
NA,1987,"Northwich Victoria","Altrincham","1-2",1,2,5,5,3,-1,"A"
NA,1987,"Runcorn","Altrincham","1-1",1,1,5,5,2,0,"D"
NA,1987,"Stafford Rangers","Altrincham","3-0",3,0,5,5,3,3,"H"
NA,1987,"Sutton United","Altrincham","2-1",2,1,5,5,3,1,"H"
NA,1987,"Telford United","Altrincham","1-0",1,0,5,5,1,1,"H"
NA,1987,"Wealdstone","Altrincham","0-0",0,0,5,5,0,0,"D"
NA,1987,"Welling United","Altrincham","0-1",0,1,5,5,1,-1,"A"
NA,1987,"Weymouth","Altrincham","1-0",1,0,5,5,1,1,"H"
NA,1987,"Wycombe Wanderers","Altrincham","1-0",1,0,5,5,1,1,"H"
NA,1987,"Altrincham","Barnet","1-1",1,1,5,5,2,0,"D"
NA,1987,"Bath City","Barnet","0-1",0,1,5,5,1,-1,"A"
NA,1987,"Boston United","Barnet","2-1",2,1,5,5,3,1,"H"
NA,1987,"Cheltenham","Barnet","0-2",0,2,5,5,2,-2,"A"
NA,1987,"Dagenham","Barnet","0-0",0,0,5,5,0,0,"D"
NA,1987,"Enfield","Barnet","2-0",2,0,5,5,2,2,"H"
NA,1987,"Fisher Athletic","Barnet","2-2",2,2,5,5,4,0,"D"
NA,1987,"Kettering Town","Barnet","1-1",1,1,5,5,2,0,"D"
NA,1987,"Kidderminster Harriers","Barnet","1-1",1,1,5,5,2,0,"D"
NA,1987,"Lincoln City","Barnet","2-1",2,1,5,5,3,1,"H"
NA,1987,"Macclesfield","Barnet","2-2",2,2,5,5,4,0,"D"
NA,1987,"Maidstone United","Barnet","2-1",2,1,5,5,3,1,"H"
NA,1987,"Northwich Victoria","Barnet","2-1",2,1,5,5,3,1,"H"
NA,1987,"Runcorn","Barnet","0-1",0,1,5,5,1,-1,"A"
NA,1987,"Stafford Rangers","Barnet","1-1",1,1,5,5,2,0,"D"
NA,1987,"Sutton United","Barnet","0-1",0,1,5,5,1,-1,"A"
NA,1987,"Telford United","Barnet","2-4",2,4,5,5,6,-2,"A"
NA,1987,"Wealdstone","Barnet","0-6",0,6,5,5,6,-6,"A"
NA,1987,"Welling United","Barnet","0-2",0,2,5,5,2,-2,"A"
NA,1987,"Weymouth","Barnet","2-0",2,0,5,5,2,2,"H"
NA,1987,"Wycombe Wanderers","Barnet","0-7",0,7,5,5,7,-7,"A"
NA,1987,"Altrincham","Bath City","2-0",2,0,5,5,2,2,"H"
NA,1987,"Barnet","Bath City","4-0",4,0,5,5,4,4,"H"
NA,1987,"Boston United","Bath City","2-0",2,0,5,5,2,2,"H"
NA,1987,"Cheltenham","Bath City","3-3",3,3,5,5,6,0,"D"
NA,1987,"Dagenham","Bath City","1-1",1,1,5,5,2,0,"D"
NA,1987,"Enfield","Bath City","1-3",1,3,5,5,4,-2,"A"
NA,1987,"Fisher Athletic","Bath City","2-0",2,0,5,5,2,2,"H"
NA,1987,"Kettering Town","Bath City","1-1",1,1,5,5,2,0,"D"
NA,1987,"Kidderminster Harriers","Bath City","3-2",3,2,5,5,5,1,"H"
NA,1987,"Lincoln City","Bath City","3-0",3,0,5,5,3,3,"H"
NA,1987,"Macclesfield","Bath City","0-2",0,2,5,5,2,-2,"A"
NA,1987,"Maidstone United","Bath City","3-0",3,0,5,5,3,3,"H"
NA,1987,"Northwich Victoria","Bath City","2-1",2,1,5,5,3,1,"H"
NA,1987,"Runcorn","Bath City","2-1",2,1,5,5,3,1,"H"
NA,1987,"Stafford Rangers","Bath City","1-0",1,0,5,5,1,1,"H"
NA,1987,"Sutton United","Bath City","3-1",3,1,5,5,4,2,"H"
NA,1987,"Telford United","Bath City","3-1",3,1,5,5,4,2,"H"
NA,1987,"Wealdstone","Bath City","1-1",1,1,5,5,2,0,"D"
NA,1987,"Welling United","Bath City","2-1",2,1,5,5,3,1,"H"
NA,1987,"Weymouth","Bath City","3-1",3,1,5,5,4,2,"H"
NA,1987,"Wycombe Wanderers","Bath City","2-2",2,2,5,5,4,0,"D"
NA,1987,"Altrincham","Boston United","4-1",4,1,5,5,5,3,"H"
NA,1987,"Barnet","Boston United","1-0",1,0,5,5,1,1,"H"
NA,1987,"Bath City","Boston United","2-1",2,1,5,5,3,1,"H"
NA,1987,"Cheltenham","Boston United","1-5",1,5,5,5,6,-4,"A"
NA,1987,"Dagenham","Boston United","4-2",4,2,5,5,6,2,"H"
NA,1987,"Enfield","Boston United","3-2",3,2,5,5,5,1,"H"
NA,1987,"Fisher Athletic","Boston United","0-0",0,0,5,5,0,0,"D"
NA,1987,"Kettering Town","Boston United","3-0",3,0,5,5,3,3,"H"
NA,1987,"Kidderminster Harriers","Boston United","1-0",1,0,5,5,1,1,"H"
NA,1987,"Lincoln City","Boston United","5-1",5,1,5,5,6,4,"H"
NA,1987,"Macclesfield","Boston United","2-1",2,1,5,5,3,1,"H"
NA,1987,"Maidstone United","Boston United","1-2",1,2,5,5,3,-1,"A"
NA,1987,"Northwich Victoria","Boston United","6-0",6,0,5,5,6,6,"H"
NA,1987,"Runcorn","Boston United","3-0",3,0,5,5,3,3,"H"
NA,1987,"Stafford Rangers","Boston United","3-4",3,4,5,5,7,-1,"A"
NA,1987,"Sutton United","Boston United","1-2",1,2,5,5,3,-1,"A"
NA,1987,"Telford United","Boston United","2-1",2,1,5,5,3,1,"H"
NA,1987,"Wealdstone","Boston United","1-1",1,1,5,5,2,0,"D"
NA,1987,"Welling United","Boston United","3-1",3,1,5,5,4,2,"H"
NA,1987,"Weymouth","Boston United","3-1",3,1,5,5,4,2,"H"
NA,1987,"Wycombe Wanderers","Boston United","1-2",1,2,5,5,3,-1,"A"
NA,1987,"Altrincham","Cheltenham","1-1",1,1,5,5,2,0,"D"
NA,1987,"Barnet","Cheltenham","1-1",1,1,5,5,2,0,"D"
NA,1987,"Bath City","Cheltenham","1-1",1,1,5,5,2,0,"D"
NA,1987,"Boston United","Cheltenham","4-1",4,1,5,5,5,3,"H"
NA,1987,"Dagenham","Cheltenham","1-3",1,3,5,5,4,-2,"A"
NA,1987,"Enfield","Cheltenham","0-1",0,1,5,5,1,-1,"A"
NA,1987,"Fisher Athletic","Cheltenham","1-0",1,0,5,5,1,1,"H"
NA,1987,"Kettering Town","Cheltenham","1-1",1,1,5,5,2,0,"D"
NA,1987,"Kidderminster Harriers","Cheltenham","3-2",3,2,5,5,5,1,"H"
NA,1987,"Lincoln City","Cheltenham","5-1",5,1,5,5,6,4,"H"
NA,1987,"Macclesfield","Cheltenham","1-0",1,0,5,5,1,1,"H"
NA,1987,"Maidstone United","Cheltenham","2-2",2,2,5,5,4,0,"D"
NA,1987,"Northwich Victoria","Cheltenham","0-0",0,0,5,5,0,0,"D"
NA,1987,"Runcorn","Cheltenham","2-2",2,2,5,5,4,0,"D"
NA,1987,"Stafford Rangers","Cheltenham","2-2",2,2,5,5,4,0,"D"
NA,1987,"Sutton United","Cheltenham","3-0",3,0,5,5,3,3,"H"
NA,1987,"Telford United","Cheltenham","0-1",0,1,5,5,1,-1,"A"
NA,1987,"Wealdstone","Cheltenham","1-4",1,4,5,5,5,-3,"A"
NA,1987,"Welling United","Cheltenham","0-1",0,1,5,5,1,-1,"A"
NA,1987,"Weymouth","Cheltenham","1-1",1,1,5,5,2,0,"D"
NA,1987,"Wycombe Wanderers","Cheltenham","5-3",5,3,5,5,8,2,"H"
NA,1987,"Altrincham","Dagenham","6-0",6,0,5,5,6,6,"H"
NA,1987,"Barnet","Dagenham","3-2",3,2,5,5,5,1,"H"
NA,1987,"Bath City","Dagenham","4-2",4,2,5,5,6,2,"H"
NA,1987,"Boston United","Dagenham","1-0",1,0,5,5,1,1,"H"
NA,1987,"Cheltenham","Dagenham","5-1",5,1,5,5,6,4,"H"
NA,1987,"Enfield","Dagenham","2-2",2,2,5,5,4,0,"D"
NA,1987,"Fisher Athletic","Dagenham","5-1",5,1,5,5,6,4,"H"
NA,1987,"Kettering Town","Dagenham","3-0",3,0,5,5,3,3,"H"
NA,1987,"Kidderminster Harriers","Dagenham","1-1",1,1,5,5,2,0,"D"
NA,1987,"Lincoln City","Dagenham","3-0",3,0,5,5,3,3,"H"
NA,1987,"Macclesfield","Dagenham","3-1",3,1,5,5,4,2,"H"
NA,1987,"Maidstone United","Dagenham","2-0",2,0,5,5,2,2,"H"
NA,1987,"Northwich Victoria","Dagenham","1-0",1,0,5,5,1,1,"H"
NA,1987,"Runcorn","Dagenham","2-1",2,1,5,5,3,1,"H"
NA,1987,"Stafford Rangers","Dagenham","4-0",4,0,5,5,4,4,"H"
NA,1987,"Sutton United","Dagenham","1-1",1,1,5,5,2,0,"D"
NA,1987,"Telford United","Dagenham","1-0",1,0,5,5,1,1,"H"
NA,1987,"Wealdstone","Dagenham","2-3",2,3,5,5,5,-1,"A"
NA,1987,"Welling United","Dagenham","6-1",6,1,5,5,7,5,"H"
NA,1987,"Weymouth","Dagenham","1-0",1,0,5,5,1,1,"H"
NA,1987,"Wycombe Wanderers","Dagenham","2-1",2,1,5,5,3,1,"H"
NA,1987,"Altrincham","Enfield","5-1",5,1,5,5,6,4,"H"
NA,1987,"Barnet","Enfield","3-0",3,0,5,5,3,3,"H"
NA,1987,"Bath City","Enfield","0-1",0,1,5,5,1,-1,"A"
NA,1987,"Boston United","Enfield","2-3",2,3,5,5,5,-1,"A"
NA,1987,"Cheltenham","Enfield","1-1",1,1,5,5,2,0,"D"
NA,1987,"Dagenham","Enfield","1-2",1,2,5,5,3,-1,"A"
NA,1987,"Fisher Athletic","Enfield","2-3",2,3,5,5,5,-1,"A"
NA,1987,"Kettering Town","Enfield","2-1",2,1,5,5,3,1,"H"
NA,1987,"Kidderminster Harriers","Enfield","4-0",4,0,5,5,4,4,"H"
NA,1987,"Lincoln City","Enfield","4-0",4,0,5,5,4,4,"H"
NA,1987,"Macclesfield","Enfield","0-3",0,3,5,5,3,-3,"A"
NA,1987,"Maidstone United","Enfield","3-2",3,2,5,5,5,1,"H"
NA,1987,"Northwich Victoria","Enfield","1-1",1,1,5,5,2,0,"D"
NA,1987,"Runcorn","Enfield","2-2",2,2,5,5,4,0,"D"
NA,1987,"Stafford Rangers","Enfield","3-1",3,1,5,5,4,2,"H"
NA,1987,"Sutton United","Enfield","3-3",3,3,5,5,6,0,"D"
NA,1987,"Telford United","Enfield","4-0",4,0,5,5,4,4,"H"
NA,1987,"Wealdstone","Enfield","1-0",1,0,5,5,1,1,"H"
NA,1987,"Welling United","Enfield","1-1",1,1,5,5,2,0,"D"
NA,1987,"Weymouth","Enfield","1-3",1,3,5,5,4,-2,"A"
NA,1987,"Wycombe Wanderers","Enfield","1-5",1,5,5,5,6,-4,"A"
NA,1987,"Altrincham","Fisher Athletic","2-3",2,3,5,5,5,-1,"A"
NA,1987,"Barnet","Fisher Athletic","2-0",2,0,5,5,2,2,"H"
NA,1987,"Bath City","Fisher Athletic","1-3",1,3,5,5,4,-2,"A"
NA,1987,"Boston United","Fisher Athletic","2-1",2,1,5,5,3,1,"H"
NA,1987,"Cheltenham","Fisher Athletic","2-0",2,0,5,5,2,2,"H"
NA,1987,"Dagenham","Fisher Athletic","1-5",1,5,5,5,6,-4,"A"
NA,1987,"Enfield","Fisher Athletic","0-0",0,0,5,5,0,0,"D"
NA,1987,"Kettering Town","Fisher Athletic","2-1",2,1,5,5,3,1,"H"
NA,1987,"Kidderminster Harriers","Fisher Athletic","1-1",1,1,5,5,2,0,"D"
NA,1987,"Lincoln City","Fisher Athletic","3-0",3,0,5,5,3,3,"H"
NA,1987,"Macclesfield","Fisher Athletic","2-4",2,4,5,5,6,-2,"A"
NA,1987,"Maidstone United","Fisher Athletic","2-2",2,2,5,5,4,0,"D"
NA,1987,"Northwich Victoria","Fisher Athletic","1-2",1,2,5,5,3,-1,"A"
NA,1987,"Runcorn","Fisher Athletic","5-1",5,1,5,5,6,4,"H"
NA,1987,"Stafford Rangers","Fisher Athletic","3-2",3,2,5,5,5,1,"H"
NA,1987,"Sutton United","Fisher Athletic","2-0",2,0,5,5,2,2,"H"
NA,1987,"Telford United","Fisher Athletic","2-1",2,1,5,5,3,1,"H"
NA,1987,"Wealdstone","Fisher Athletic","2-1",2,1,5,5,3,1,"H"
NA,1987,"Welling United","Fisher Athletic","1-1",1,1,5,5,2,0,"D"
NA,1987,"Weymouth","Fisher Athletic","1-1",1,1,5,5,2,0,"D"
NA,1987,"Wycombe Wanderers","Fisher Athletic","1-1",1,1,5,5,2,0,"D"
NA,1987,"Altrincham","Kettering Town","2-2",2,2,5,5,4,0,"D"
NA,1987,"Barnet","Kettering Town","4-0",4,0,5,5,4,4,"H"
NA,1987,"Bath City","Kettering Town","2-0",2,0,5,5,2,2,"H"
NA,1987,"Boston United","Kettering Town","0-2",0,2,5,5,2,-2,"A"
NA,1987,"Cheltenham","Kettering Town","1-2",1,2,5,5,3,-1,"A"
NA,1987,"Dagenham","Kettering Town","0-5",0,5,5,5,5,-5,"A"
NA,1987,"Enfield","Kettering Town","2-0",2,0,5,5,2,2,"H"
NA,1987,"Fisher Athletic","Kettering Town","1-1",1,1,5,5,2,0,"D"
NA,1987,"Kidderminster Harriers","Kettering Town","2-1",2,1,5,5,3,1,"H"
NA,1987,"Lincoln City","Kettering Town","0-1",0,1,5,5,1,-1,"A"
NA,1987,"Macclesfield","Kettering Town","0-0",0,0,5,5,0,0,"D"
NA,1987,"Maidstone United","Kettering Town","2-3",2,3,5,5,5,-1,"A"
NA,1987,"Northwich Victoria","Kettering Town","0-1",0,1,5,5,1,-1,"A"
NA,1987,"Runcorn","Kettering Town","1-0",1,0,5,5,1,1,"H"
NA,1987,"Stafford Rangers","Kettering Town","2-1",2,1,5,5,3,1,"H"
NA,1987,"Sutton United","Kettering Town","2-2",2,2,5,5,4,0,"D"
NA,1987,"Telford United","Kettering Town","2-3",2,3,5,5,5,-1,"A"
NA,1987,"Wealdstone","Kettering Town","0-2",0,2,5,5,2,-2,"A"
NA,1987,"Welling United","Kettering Town","3-1",3,1,5,5,4,2,"H"
NA,1987,"Weymouth","Kettering Town","2-1",2,1,5,5,3,1,"H"
NA,1987,"Wycombe Wanderers","Kettering Town","0-3",0,3,5,5,3,-3,"A"
NA,1987,"Altrincham","Kidderminster Harriers","2-3",2,3,5,5,5,-1,"A"
NA,1987,"Barnet","Kidderminster Harriers","1-1",1,1,5,5,2,0,"D"
NA,1987,"Bath City","Kidderminster Harriers","3-3",3,3,5,5,6,0,"D"
NA,1987,"Boston United","Kidderminster Harriers","1-0",1,0,5,5,1,1,"H"
NA,1987,"Cheltenham","Kidderminster Harriers","2-2",2,2,5,5,4,0,"D"
NA,1987,"Dagenham","Kidderminster Harriers","1-2",1,2,5,5,3,-1,"A"
NA,1987,"Enfield","Kidderminster Harriers","5-2",5,2,5,5,7,3,"H"
NA,1987,"Fisher Athletic","Kidderminster Harriers","3-1",3,1,5,5,4,2,"H"
NA,1987,"Kettering Town","Kidderminster Harriers","1-1",1,1,5,5,2,0,"D"
NA,1987,"Lincoln City","Kidderminster Harriers","5-3",5,3,5,5,8,2,"H"
NA,1987,"Macclesfield","Kidderminster Harriers","1-2",1,2,5,5,3,-1,"A"
NA,1987,"Maidstone United","Kidderminster Harriers","1-2",1,2,5,5,3,-1,"A"
NA,1987,"Northwich Victoria","Kidderminster Harriers","1-1",1,1,5,5,2,0,"D"
NA,1987,"Runcorn","Kidderminster Harriers","2-0",2,0,5,5,2,2,"H"
NA,1987,"Stafford Rangers","Kidderminster Harriers","0-2",0,2,5,5,2,-2,"A"
NA,1987,"Sutton United","Kidderminster Harriers","2-0",2,0,5,5,2,2,"H"
NA,1987,"Telford United","Kidderminster Harriers","4-3",4,3,5,5,7,1,"H"
NA,1987,"Wealdstone","Kidderminster Harriers","1-1",1,1,5,5,2,0,"D"
NA,1987,"Welling United","Kidderminster Harriers","1-2",1,2,5,5,3,-1,"A"
NA,1987,"Weymouth","Kidderminster Harriers","1-1",1,1,5,5,2,0,"D"
NA,1987,"Wycombe Wanderers","Kidderminster Harriers","0-1",0,1,5,5,1,-1,"A"
NA,1987,"Altrincham","Lincoln City","0-0",0,0,5,5,0,0,"D"
NA,1987,"Barnet","Lincoln City","4-2",4,2,5,5,6,2,"H"
NA,1987,"Bath City","Lincoln City","2-1",2,1,5,5,3,1,"H"
NA,1987,"Boston United","Lincoln City","1-2",1,2,5,5,3,-1,"A"
NA,1987,"Cheltenham","Lincoln City","3-3",3,3,5,5,6,0,"D"
NA,1987,"Dagenham","Lincoln City","0-3",0,3,5,5,3,-3,"A"
NA,1987,"Enfield","Lincoln City","0-0",0,0,5,5,0,0,"D"
NA,1987,"Fisher Athletic","Lincoln City","1-1",1,1,5,5,2,0,"D"
NA,1987,"Kettering Town","Lincoln City","2-0",2,0,5,5,2,2,"H"
NA,1987,"Kidderminster Harriers","Lincoln City","3-3",3,3,5,5,6,0,"D"
NA,1987,"Macclesfield","Lincoln City","2-0",2,0,5,5,2,2,"H"
NA,1987,"Maidstone United","Lincoln City","1-2",1,2,5,5,3,-1,"A"
NA,1987,"Northwich Victoria","Lincoln City","2-3",2,3,5,5,5,-1,"A"
NA,1987,"Runcorn","Lincoln City","4-1",4,1,5,5,5,3,"H"
NA,1987,"Stafford Rangers","Lincoln City","1-4",1,4,5,5,5,-3,"A"
NA,1987,"Sutton United","Lincoln City","4-1",4,1,5,5,5,3,"H"
NA,1987,"Telford United","Lincoln City","0-1",0,1,5,5,1,-1,"A"
NA,1987,"Wealdstone","Lincoln City","0-0",0,0,5,5,0,0,"D"
NA,1987,"Welling United","Lincoln City","1-4",1,4,5,5,5,-3,"A"
NA,1987,"Weymouth","Lincoln City","3-0",3,0,5,5,3,3,"H"
NA,1987,"Wycombe Wanderers","Lincoln City","1-2",1,2,5,5,3,-1,"A"
NA,1987,"Altrincham","Macclesfield","1-3",1,3,5,5,4,-2,"A"
NA,1987,"Barnet","Macclesfield","2-1",2,1,5,5,3,1,"H"
NA,1987,"Bath City","Macclesfield","3-4",3,4,5,5,7,-1,"A"
NA,1987,"Boston United","Macclesfield","0-2",0,2,5,5,2,-2,"A"
NA,1987,"Cheltenham","Macclesfield","1-0",1,0,5,5,1,1,"H"
NA,1987,"Dagenham","Macclesfield","0-0",0,0,5,5,0,0,"D"
NA,1987,"Enfield","Macclesfield","1-2",1,2,5,5,3,-1,"A"
NA,1987,"Fisher Athletic","Macclesfield","1-2",1,2,5,5,3,-1,"A"
NA,1987,"Kettering Town","Macclesfield","3-2",3,2,5,5,5,1,"H"
NA,1987,"Kidderminster Harriers","Macclesfield","3-2",3,2,5,5,5,1,"H"
NA,1987,"Lincoln City","Macclesfield","3-0",3,0,5,5,3,3,"H"
NA,1987,"Maidstone United","Macclesfield","2-0",2,0,5,5,2,2,"H"
NA,1987,"Northwich Victoria","Macclesfield","2-1",2,1,5,5,3,1,"H"
NA,1987,"Runcorn","Macclesfield","1-2",1,2,5,5,3,-1,"A"
NA,1987,"Stafford Rangers","Macclesfield","0-1",0,1,5,5,1,-1,"A"
NA,1987,"Sutton United","Macclesfield","2-3",2,3,5,5,5,-1,"A"
NA,1987,"Telford United","Macclesfield","0-0",0,0,5,5,0,0,"D"
NA,1987,"Wealdstone","Macclesfield","1-1",1,1,5,5,2,0,"D"
NA,1987,"Welling United","Macclesfield","3-1",3,1,5,5,4,2,"H"
NA,1987,"Weymouth","Macclesfield","1-1",1,1,5,5,2,0,"D"
NA,1987,"Wycombe Wanderers","Macclesfield","5-0",5,0,5,5,5,5,"H"
NA,1987,"Altrincham","Maidstone United","0-0",0,0,5,5,0,0,"D"
NA,1987,"Barnet","Maidstone United","2-0",2,0,5,5,2,2,"H"
NA,1987,"Bath City","Maidstone United","1-3",1,3,5,5,4,-2,"A"
NA,1987,"Boston United","Maidstone United","3-3",3,3,5,5,6,0,"D"
NA,1987,"Cheltenham","Maidstone United","2-2",2,2,5,5,4,0,"D"
NA,1987,"Dagenham","Maidstone United","0-3",0,3,5,5,3,-3,"A"
NA,1987,"Enfield","Maidstone United","2-4",2,4,5,5,6,-2,"A"
NA,1987,"Fisher Athletic","Maidstone United","0-3",0,3,5,5,3,-3,"A"
NA,1987,"Kettering Town","Maidstone United","0-2",0,2,5,5,2,-2,"A"
NA,1987,"Kidderminster Harriers","Maidstone United","2-1",2,1,5,5,3,1,"H"
NA,1987,"Lincoln City","Maidstone United","1-1",1,1,5,5,2,0,"D"
NA,1987,"Macclesfield","Maidstone United","1-0",1,0,5,5,1,1,"H"
NA,1987,"Northwich Victoria","Maidstone United","2-3",2,3,5,5,5,-1,"A"
NA,1987,"Runcorn","Maidstone United","3-2",3,2,5,5,5,1,"H"
NA,1987,"Stafford Rangers","Maidstone United","2-3",2,3,5,5,5,-1,"A"
NA,1987,"Sutton United","Maidstone United","5-1",5,1,5,5,6,4,"H"
NA,1987,"Telford United","Maidstone United","1-0",1,0,5,5,1,1,"H"
NA,1987,"Wealdstone","Maidstone United","1-3",1,3,5,5,4,-2,"A"
NA,1987,"Welling United","Maidstone United","0-1",0,1,5,5,1,-1,"A"
NA,1987,"Weymouth","Maidstone United","2-1",2,1,5,5,3,1,"H"
NA,1987,"Wycombe Wanderers","Maidstone United","1-5",1,5,5,5,6,-4,"A"
NA,1987,"Altrincham","Northwich Victoria","2-0",2,0,5,5,2,2,"H"
NA,1987,"Barnet","Northwich Victoria","4-1",4,1,5,5,5,3,"H"
NA,1987,"Bath City","Northwich Victoria","0-0",0,0,5,5,0,0,"D"
NA,1987,"Boston United","Northwich Victoria","0-1",0,1,5,5,1,-1,"A"
NA,1987,"Cheltenham","Northwich Victoria","1-1",1,1,5,5,2,0,"D"
NA,1987,"Dagenham","Northwich Victoria","1-0",1,0,5,5,1,1,"H"
NA,1987,"Enfield","Northwich Victoria","0-1",0,1,5,5,1,-1,"A"
NA,1987,"Fisher Athletic","Northwich Victoria","0-0",0,0,5,5,0,0,"D"
NA,1987,"Kettering Town","Northwich Victoria","3-1",3,1,5,5,4,2,"H"
NA,1987,"Kidderminster Harriers","Northwich Victoria","1-1",1,1,5,5,2,0,"D"
NA,1987,"Lincoln City","Northwich Victoria","3-2",3,2,5,5,5,1,"H"
NA,1987,"Macclesfield","Northwich Victoria","5-0",5,0,5,5,5,5,"H"
NA,1987,"Maidstone United","Northwich Victoria","1-1",1,1,5,5,2,0,"D"
NA,1987,"Runcorn","Northwich Victoria","2-1",2,1,5,5,3,1,"H"
NA,1987,"Stafford Rangers","Northwich Victoria","3-0",3,0,5,5,3,3,"H"
NA,1987,"Sutton United","Northwich Victoria","1-1",1,1,5,5,2,0,"D"
NA,1987,"Telford United","Northwich Victoria","1-1",1,1,5,5,2,0,"D"
NA,1987,"Wealdstone","Northwich Victoria","2-2",2,2,5,5,4,0,"D"
NA,1987,"Welling United","Northwich Victoria","1-1",1,1,5,5,2,0,"D"
NA,1987,"Weymouth","Northwich Victoria","0-0",0,0,5,5,0,0,"D"
NA,1987,"Wycombe Wanderers","Northwich Victoria","1-1",1,1,5,5,2,0,"D"
NA,1987,"Altrincham","Runcorn","2-0",2,0,5,5,2,2,"H"
NA,1987,"Barnet","Runcorn","1-2",1,2,5,5,3,-1,"A"
NA,1987,"Bath City","Runcorn","0-1",0,1,5,5,1,-1,"A"
NA,1987,"Boston United","Runcorn","2-2",2,2,5,5,4,0,"D"
NA,1987,"Cheltenham","Runcorn","0-0",0,0,5,5,0,0,"D"
NA,1987,"Dagenham","Runcorn","1-4",1,4,5,5,5,-3,"A"
NA,1987,"Enfield","Runcorn","1-3",1,3,5,5,4,-2,"A"
NA,1987,"Fisher Athletic","Runcorn","0-2",0,2,5,5,2,-2,"A"
NA,1987,"Kettering Town","Runcorn","0-3",0,3,5,5,3,-3,"A"
NA,1987,"Kidderminster Harriers","Runcorn","1-1",1,1,5,5,2,0,"D"
NA,1987,"Lincoln City","Runcorn","1-0",1,0,5,5,1,1,"H"
NA,1987,"Macclesfield","Runcorn","4-0",4,0,5,5,4,4,"H"
NA,1987,"Maidstone United","Runcorn","3-0",3,0,5,5,3,3,"H"
NA,1987,"Northwich Victoria","Runcorn","2-0",2,0,5,5,2,2,"H"
NA,1987,"Stafford Rangers","Runcorn","2-1",2,1,5,5,3,1,"H"
NA,1987,"Sutton United","Runcorn","2-2",2,2,5,5,4,0,"D"
NA,1987,"Telford United","Runcorn","2-1",2,1,5,5,3,1,"H"
NA,1987,"Wealdstone","Runcorn","0-1",0,1,5,5,1,-1,"A"
NA,1987,"Welling United","Runcorn","1-1",1,1,5,5,2,0,"D"
NA,1987,"Weymouth","Runcorn","0-0",0,0,5,5,0,0,"D"
NA,1987,"Wycombe Wanderers","Runcorn","2-2",2,2,5,5,4,0,"D"
NA,1987,"Altrincham","Stafford Rangers","2-0",2,0,5,5,2,2,"H"
NA,1987,"Barnet","Stafford Rangers","2-2",2,2,5,5,4,0,"D"
NA,1987,"Bath City","Stafford Rangers","0-3",0,3,5,5,3,-3,"A"
NA,1987,"Boston United","Stafford Rangers","4-1",4,1,5,5,5,3,"H"
NA,1987,"Cheltenham","Stafford Rangers","2-3",2,3,5,5,5,-1,"A"
NA,1987,"Dagenham","Stafford Rangers","2-4",2,4,5,5,6,-2,"A"
NA,1987,"Enfield","Stafford Rangers","0-0",0,0,5,5,0,0,"D"
NA,1987,"Fisher Athletic","Stafford Rangers","1-2",1,2,5,5,3,-1,"A"
NA,1987,"Kettering Town","Stafford Rangers","1-0",1,0,5,5,1,1,"H"
NA,1987,"Kidderminster Harriers","Stafford Rangers","0-0",0,0,5,5,0,0,"D"
NA,1987,"Lincoln City","Stafford Rangers","2-1",2,1,5,5,3,1,"H"
NA,1987,"Macclesfield","Stafford Rangers","2-3",2,3,5,5,5,-1,"A"
NA,1987,"Maidstone United","Stafford Rangers","4-2",4,2,5,5,6,2,"H"
NA,1987,"Northwich Victoria","Stafford Rangers","1-1",1,1,5,5,2,0,"D"
NA,1987,"Runcorn","Stafford Rangers","1-1",1,1,5,5,2,0,"D"
NA,1987,"Sutton United","Stafford Rangers","2-0",2,0,5,5,2,2,"H"
NA,1987,"Telford United","Stafford Rangers","1-2",1,2,5,5,3,-1,"A"
NA,1987,"Wealdstone","Stafford Rangers","4-2",4,2,5,5,6,2,"H"
NA,1987,"Welling United","Stafford Rangers","0-5",0,5,5,5,5,-5,"A"
NA,1987,"Weymouth","Stafford Rangers","2-0",2,0,5,5,2,2,"H"
NA,1987,"Wycombe Wanderers","Stafford Rangers","0-4",0,4,5,5,4,-4,"A"
NA,1987,"Altrincham","Sutton United","0-1",0,1,5,5,1,-1,"A"
NA,1987,"Barnet","Sutton United","6-2",6,2,5,5,8,4,"H"
NA,1987,"Bath City","Sutton United","0-4",0,4,5,5,4,-4,"A"
NA,1987,"Boston United","Sutton United","0-0",0,0,5,5,0,0,"D"
NA,1987,"Cheltenham","Sutton United","1-1",1,1,5,5,2,0,"D"
NA,1987,"Dagenham","Sutton United","0-1",0,1,5,5,1,-1,"A"
NA,1987,"Enfield","Sutton United","2-3",2,3,5,5,5,-1,"A"
NA,1987,"Fisher Athletic","Sutton United","1-1",1,1,5,5,2,0,"D"
NA,1987,"Kettering Town","Sutton United","2-2",2,2,5,5,4,0,"D"
NA,1987,"Kidderminster Harriers","Sutton United","2-2",2,2,5,5,4,0,"D"
NA,1987,"Lincoln City","Sutton United","1-1",1,1,5,5,2,0,"D"
NA,1987,"Macclesfield","Sutton United","1-1",1,1,5,5,2,0,"D"
NA,1987,"Maidstone United","Sutton United","2-4",2,4,5,5,6,-2,"A"
NA,1987,"Northwich Victoria","Sutton United","1-4",1,4,5,5,5,-3,"A"
NA,1987,"Runcorn","Sutton United","1-0",1,0,5,5,1,1,"H"
NA,1987,"Stafford Rangers","Sutton United","2-0",2,0,5,5,2,2,"H"
NA,1987,"Telford United","Sutton United","3-3",3,3,5,5,6,0,"D"
NA,1987,"Wealdstone","Sutton United","0-0",0,0,5,5,0,0,"D"
NA,1987,"Welling United","Sutton United","1-4",1,4,5,5,5,-3,"A"
NA,1987,"Weymouth","Sutton United","2-1",2,1,5,5,3,1,"H"
NA,1987,"Wycombe Wanderers","Sutton United","1-1",1,1,5,5,2,0,"D"
NA,1987,"Altrincham","Telford United","0-3",0,3,5,5,3,-3,"A"
NA,1987,"Barnet","Telford United","0-2",0,2,5,5,2,-2,"A"
NA,1987,"Bath City","Telford United","1-2",1,2,5,5,3,-1,"A"
NA,1987,"Boston United","Telford United","1-1",1,1,5,5,2,0,"D"
NA,1987,"Cheltenham","Telford United","3-0",3,0,5,5,3,3,"H"
NA,1987,"Dagenham","Telford United","0-1",0,1,5,5,1,-1,"A"
NA,1987,"Enfield","Telford United","1-4",1,4,5,5,5,-3,"A"
NA,1987,"Fisher Athletic","Telford United","0-1",0,1,5,5,1,-1,"A"
NA,1987,"Kettering Town","Telford United","1-0",1,0,5,5,1,1,"H"
NA,1987,"Kidderminster Harriers","Telford United","2-4",2,4,5,5,6,-2,"A"
NA,1987,"Lincoln City","Telford United","0-0",0,0,5,5,0,0,"D"
NA,1987,"Macclesfield","Telford United","1-1",1,1,5,5,2,0,"D"
NA,1987,"Maidstone United","Telford United","2-4",2,4,5,5,6,-2,"A"
NA,1987,"Northwich Victoria","Telford United","1-2",1,2,5,5,3,-1,"A"
NA,1987,"Runcorn","Telford United","2-1",2,1,5,5,3,1,"H"
NA,1987,"Stafford Rangers","Telford United","1-1",1,1,5,5,2,0,"D"
NA,1987,"Sutton United","Telford United","2-1",2,1,5,5,3,1,"H"
NA,1987,"Wealdstone","Telford United","2-2",2,2,5,5,4,0,"D"
NA,1987,"Welling United","Telford United","4-1",4,1,5,5,5,3,"H"
NA,1987,"Weymouth","Telford United","1-0",1,0,5,5,1,1,"H"
NA,1987,"Wycombe Wanderers","Telford United","2-1",2,1,5,5,3,1,"H"
NA,1987,"Altrincham","Wealdstone","1-0",1,0,5,5,1,1,"H"
NA,1987,"Barnet","Wealdstone","5-1",5,1,5,5,6,4,"H"
NA,1987,"Bath City","Wealdstone","0-0",0,0,5,5,0,0,"D"
NA,1987,"Boston United","Wealdstone","0-1",0,1,5,5,1,-1,"A"
NA,1987,"Cheltenham","Wealdstone","1-1",1,1,5,5,2,0,"D"
NA,1987,"Dagenham","Wealdstone","1-2",1,2,5,5,3,-1,"A"
NA,1987,"Enfield","Wealdstone","5-2",5,2,5,5,7,3,"H"
NA,1987,"Fisher Athletic","Wealdstone","3-1",3,1,5,5,4,2,"H"
NA,1987,"Kettering Town","Wealdstone","3-2",3,2,5,5,5,1,"H"
NA,1987,"Kidderminster Harriers","Wealdstone","2-1",2,1,5,5,3,1,"H"
NA,1987,"Lincoln City","Wealdstone","3-0",3,0,5,5,3,3,"H"
NA,1987,"Macclesfield","Wealdstone","3-2",3,2,5,5,5,1,"H"
NA,1987,"Maidstone United","Wealdstone","1-1",1,1,5,5,2,0,"D"
NA,1987,"Northwich Victoria","Wealdstone","0-0",0,0,5,5,0,0,"D"
NA,1987,"Runcorn","Wealdstone","1-0",1,0,5,5,1,1,"H"
NA,1987,"Stafford Rangers","Wealdstone","5-2",5,2,5,5,7,3,"H"
NA,1987,"Sutton United","Wealdstone","1-1",1,1,5,5,2,0,"D"
NA,1987,"Telford United","Wealdstone","1-1",1,1,5,5,2,0,"D"
NA,1987,"Welling United","Wealdstone","4-0",4,0,5,5,4,4,"H"
NA,1987,"Weymouth","Wealdstone","2-1",2,1,5,5,3,1,"H"
NA,1987,"Wycombe Wanderers","Wealdstone","1-0",1,0,5,5,1,1,"H"
NA,1987,"Altrincham","Welling United","1-0",1,0,5,5,1,1,"H"
NA,1987,"Barnet","Welling United","5-2",5,2,5,5,7,3,"H"
NA,1987,"Bath City","Welling United","0-0",0,0,5,5,0,0,"D"
NA,1987,"Boston United","Welling United","1-2",1,2,5,5,3,-1,"A"
NA,1987,"Cheltenham","Welling United","2-2",2,2,5,5,4,0,"D"
NA,1987,"Dagenham","Welling United","1-2",1,2,5,5,3,-1,"A"
NA,1987,"Enfield","Welling United","1-0",1,0,5,5,1,1,"H"
NA,1987,"Fisher Athletic","Welling United","1-0",1,0,5,5,1,1,"H"
NA,1987,"Kettering Town","Welling United","1-0",1,0,5,5,1,1,"H"
NA,1987,"Kidderminster Harriers","Welling United","5-2",5,2,5,5,7,3,"H"
NA,1987,"Lincoln City","Welling United","2-1",2,1,5,5,3,1,"H"
NA,1987,"Macclesfield","Welling United","3-2",3,2,5,5,5,1,"H"
NA,1987,"Maidstone United","Welling United","0-1",0,1,5,5,1,-1,"A"
NA,1987,"Northwich Victoria","Welling United","0-0",0,0,5,5,0,0,"D"
NA,1987,"Runcorn","Welling United","4-0",4,0,5,5,4,4,"H"
NA,1987,"Stafford Rangers","Welling United","2-0",2,0,5,5,2,2,"H"
NA,1987,"Sutton United","Welling United","1-1",1,1,5,5,2,0,"D"
NA,1987,"Telford United","Welling United","2-0",2,0,5,5,2,2,"H"
NA,1987,"Wealdstone","Welling United","1-1",1,1,5,5,2,0,"D"
NA,1987,"Weymouth","Welling United","4-0",4,0,5,5,4,4,"H"
NA,1987,"Wycombe Wanderers","Welling United","3-1",3,1,5,5,4,2,"H"
NA,1987,"Altrincham","Weymouth","3-0",3,0,5,5,3,3,"H"
NA,1987,"Barnet","Weymouth","3-2",3,2,5,5,5,1,"H"
NA,1987,"Bath City","Weymouth","3-1",3,1,5,5,4,2,"H"
NA,1987,"Boston United","Weymouth","1-0",1,0,5,5,1,1,"H"
NA,1987,"Cheltenham","Weymouth","2-1",2,1,5,5,3,1,"H"
NA,1987,"Dagenham","Weymouth","0-3",0,3,5,5,3,-3,"A"
NA,1987,"Enfield","Weymouth","3-2",3,2,5,5,5,1,"H"
NA,1987,"Fisher Athletic","Weymouth","1-0",1,0,5,5,1,1,"H"
NA,1987,"Kettering Town","Weymouth","3-0",3,0,5,5,3,3,"H"
NA,1987,"Kidderminster Harriers","Weymouth","1-0",1,0,5,5,1,1,"H"
NA,1987,"Lincoln City","Weymouth","0-0",0,0,5,5,0,0,"D"
NA,1987,"Macclesfield","Weymouth","1-2",1,2,5,5,3,-1,"A"
NA,1987,"Maidstone United","Weymouth","2-1",2,1,5,5,3,1,"H"
NA,1987,"Northwich Victoria","Weymouth","2-1",2,1,5,5,3,1,"H"
NA,1987,"Runcorn","Weymouth","2-1",2,1,5,5,3,1,"H"
NA,1987,"Stafford Rangers","Weymouth","0-0",0,0,5,5,0,0,"D"
NA,1987,"Sutton United","Weymouth","0-1",0,1,5,5,1,-1,"A"
NA,1987,"Telford United","Weymouth","1-0",1,0,5,5,1,1,"H"
NA,1987,"Wealdstone","Weymouth","0-2",0,2,5,5,2,-2,"A"
NA,1987,"Welling United","Weymouth","0-2",0,2,5,5,2,-2,"A"
NA,1987,"Wycombe Wanderers","Weymouth","2-1",2,1,5,5,3,1,"H"
NA,1987,"Altrincham","Wycombe Wanderers","4-2",4,2,5,5,6,2,"H"
NA,1987,"Barnet","Wycombe Wanderers","1-1",1,1,5,5,2,0,"D"
NA,1987,"Bath City","Wycombe Wanderers","2-1",2,1,5,5,3,1,"H"
NA,1987,"Boston United","Wycombe Wanderers","4-0",4,0,5,5,4,4,"H"
NA,1987,"Cheltenham","Wycombe Wanderers","2-2",2,2,5,5,4,0,"D"
NA,1987,"Dagenham","Wycombe Wanderers","2-1",2,1,5,5,3,1,"H"
NA,1987,"Enfield","Wycombe Wanderers","3-2",3,2,5,5,5,1,"H"
NA,1987,"Fisher Athletic","Wycombe Wanderers","0-0",0,0,5,5,0,0,"D"
NA,1987,"Kettering Town","Wycombe Wanderers","3-0",3,0,5,5,3,3,"H"
NA,1987,"Kidderminster Harriers","Wycombe Wanderers","0-2",0,2,5,5,2,-2,"A"
NA,1987,"Lincoln City","Wycombe Wanderers","2-0",2,0,5,5,2,2,"H"
NA,1987,"Macclesfield","Wycombe Wanderers","1-1",1,1,5,5,2,0,"D"
NA,1987,"Maidstone United","Wycombe Wanderers","0-1",0,1,5,5,1,-1,"A"
NA,1987,"Northwich Victoria","Wycombe Wanderers","2-1",2,1,5,5,3,1,"H"
NA,1987,"Runcorn","Wycombe Wanderers","1-2",1,2,5,5,3,-1,"A"
NA,1987,"Stafford Rangers","Wycombe Wanderers","3-0",3,0,5,5,3,3,"H"
NA,1987,"Sutton United","Wycombe Wanderers","2-2",2,2,5,5,4,0,"D"
NA,1987,"Telford United","Wycombe Wanderers","0-0",0,0,5,5,0,0,"D"
NA,1987,"Wealdstone","Wycombe Wanderers","0-0",0,0,5,5,0,0,"D"
NA,1987,"Welling United","Wycombe Wanderers","1-0",1,0,5,5,1,1,"H"
NA,1987,"Weymouth","Wycombe Wanderers","0-0",0,0,5,5,0,0,"D"
NA,1988,"Aylesbury United","Altrincham","1-2",1,2,5,5,3,-1,"A"
NA,1988,"Barnet","Altrincham","3-0",3,0,5,5,3,3,"H"
NA,1988,"Boston United","Altrincham","3-1",3,1,5,5,4,2,"H"
NA,1988,"Cheltenham","Altrincham","2-1",2,1,5,5,3,1,"H"
NA,1988,"Chorley","Altrincham","1-0",1,0,5,5,1,1,"H"
NA,1988,"Enfield","Altrincham","2-1",2,1,5,5,3,1,"H"
NA,1988,"Fisher Athletic","Altrincham","1-1",1,1,5,5,2,0,"D"
NA,1988,"Kettering Town","Altrincham","0-1",0,1,5,5,1,-1,"A"
NA,1988,"Kidderminster Harriers","Altrincham","2-3",2,3,5,5,5,-1,"A"
NA,1988,"Macclesfield","Altrincham","1-0",1,0,5,5,1,1,"H"
NA,1988,"Maidstone United","Altrincham","7-2",7,2,5,5,9,5,"H"
NA,1988,"Northwich Victoria","Altrincham","4-3",4,3,5,5,7,1,"H"
NA,1988,"Runcorn","Altrincham","3-0",3,0,5,5,3,3,"H"
NA,1988,"Stafford Rangers","Altrincham","0-2",0,2,5,5,2,-2,"A"
NA,1988,"Sutton United","Altrincham","3-2",3,2,5,5,5,1,"H"
NA,1988,"Telford United","Altrincham","0-1",0,1,5,5,1,-1,"A"
NA,1988,"Welling United","Altrincham","0-0",0,0,5,5,0,0,"D"
NA,1988,"Weymouth","Altrincham","1-3",1,3,5,5,4,-2,"A"
NA,1988,"Wycombe Wanderers","Altrincham","2-1",2,1,5,5,3,1,"H"
NA,1988,"Yeovil","Altrincham","2-3",2,3,5,5,5,-1,"A"
NA,1988,"Altrincham","Aylesbury United","1-0",1,0,5,5,1,1,"H"
NA,1988,"Barnet","Aylesbury United","1-0",1,0,5,5,1,1,"H"
NA,1988,"Boston United","Aylesbury United","2-0",2,0,5,5,2,2,"H"
NA,1988,"Cheltenham","Aylesbury United","0-0",0,0,5,5,0,0,"D"
NA,1988,"Chorley","Aylesbury United","1-1",1,1,5,5,2,0,"D"
NA,1988,"Enfield","Aylesbury United","2-1",2,1,5,5,3,1,"H"
NA,1988,"Fisher Athletic","Aylesbury United","0-2",0,2,5,5,2,-2,"A"
NA,1988,"Kettering Town","Aylesbury United","5-2",5,2,5,5,7,3,"H"
NA,1988,"Kidderminster Harriers","Aylesbury United","4-3",4,3,5,5,7,1,"H"
NA,1988,"Macclesfield","Aylesbury United","3-1",3,1,5,5,4,2,"H"
NA,1988,"Maidstone United","Aylesbury United","1-1",1,1,5,5,2,0,"D"
NA,1988,"Northwich Victoria","Aylesbury United","1-1",1,1,5,5,2,0,"D"
NA,1988,"Runcorn","Aylesbury United","5-0",5,0,5,5,5,5,"H"
NA,1988,"Stafford Rangers","Aylesbury United","3-1",3,1,5,5,4,2,"H"
NA,1988,"Sutton United","Aylesbury United","5-2",5,2,5,5,7,3,"H"
NA,1988,"Telford United","Aylesbury United","0-1",0,1,5,5,1,-1,"A"
NA,1988,"Welling United","Aylesbury United","5-0",5,0,5,5,5,5,"H"
NA,1988,"Weymouth","Aylesbury United","0-0",0,0,5,5,0,0,"D"
NA,1988,"Wycombe Wanderers","Aylesbury United","1-0",1,0,5,5,1,1,"H"
NA,1988,"Yeovil","Aylesbury United","1-0",1,0,5,5,1,1,"H"
NA,1988,"Altrincham","Barnet","1-1",1,1,5,5,2,0,"D"
NA,1988,"Aylesbury United","Barnet","1-3",1,3,5,5,4,-2,"A"
NA,1988,"Boston United","Barnet","5-0",5,0,5,5,5,5,"H"
NA,1988,"Cheltenham","Barnet","1-2",1,2,5,5,3,-1,"A"
NA,1988,"Chorley","Barnet","2-3",2,3,5,5,5,-1,"A"
NA,1988,"Enfield","Barnet","4-0",4,0,5,5,4,4,"H"
NA,1988,"Fisher Athletic","Barnet","1-2",1,2,5,5,3,-1,"A"
NA,1988,"Kettering Town","Barnet","3-1",3,1,5,5,4,2,"H"
NA,1988,"Kidderminster Harriers","Barnet","1-0",1,0,5,5,1,1,"H"
NA,1988,"Macclesfield","Barnet","1-1",1,1,5,5,2,0,"D"
NA,1988,"Maidstone United","Barnet","3-2",3,2,5,5,5,1,"H"
NA,1988,"Northwich Victoria","Barnet","1-1",1,1,5,5,2,0,"D"
NA,1988,"Runcorn","Barnet","3-0",3,0,5,5,3,3,"H"
NA,1988,"Stafford Rangers","Barnet","1-2",1,2,5,5,3,-1,"A"
NA,1988,"Sutton United","Barnet","5-1",5,1,5,5,6,4,"H"
NA,1988,"Telford United","Barnet","0-3",0,3,5,5,3,-3,"A"
NA,1988,"Welling United","Barnet","1-1",1,1,5,5,2,0,"D"
NA,1988,"Weymouth","Barnet","1-1",1,1,5,5,2,0,"D"
NA,1988,"Wycombe Wanderers","Barnet","2-3",2,3,5,5,5,-1,"A"
NA,1988,"Yeovil","Barnet","2-1",2,1,5,5,3,1,"H"
NA,1988,"Altrincham","Boston United","0-0",0,0,5,5,0,0,"D"
NA,1988,"Aylesbury United","Boston United","1-2",1,2,5,5,3,-1,"A"
NA,1988,"Barnet","Boston United","0-0",0,0,5,5,0,0,"D"
NA,1988,"Cheltenham","Boston United","3-1",3,1,5,5,4,2,"H"
NA,1988,"Chorley","Boston United","0-1",0,1,5,5,1,-1,"A"
NA,1988,"Enfield","Boston United","1-2",1,2,5,5,3,-1,"A"
NA,1988,"Fisher Athletic","Boston United","1-3",1,3,5,5,4,-2,"A"
NA,1988,"Kettering Town","Boston United","1-2",1,2,5,5,3,-1,"A"
NA,1988,"Kidderminster Harriers","Boston United","0-2",0,2,5,5,2,-2,"A"
NA,1988,"Macclesfield","Boston United","0-1",0,1,5,5,1,-1,"A"
NA,1988,"Maidstone United","Boston United","3-0",3,0,5,5,3,3,"H"
NA,1988,"Northwich Victoria","Boston United","0-1",0,1,5,5,1,-1,"A"
NA,1988,"Runcorn","Boston United","1-2",1,2,5,5,3,-1,"A"
NA,1988,"Stafford Rangers","Boston United","4-1",4,1,5,5,5,3,"H"
NA,1988,"Sutton United","Boston United","0-0",0,0,5,5,0,0,"D"
NA,1988,"Telford United","Boston United","0-1",0,1,5,5,1,-1,"A"
NA,1988,"Welling United","Boston United","3-2",3,2,5,5,5,1,"H"
NA,1988,"Weymouth","Boston United","2-2",2,2,5,5,4,0,"D"
NA,1988,"Wycombe Wanderers","Boston United","2-1",2,1,5,5,3,1,"H"
NA,1988,"Yeovil","Boston United","1-1",1,1,5,5,2,0,"D"
NA,1988,"Altrincham","Cheltenham","0-1",0,1,5,5,1,-1,"A"
NA,1988,"Aylesbury United","Cheltenham","0-0",0,0,5,5,0,0,"D"
NA,1988,"Barnet","Cheltenham","3-1",3,1,5,5,4,2,"H"
NA,1988,"Boston United","Cheltenham","1-1",1,1,5,5,2,0,"D"
NA,1988,"Chorley","Cheltenham","1-4",1,4,5,5,5,-3,"A"
NA,1988,"Enfield","Cheltenham","3-4",3,4,5,5,7,-1,"A"
NA,1988,"Fisher Athletic","Cheltenham","2-0",2,0,5,5,2,2,"H"
NA,1988,"Kettering Town","Cheltenham","2-0",2,0,5,5,2,2,"H"
NA,1988,"Kidderminster Harriers","Cheltenham","3-2",3,2,5,5,5,1,"H"
NA,1988,"Macclesfield","Cheltenham","0-0",0,0,5,5,0,0,"D"
NA,1988,"Maidstone United","Cheltenham","2-0",2,0,5,5,2,2,"H"
NA,1988,"Northwich Victoria","Cheltenham","1-0",1,0,5,5,1,1,"H"
NA,1988,"Runcorn","Cheltenham","2-1",2,1,5,5,3,1,"H"
NA,1988,"Stafford Rangers","Cheltenham","1-1",1,1,5,5,2,0,"D"
NA,1988,"Sutton United","Cheltenham","1-1",1,1,5,5,2,0,"D"
NA,1988,"Telford United","Cheltenham","2-0",2,0,5,5,2,2,"H"
NA,1988,"Welling United","Cheltenham","0-2",0,2,5,5,2,-2,"A"
NA,1988,"Weymouth","Cheltenham","3-2",3,2,5,5,5,1,"H"
NA,1988,"Wycombe Wanderers","Cheltenham","1-0",1,0,5,5,1,1,"H"
NA,1988,"Yeovil","Cheltenham","1-3",1,3,5,5,4,-2,"A"
NA,1988,"Altrincham","Chorley","1-2",1,2,5,5,3,-1,"A"
NA,1988,"Aylesbury United","Chorley","4-3",4,3,5,5,7,1,"H"
NA,1988,"Barnet","Chorley","2-4",2,4,5,5,6,-2,"A"
NA,1988,"Boston United","Chorley","2-0",2,0,5,5,2,2,"H"
NA,1988,"Cheltenham","Chorley","2-2",2,2,5,5,4,0,"D"
NA,1988,"Enfield","Chorley","1-2",1,2,5,5,3,-1,"A"
NA,1988,"Fisher Athletic","Chorley","4-0",4,0,5,5,4,4,"H"
NA,1988,"Kettering Town","Chorley","3-0",3,0,5,5,3,3,"H"
NA,1988,"Kidderminster Harriers","Chorley","0-2",0,2,5,5,2,-2,"A"
NA,1988,"Macclesfield","Chorley","3-2",3,2,5,5,5,1,"H"
NA,1988,"Maidstone United","Chorley","2-0",2,0,5,5,2,2,"H"
NA,1988,"Northwich Victoria","Chorley","0-4",0,4,5,5,4,-4,"A"
NA,1988,"Runcorn","Chorley","3-0",3,0,5,5,3,3,"H"
NA,1988,"Stafford Rangers","Chorley","3-2",3,2,5,5,5,1,"H"
NA,1988,"Sutton United","Chorley","1-2",1,2,5,5,3,-1,"A"
NA,1988,"Telford United","Chorley","2-1",2,1,5,5,3,1,"H"
NA,1988,"Welling United","Chorley","1-0",1,0,5,5,1,1,"H"
NA,1988,"Weymouth","Chorley","2-3",2,3,5,5,5,-1,"A"
NA,1988,"Wycombe Wanderers","Chorley","1-1",1,1,5,5,2,0,"D"
NA,1988,"Yeovil","Chorley","2-1",2,1,5,5,3,1,"H"
NA,1988,"Altrincham","Enfield","0-0",0,0,5,5,0,0,"D"
NA,1988,"Aylesbury United","Enfield","2-1",2,1,5,5,3,1,"H"
NA,1988,"Barnet","Enfield","2-1",2,1,5,5,3,1,"H"
NA,1988,"Boston United","Enfield","3-2",3,2,5,5,5,1,"H"
NA,1988,"Cheltenham","Enfield","3-2",3,2,5,5,5,1,"H"
NA,1988,"Chorley","Enfield","1-2",1,2,5,5,3,-1,"A"
NA,1988,"Fisher Athletic","Enfield","1-2",1,2,5,5,3,-1,"A"
NA,1988,"Kettering Town","Enfield","0-1",0,1,5,5,1,-1,"A"
NA,1988,"Kidderminster Harriers","Enfield","1-3",1,3,5,5,4,-2,"A"
NA,1988,"Macclesfield","Enfield","1-1",1,1,5,5,2,0,"D"
NA,1988,"Maidstone United","Enfield","3-1",3,1,5,5,4,2,"H"
NA,1988,"Northwich Victoria","Enfield","2-2",2,2,5,5,4,0,"D"
NA,1988,"Runcorn","Enfield","1-2",1,2,5,5,3,-1,"A"
NA,1988,"Stafford Rangers","Enfield","3-1",3,1,5,5,4,2,"H"
NA,1988,"Sutton United","Enfield","3-1",3,1,5,5,4,2,"H"
NA,1988,"Telford United","Enfield","3-0",3,0,5,5,3,3,"H"
NA,1988,"Welling United","Enfield","0-0",0,0,5,5,0,0,"D"
NA,1988,"Weymouth","Enfield","2-3",2,3,5,5,5,-1,"A"
NA,1988,"Wycombe Wanderers","Enfield","3-2",3,2,5,5,5,1,"H"
NA,1988,"Yeovil","Enfield","1-2",1,2,5,5,3,-1,"A"
NA,1988,"Altrincham","Fisher Athletic","1-1",1,1,5,5,2,0,"D"
NA,1988,"Aylesbury United","Fisher Athletic","1-1",1,1,5,5,2,0,"D"
NA,1988,"Barnet","Fisher Athletic","2-3",2,3,5,5,5,-1,"A"
NA,1988,"Boston United","Fisher Athletic","2-4",2,4,5,5,6,-2,"A"
NA,1988,"Cheltenham","Fisher Athletic","2-2",2,2,5,5,4,0,"D"
NA,1988,"Chorley","Fisher Athletic","1-1",1,1,5,5,2,0,"D"
NA,1988,"Enfield","Fisher Athletic","2-1",2,1,5,5,3,1,"H"
NA,1988,"Kettering Town","Fisher Athletic","2-1",2,1,5,5,3,1,"H"
NA,1988,"Kidderminster Harriers","Fisher Athletic","2-1",2,1,5,5,3,1,"H"
NA,1988,"Macclesfield","Fisher Athletic","2-2",2,2,5,5,4,0,"D"
NA,1988,"Maidstone United","Fisher Athletic","1-0",1,0,5,5,1,1,"H"
NA,1988,"Northwich Victoria","Fisher Athletic","3-0",3,0,5,5,3,3,"H"
NA,1988,"Runcorn","Fisher Athletic","1-1",1,1,5,5,2,0,"D"
NA,1988,"Stafford Rangers","Fisher Athletic","0-1",0,1,5,5,1,-1,"A"
NA,1988,"Sutton United","Fisher Athletic","2-1",2,1,5,5,3,1,"H"
NA,1988,"Telford United","Fisher Athletic","1-1",1,1,5,5,2,0,"D"
NA,1988,"Welling United","Fisher Athletic","3-1",3,1,5,5,4,2,"H"
NA,1988,"Weymouth","Fisher Athletic","1-0",1,0,5,5,1,1,"H"
NA,1988,"Wycombe Wanderers","Fisher Athletic","3-0",3,0,5,5,3,3,"H"
NA,1988,"Yeovil","Fisher Athletic","1-2",1,2,5,5,3,-1,"A"
NA,1988,"Altrincham","Kettering Town","1-2",1,2,5,5,3,-1,"A"
NA,1988,"Aylesbury United","Kettering Town","0-1",0,1,5,5,1,-1,"A"
NA,1988,"Barnet","Kettering Town","3-2",3,2,5,5,5,1,"H"
NA,1988,"Boston United","Kettering Town","1-1",1,1,5,5,2,0,"D"
NA,1988,"Cheltenham","Kettering Town","2-1",2,1,5,5,3,1,"H"
NA,1988,"Chorley","Kettering Town","0-1",0,1,5,5,1,-1,"A"
NA,1988,"Enfield","Kettering Town","1-1",1,1,5,5,2,0,"D"
NA,1988,"Fisher Athletic","Kettering Town","3-0",3,0,5,5,3,3,"H"
NA,1988,"Kidderminster Harriers","Kettering Town","1-1",1,1,5,5,2,0,"D"
NA,1988,"Macclesfield","Kettering Town","0-1",0,1,5,5,1,-1,"A"
NA,1988,"Maidstone United","Kettering Town","0-0",0,0,5,5,0,0,"D"
NA,1988,"Northwich Victoria","Kettering Town","1-1",1,1,5,5,2,0,"D"
NA,1988,"Runcorn","Kettering Town","2-1",2,1,5,5,3,1,"H"
NA,1988,"Stafford Rangers","Kettering Town","2-1",2,1,5,5,3,1,"H"
NA,1988,"Sutton United","Kettering Town","0-2",0,2,5,5,2,-2,"A"
NA,1988,"Telford United","Kettering Town","0-1",0,1,5,5,1,-1,"A"
NA,1988,"Welling United","Kettering Town","2-1",2,1,5,5,3,1,"H"
NA,1988,"Weymouth","Kettering Town","3-0",3,0,5,5,3,3,"H"
NA,1988,"Wycombe Wanderers","Kettering Town","0-1",0,1,5,5,1,-1,"A"
NA,1988,"Yeovil","Kettering Town","2-2",2,2,5,5,4,0,"D"
NA,1988,"Altrincham","Kidderminster Harriers","3-1",3,1,5,5,4,2,"H"
NA,1988,"Aylesbury United","Kidderminster Harriers","1-5",1,5,5,5,6,-4,"A"
NA,1988,"Barnet","Kidderminster Harriers","0-2",0,2,5,5,2,-2,"A"
NA,1988,"Boston United","Kidderminster Harriers","0-2",0,2,5,5,2,-2,"A"
NA,1988,"Cheltenham","Kidderminster Harriers","4-1",4,1,5,5,5,3,"H"
NA,1988,"Chorley","Kidderminster Harriers","1-3",1,3,5,5,4,-2,"A"
NA,1988,"Enfield","Kidderminster Harriers","1-3",1,3,5,5,4,-2,"A"
NA,1988,"Fisher Athletic","Kidderminster Harriers","2-0",2,0,5,5,2,2,"H"
NA,1988,"Kettering Town","Kidderminster Harriers","2-1",2,1,5,5,3,1,"H"
NA,1988,"Macclesfield","Kidderminster Harriers","1-1",1,1,5,5,2,0,"D"
NA,1988,"Maidstone United","Kidderminster Harriers","0-3",0,3,5,5,3,-3,"A"
NA,1988,"Northwich Victoria","Kidderminster Harriers","2-4",2,4,5,5,6,-2,"A"
NA,1988,"Runcorn","Kidderminster Harriers","1-3",1,3,5,5,4,-2,"A"
NA,1988,"Stafford Rangers","Kidderminster Harriers","0-1",0,1,5,5,1,-1,"A"
NA,1988,"Sutton United","Kidderminster Harriers","1-1",1,1,5,5,2,0,"D"
NA,1988,"Telford United","Kidderminster Harriers","1-0",1,0,5,5,1,1,"H"
NA,1988,"Welling United","Kidderminster Harriers","0-1",0,1,5,5,1,-1,"A"
NA,1988,"Weymouth","Kidderminster Harriers","3-1",3,1,5,5,4,2,"H"
NA,1988,"Wycombe Wanderers","Kidderminster Harriers","1-0",1,0,5,5,1,1,"H"
NA,1988,"Yeovil","Kidderminster Harriers","1-3",1,3,5,5,4,-2,"A"
NA,1988,"Altrincham","Macclesfield","1-3",1,3,5,5,4,-2,"A"
NA,1988,"Aylesbury United","Macclesfield","1-2",1,2,5,5,3,-1,"A"
NA,1988,"Barnet","Macclesfield","1-4",1,4,5,5,5,-3,"A"
NA,1988,"Boston United","Macclesfield","3-2",3,2,5,5,5,1,"H"
NA,1988,"Cheltenham","Macclesfield","3-0",3,0,5,5,3,3,"H"
NA,1988,"Chorley","Macclesfield","0-1",0,1,5,5,1,-1,"A"
NA,1988,"Enfield","Macclesfield","2-1",2,1,5,5,3,1,"H"
NA,1988,"Fisher Athletic","Macclesfield","2-2",2,2,5,5,4,0,"D"
NA,1988,"Kettering Town","Macclesfield","1-0",1,0,5,5,1,1,"H"
NA,1988,"Kidderminster Harriers","Macclesfield","0-1",0,1,5,5,1,-1,"A"
NA,1988,"Maidstone United","Macclesfield","3-3",3,3,5,5,6,0,"D"
NA,1988,"Northwich Victoria","Macclesfield","3-2",3,2,5,5,5,1,"H"
NA,1988,"Runcorn","Macclesfield","2-2",2,2,5,5,4,0,"D"
NA,1988,"Stafford Rangers","Macclesfield","1-1",1,1,5,5,2,0,"D"
NA,1988,"Sutton United","Macclesfield","1-2",1,2,5,5,3,-1,"A"
NA,1988,"Telford United","Macclesfield","1-3",1,3,5,5,4,-2,"A"
NA,1988,"Welling United","Macclesfield","2-0",2,0,5,5,2,2,"H"
NA,1988,"Weymouth","Macclesfield","1-2",1,2,5,5,3,-1,"A"
NA,1988,"Wycombe Wanderers","Macclesfield","1-1",1,1,5,5,2,0,"D"
NA,1988,"Yeovil","Macclesfield","2-0",2,0,5,5,2,2,"H"
NA,1988,"Altrincham","Maidstone United","0-1",0,1,5,5,1,-1,"A"
NA,1988,"Aylesbury United","Maidstone United","1-2",1,2,5,5,3,-1,"A"
NA,1988,"Barnet","Maidstone United","2-1",2,1,5,5,3,1,"H"
NA,1988,"Boston United","Maidstone United","1-4",1,4,5,5,5,-3,"A"
NA,1988,"Cheltenham","Maidstone United","0-4",0,4,5,5,4,-4,"A"
NA,1988,"Chorley","Maidstone United","1-3",1,3,5,5,4,-2,"A"
NA,1988,"Enfield","Maidstone United","1-1",1,1,5,5,2,0,"D"
NA,1988,"Fisher Athletic","Maidstone United","0-2",0,2,5,5,2,-2,"A"
NA,1988,"Kettering Town","Maidstone United","3-3",3,3,5,5,6,0,"D"
NA,1988,"Kidderminster Harriers","Maidstone United","3-6",3,6,5,5,9,-3,"A"
NA,1988,"Macclesfield","Maidstone United","4-3",4,3,5,5,7,1,"H"
NA,1988,"Northwich Victoria","Maidstone United","2-0",2,0,5,5,2,2,"H"
NA,1988,"Runcorn","Maidstone United","0-1",0,1,5,5,1,-1,"A"
NA,1988,"Stafford Rangers","Maidstone United","0-2",0,2,5,5,2,-2,"A"
NA,1988,"Sutton United","Maidstone United","1-1",1,1,5,5,2,0,"D"
NA,1988,"Telford United","Maidstone United","1-2",1,2,5,5,3,-1,"A"
NA,1988,"Welling United","Maidstone United","0-0",0,0,5,5,0,0,"D"
NA,1988,"Weymouth","Maidstone United","1-3",1,3,5,5,4,-2,"A"
NA,1988,"Wycombe Wanderers","Maidstone United","2-3",2,3,5,5,5,-1,"A"
NA,1988,"Yeovil","Maidstone United","1-2",1,2,5,5,3,-1,"A"
NA,1988,"Altrincham","Northwich Victoria","2-2",2,2,5,5,4,0,"D"
NA,1988,"Aylesbury United","Northwich Victoria","2-0",2,0,5,5,2,2,"H"
NA,1988,"Barnet","Northwich Victoria","2-0",2,0,5,5,2,2,"H"
NA,1988,"Boston United","Northwich Victoria","2-1",2,1,5,5,3,1,"H"
NA,1988,"Cheltenham","Northwich Victoria","2-2",2,2,5,5,4,0,"D"
NA,1988,"Chorley","Northwich Victoria","3-1",3,1,5,5,4,2,"H"
NA,1988,"Enfield","Northwich Victoria","1-2",1,2,5,5,3,-1,"A"
NA,1988,"Fisher Athletic","Northwich Victoria","2-4",2,4,5,5,6,-2,"A"
NA,1988,"Kettering Town","Northwich Victoria","2-1",2,1,5,5,3,1,"H"
NA,1988,"Kidderminster Harriers","Northwich Victoria","1-1",1,1,5,5,2,0,"D"
NA,1988,"Macclesfield","Northwich Victoria","0-2",0,2,5,5,2,-2,"A"
NA,1988,"Maidstone United","Northwich Victoria","4-1",4,1,5,5,5,3,"H"
NA,1988,"Runcorn","Northwich Victoria","3-1",3,1,5,5,4,2,"H"
NA,1988,"Stafford Rangers","Northwich Victoria","0-1",0,1,5,5,1,-1,"A"
NA,1988,"Sutton United","Northwich Victoria","3-3",3,3,5,5,6,0,"D"
NA,1988,"Telford United","Northwich Victoria","1-4",1,4,5,5,5,-3,"A"
NA,1988,"Welling United","Northwich Victoria","0-0",0,0,5,5,0,0,"D"
NA,1988,"Weymouth","Northwich Victoria","2-2",2,2,5,5,4,0,"D"
NA,1988,"Wycombe Wanderers","Northwich Victoria","1-4",1,4,5,5,5,-3,"A"
NA,1988,"Yeovil","Northwich Victoria","2-1",2,1,5,5,3,1,"H"
NA,1988,"Altrincham","Runcorn","1-2",1,2,5,5,3,-1,"A"
NA,1988,"Aylesbury United","Runcorn","1-2",1,2,5,5,3,-1,"A"
NA,1988,"Barnet","Runcorn","3-2",3,2,5,5,5,1,"H"
NA,1988,"Boston United","Runcorn","0-6",0,6,5,5,6,-6,"A"
NA,1988,"Cheltenham","Runcorn","2-1",2,1,5,5,3,1,"H"
NA,1988,"Chorley","Runcorn","1-3",1,3,5,5,4,-2,"A"
NA,1988,"Enfield","Runcorn","0-3",0,3,5,5,3,-3,"A"
NA,1988,"Fisher Athletic","Runcorn","0-1",0,1,5,5,1,-1,"A"
NA,1988,"Kettering Town","Runcorn","2-0",2,0,5,5,2,2,"H"
NA,1988,"Kidderminster Harriers","Runcorn","2-1",2,1,5,5,3,1,"H"
NA,1988,"Macclesfield","Runcorn","3-2",3,2,5,5,5,1,"H"
NA,1988,"Maidstone United","Runcorn","2-2",2,2,5,5,4,0,"D"
NA,1988,"Northwich Victoria","Runcorn","0-1",0,1,5,5,1,-1,"A"
NA,1988,"Stafford Rangers","Runcorn","0-4",0,4,5,5,4,-4,"A"
NA,1988,"Sutton United","Runcorn","3-1",3,1,5,5,4,2,"H"
NA,1988,"Telford United","Runcorn","1-1",1,1,5,5,2,0,"D"
NA,1988,"Welling United","Runcorn","4-0",4,0,5,5,4,4,"H"
NA,1988,"Weymouth","Runcorn","1-1",1,1,5,5,2,0,"D"
NA,1988,"Wycombe Wanderers","Runcorn","3-3",3,3,5,5,6,0,"D"
NA,1988,"Yeovil","Runcorn","2-2",2,2,5,5,4,0,"D"
NA,1988,"Altrincham","Stafford Rangers","2-1",2,1,5,5,3,1,"H"
NA,1988,"Aylesbury United","Stafford Rangers","1-1",1,1,5,5,2,0,"D"
NA,1988,"Barnet","Stafford Rangers","1-2",1,2,5,5,3,-1,"A"
NA,1988,"Boston United","Stafford Rangers","2-1",2,1,5,5,3,1,"H"
NA,1988,"Cheltenham","Stafford Rangers","1-2",1,2,5,5,3,-1,"A"
NA,1988,"Chorley","Stafford Rangers","3-1",3,1,5,5,4,2,"H"
NA,1988,"Enfield","Stafford Rangers","4-2",4,2,5,5,6,2,"H"
NA,1988,"Fisher Athletic","Stafford Rangers","0-1",0,1,5,5,1,-1,"A"
NA,1988,"Kettering Town","Stafford Rangers","1-0",1,0,5,5,1,1,"H"
NA,1988,"Kidderminster Harriers","Stafford Rangers","3-2",3,2,5,5,5,1,"H"
NA,1988,"Macclesfield","Stafford Rangers","2-1",2,1,5,5,3,1,"H"
NA,1988,"Maidstone United","Stafford Rangers","3-0",3,0,5,5,3,3,"H"
NA,1988,"Northwich Victoria","Stafford Rangers","1-1",1,1,5,5,2,0,"D"
NA,1988,"Runcorn","Stafford Rangers","4-1",4,1,5,5,5,3,"H"
NA,1988,"Sutton United","Stafford Rangers","2-0",2,0,5,5,2,2,"H"
NA,1988,"Telford United","Stafford Rangers","2-2",2,2,5,5,4,0,"D"
NA,1988,"Welling United","Stafford Rangers","1-3",1,3,5,5,4,-2,"A"
NA,1988,"Weymouth","Stafford Rangers","1-0",1,0,5,5,1,1,"H"
NA,1988,"Wycombe Wanderers","Stafford Rangers","6-1",6,1,5,5,7,5,"H"
NA,1988,"Yeovil","Stafford Rangers","2-0",2,0,5,5,2,2,"H"
NA,1988,"Altrincham","Sutton United","1-0",1,0,5,5,1,1,"H"
NA,1988,"Aylesbury United","Sutton United","1-0",1,0,5,5,1,1,"H"
NA,1988,"Barnet","Sutton United","1-1",1,1,5,5,2,0,"D"
NA,1988,"Boston United","Sutton United","3-1",3,1,5,5,4,2,"H"
NA,1988,"Cheltenham","Sutton United","2-3",2,3,5,5,5,-1,"A"
NA,1988,"Chorley","Sutton United","2-1",2,1,5,5,3,1,"H"
NA,1988,"Enfield","Sutton United","1-1",1,1,5,5,2,0,"D"
NA,1988,"Fisher Athletic","Sutton United","1-1",1,1,5,5,2,0,"D"
NA,1988,"Kettering Town","Sutton United","1-0",1,0,5,5,1,1,"H"
NA,1988,"Kidderminster Harriers","Sutton United","1-0",1,0,5,5,1,1,"H"
NA,1988,"Macclesfield","Sutton United","1-3",1,3,5,5,4,-2,"A"
NA,1988,"Maidstone United","Sutton United","1-1",1,1,5,5,2,0,"D"
NA,1988,"Northwich Victoria","Sutton United","4-2",4,2,5,5,6,2,"H"
NA,1988,"Runcorn","Sutton United","2-1",2,1,5,5,3,1,"H"
NA,1988,"Stafford Rangers","Sutton United","1-1",1,1,5,5,2,0,"D"
NA,1988,"Telford United","Sutton United","0-0",0,0,5,5,0,0,"D"
NA,1988,"Welling United","Sutton United","1-1",1,1,5,5,2,0,"D"
NA,1988,"Weymouth","Sutton United","2-2",2,2,5,5,4,0,"D"
NA,1988,"Wycombe Wanderers","Sutton United","2-2",2,2,5,5,4,0,"D"
NA,1988,"Yeovil","Sutton United","0-0",0,0,5,5,0,0,"D"
NA,1988,"Altrincham","Telford United","0-0",0,0,5,5,0,0,"D"
NA,1988,"Aylesbury United","Telford United","2-0",2,0,5,5,2,2,"H"
NA,1988,"Barnet","Telford United","1-3",1,3,5,5,4,-2,"A"
NA,1988,"Boston United","Telford United","1-0",1,0,5,5,1,1,"H"
NA,1988,"Cheltenham","Telford United","0-1",0,1,5,5,1,-1,"A"
NA,1988,"Chorley","Telford United","2-0",2,0,5,5,2,2,"H"
NA,1988,"Enfield","Telford United","0-1",0,1,5,5,1,-1,"A"
NA,1988,"Fisher Athletic","Telford United","0-1",0,1,5,5,1,-1,"A"
NA,1988,"Kettering Town","Telford United","1-0",1,0,5,5,1,1,"H"
NA,1988,"Kidderminster Harriers","Telford United","1-1",1,1,5,5,2,0,"D"
NA,1988,"Macclesfield","Telford United","2-1",2,1,5,5,3,1,"H"
NA,1988,"Maidstone United","Telford United","1-3",1,3,5,5,4,-2,"A"
NA,1988,"Northwich Victoria","Telford United","1-0",1,0,5,5,1,1,"H"
NA,1988,"Runcorn","Telford United","0-0",0,0,5,5,0,0,"D"
NA,1988,"Stafford Rangers","Telford United","1-3",1,3,5,5,4,-2,"A"
NA,1988,"Sutton United","Telford United","1-2",1,2,5,5,3,-1,"A"
NA,1988,"Welling United","Telford United","0-1",0,1,5,5,1,-1,"A"
NA,1988,"Weymouth","Telford United","0-0",0,0,5,5,0,0,"D"
NA,1988,"Wycombe Wanderers","Telford United","1-0",1,0,5,5,1,1,"H"
NA,1988,"Yeovil","Telford United","4-3",4,3,5,5,7,1,"H"
NA,1988,"Altrincham","Welling United","3-1",3,1,5,5,4,2,"H"
NA,1988,"Aylesbury United","Welling United","0-0",0,0,5,5,0,0,"D"
NA,1988,"Barnet","Welling United","2-3",2,3,5,5,5,-1,"A"
NA,1988,"Boston United","Welling United","2-0",2,0,5,5,2,2,"H"
NA,1988,"Cheltenham","Welling United","1-1",1,1,5,5,2,0,"D"
NA,1988,"Chorley","Welling United","1-1",1,1,5,5,2,0,"D"
NA,1988,"Enfield","Welling United","0-1",0,1,5,5,1,-1,"A"
NA,1988,"Fisher Athletic","Welling United","1-3",1,3,5,5,4,-2,"A"
NA,1988,"Kettering Town","Welling United","2-1",2,1,5,5,3,1,"H"
NA,1988,"Kidderminster Harriers","Welling United","2-1",2,1,5,5,3,1,"H"
NA,1988,"Macclesfield","Welling United","3-0",3,0,5,5,3,3,"H"
NA,1988,"Maidstone United","Welling United","3-0",3,0,5,5,3,3,"H"
NA,1988,"Northwich Victoria","Welling United","0-2",0,2,5,5,2,-2,"A"
NA,1988,"Runcorn","Welling United","1-2",1,2,5,5,3,-1,"A"
NA,1988,"Stafford Rangers","Welling United","3-0",3,0,5,5,3,3,"H"
NA,1988,"Sutton United","Welling United","0-1",0,1,5,5,1,-1,"A"
NA,1988,"Telford United","Welling United","0-0",0,0,5,5,0,0,"D"
NA,1988,"Weymouth","Welling United","1-0",1,0,5,5,1,1,"H"
NA,1988,"Wycombe Wanderers","Welling United","1-1",1,1,5,5,2,0,"D"
NA,1988,"Yeovil","Welling United","4-0",4,0,5,5,4,4,"H"
NA,1988,"Altrincham","Weymouth","2-1",2,1,5,5,3,1,"H"
NA,1988,"Aylesbury United","Weymouth","4-1",4,1,5,5,5,3,"H"
NA,1988,"Barnet","Weymouth","4-1",4,1,5,5,5,3,"H"
NA,1988,"Boston United","Weymouth","2-0",2,0,5,5,2,2,"H"
NA,1988,"Cheltenham","Weymouth","1-1",1,1,5,5,2,0,"D"
NA,1988,"Chorley","Weymouth","0-0",0,0,5,5,0,0,"D"
NA,1988,"Enfield","Weymouth","3-0",3,0,5,5,3,3,"H"
NA,1988,"Fisher Athletic","Weymouth","3-2",3,2,5,5,5,1,"H"
NA,1988,"Kettering Town","Weymouth","1-0",1,0,5,5,1,1,"H"
NA,1988,"Kidderminster Harriers","Weymouth","1-0",1,0,5,5,1,1,"H"
NA,1988,"Macclesfield","Weymouth","2-0",2,0,5,5,2,2,"H"
NA,1988,"Maidstone United","Weymouth","3-0",3,0,5,5,3,3,"H"
NA,1988,"Northwich Victoria","Weymouth","2-0",2,0,5,5,2,2,"H"
NA,1988,"Runcorn","Weymouth","1-0",1,0,5,5,1,1,"H"
NA,1988,"Stafford Rangers","Weymouth","1-0",1,0,5,5,1,1,"H"
NA,1988,"Sutton United","Weymouth","3-1",3,1,5,5,4,2,"H"
NA,1988,"Telford United","Weymouth","1-0",1,0,5,5,1,1,"H"
NA,1988,"Welling United","Weymouth","4-0",4,0,5,5,4,4,"H"
NA,1988,"Wycombe Wanderers","Weymouth","0-0",0,0,5,5,0,0,"D"
NA,1988,"Yeovil","Weymouth","2-3",2,3,5,5,5,-1,"A"
NA,1988,"Altrincham","Wycombe Wanderers","2-2",2,2,5,5,4,0,"D"
NA,1988,"Aylesbury United","Wycombe Wanderers","0-2",0,2,5,5,2,-2,"A"
NA,1988,"Barnet","Wycombe Wanderers","1-0",1,0,5,5,1,1,"H"
NA,1988,"Boston United","Wycombe Wanderers","0-1",0,1,5,5,1,-1,"A"
NA,1988,"Cheltenham","Wycombe Wanderers","0-1",0,1,5,5,1,-1,"A"
NA,1988,"Chorley","Wycombe Wanderers","3-2",3,2,5,5,5,1,"H"
NA,1988,"Enfield","Wycombe Wanderers","3-4",3,4,5,5,7,-1,"A"
NA,1988,"Fisher Athletic","Wycombe Wanderers","3-3",3,3,5,5,6,0,"D"
NA,1988,"Kettering Town","Wycombe Wanderers","2-1",2,1,5,5,3,1,"H"
NA,1988,"Kidderminster Harriers","Wycombe Wanderers","2-0",2,0,5,5,2,2,"H"
NA,1988,"Macclesfield","Wycombe Wanderers","0-1",0,1,5,5,1,-1,"A"
NA,1988,"Maidstone United","Wycombe Wanderers","1-3",1,3,5,5,4,-2,"A"
NA,1988,"Northwich Victoria","Wycombe Wanderers","2-3",2,3,5,5,5,-1,"A"
NA,1988,"Runcorn","Wycombe Wanderers","2-3",2,3,5,5,5,-1,"A"
NA,1988,"Stafford Rangers","Wycombe Wanderers","1-1",1,1,5,5,2,0,"D"
NA,1988,"Sutton United","Wycombe Wanderers","3-0",3,0,5,5,3,3,"H"
NA,1988,"Telford United","Wycombe Wanderers","1-2",1,2,5,5,3,-1,"A"
NA,1988,"Welling United","Wycombe Wanderers","0-1",0,1,5,5,1,-1,"A"
NA,1988,"Weymouth","Wycombe Wanderers","0-3",0,3,5,5,3,-3,"A"
NA,1988,"Yeovil","Wycombe Wanderers","1-1",1,1,5,5,2,0,"D"
NA,1988,"Altrincham","Yeovil","2-2",2,2,5,5,4,0,"D"
NA,1988,"Aylesbury United","Yeovil","3-2",3,2,5,5,5,1,"H"
NA,1988,"Barnet","Yeovil","2-0",2,0,5,5,2,2,"H"
NA,1988,"Boston United","Yeovil","1-1",1,1,5,5,2,0,"D"
NA,1988,"Cheltenham","Yeovil","1-1",1,1,5,5,2,0,"D"
NA,1988,"Chorley","Yeovil","2-3",2,3,5,5,5,-1,"A"
NA,1988,"Enfield","Yeovil","1-1",1,1,5,5,2,0,"D"
NA,1988,"Fisher Athletic","Yeovil","4-2",4,2,5,5,6,2,"H"
NA,1988,"Kettering Town","Yeovil","1-0",1,0,5,5,1,1,"H"
NA,1988,"Kidderminster Harriers","Yeovil","2-2",2,2,5,5,4,0,"D"
NA,1988,"Macclesfield","Yeovil","2-3",2,3,5,5,5,-1,"A"
NA,1988,"Maidstone United","Yeovil","5-0",5,0,5,5,5,5,"H"
NA,1988,"Northwich Victoria","Yeovil","1-2",1,2,5,5,3,-1,"A"
NA,1988,"Runcorn","Yeovil","2-1",2,1,5,5,3,1,"H"
NA,1988,"Stafford Rangers","Yeovil","2-6",2,6,5,5,8,-4,"A"
NA,1988,"Sutton United","Yeovil","5-2",5,2,5,5,7,3,"H"
NA,1988,"Telford United","Yeovil","0-1",0,1,5,5,1,-1,"A"
NA,1988,"Welling United","Yeovil","0-2",0,2,5,5,2,-2,"A"
NA,1988,"Weymouth","Yeovil","0-2",0,2,5,5,2,-2,"A"
NA,1988,"Wycombe Wanderers","Yeovil","1-1",1,1,5,5,2,0,"D"
NA,1989,"Barnet","Altrincham","1-0",1,0,5,5,1,1,"H"
NA,1989,"Barrow","Altrincham","1-1",1,1,5,5,2,0,"D"
NA,1989,"Boston United","Altrincham","2-3",2,3,5,5,5,-1,"A"
NA,1989,"Cheltenham","Altrincham","0-0",0,0,5,5,0,0,"D"
NA,1989,"Chorley","Altrincham","2-1",2,1,5,5,3,1,"H"
NA,1989,"Darlington","Altrincham","2-0",2,0,5,5,2,2,"H"
NA,1989,"Enfield","Altrincham","2-1",2,1,5,5,3,1,"H"
NA,1989,"Farnborough Town","Altrincham","0-0",0,0,5,5,0,0,"D"
NA,1989,"Fisher Athletic","Altrincham","3-0",3,0,5,5,3,3,"H"
NA,1989,"Kettering Town","Altrincham","3-0",3,0,5,5,3,3,"H"
NA,1989,"Kidderminster Harriers","Altrincham","1-2",1,2,5,5,3,-1,"A"
NA,1989,"Macclesfield","Altrincham","1-0",1,0,5,5,1,1,"H"
NA,1989,"Merthyr Tydfil","Altrincham","0-0",0,0,5,5,0,0,"D"
NA,1989,"Northwich Victoria","Altrincham","2-3",2,3,5,5,5,-1,"A"
NA,1989,"Runcorn","Altrincham","0-0",0,0,5,5,0,0,"D"
NA,1989,"Stafford Rangers","Altrincham","3-1",3,1,5,5,4,2,"H"
NA,1989,"Sutton United","Altrincham","2-1",2,1,5,5,3,1,"H"
NA,1989,"Telford United","Altrincham","1-3",1,3,5,5,4,-2,"A"
NA,1989,"Welling United","Altrincham","1-1",1,1,5,5,2,0,"D"
NA,1989,"Wycombe Wanderers","Altrincham","1-1",1,1,5,5,2,0,"D"
NA,1989,"Yeovil","Altrincham","0-0",0,0,5,5,0,0,"D"
NA,1989,"Altrincham","Barnet","2-1",2,1,5,5,3,1,"H"
NA,1989,"Barrow","Barnet","1-1",1,1,5,5,2,0,"D"
NA,1989,"Boston United","Barnet","1-2",1,2,5,5,3,-1,"A"
NA,1989,"Cheltenham","Barnet","1-0",1,0,5,5,1,1,"H"
NA,1989,"Chorley","Barnet","1-4",1,4,5,5,5,-3,"A"
NA,1989,"Darlington","Barnet","1-2",1,2,5,5,3,-1,"A"
NA,1989,"Enfield","Barnet","1-3",1,3,5,5,4,-2,"A"
NA,1989,"Farnborough Town","Barnet","0-1",0,1,5,5,1,-1,"A"
NA,1989,"Fisher Athletic","Barnet","1-2",1,2,5,5,3,-1,"A"
NA,1989,"Kettering Town","Barnet","3-2",3,2,5,5,5,1,"H"
NA,1989,"Kidderminster Harriers","Barnet","0-1",0,1,5,5,1,-1,"A"
NA,1989,"Macclesfield","Barnet","0-1",0,1,5,5,1,-1,"A"
NA,1989,"Merthyr Tydfil","Barnet","2-1",2,1,5,5,3,1,"H"
NA,1989,"Northwich Victoria","Barnet","0-2",0,2,5,5,2,-2,"A"
NA,1989,"Runcorn","Barnet","2-2",2,2,5,5,4,0,"D"
NA,1989,"Stafford Rangers","Barnet","1-1",1,1,5,5,2,0,"D"
NA,1989,"Sutton United","Barnet","1-3",1,3,5,5,4,-2,"A"
NA,1989,"Telford United","Barnet","1-3",1,3,5,5,4,-2,"A"
NA,1989,"Welling United","Barnet","3-1",3,1,5,5,4,2,"H"
NA,1989,"Wycombe Wanderers","Barnet","1-0",1,0,5,5,1,1,"H"
NA,1989,"Yeovil","Barnet","3-2",3,2,5,5,5,1,"H"
NA,1989,"Altrincham","Barrow","1-1",1,1,5,5,2,0,"D"
NA,1989,"Barnet","Barrow","1-0",1,0,5,5,1,1,"H"
NA,1989,"Boston United","Barrow","2-1",2,1,5,5,3,1,"H"
NA,1989,"Cheltenham","Barrow","1-0",1,0,5,5,1,1,"H"
NA,1989,"Chorley","Barrow","0-1",0,1,5,5,1,-1,"A"
NA,1989,"Darlington","Barrow","0-0",0,0,5,5,0,0,"D"
NA,1989,"Enfield","Barrow","3-0",3,0,5,5,3,3,"H"
NA,1989,"Farnborough Town","Barrow","3-0",3,0,5,5,3,3,"H"
NA,1989,"Fisher Athletic","Barrow","4-0",4,0,5,5,4,4,"H"
NA,1989,"Kettering Town","Barrow","2-0",2,0,5,5,2,2,"H"
NA,1989,"Kidderminster Harriers","Barrow","2-2",2,2,5,5,4,0,"D"
NA,1989,"Macclesfield","Barrow","2-1",2,1,5,5,3,1,"H"
NA,1989,"Merthyr Tydfil","Barrow","3-3",3,3,5,5,6,0,"D"
NA,1989,"Northwich Victoria","Barrow","1-0",1,0,5,5,1,1,"H"
NA,1989,"Runcorn","Barrow","4-3",4,3,5,5,7,1,"H"
NA,1989,"Stafford Rangers","Barrow","1-1",1,1,5,5,2,0,"D"
NA,1989,"Sutton United","Barrow","3-3",3,3,5,5,6,0,"D"
NA,1989,"Telford United","Barrow","3-0",3,0,5,5,3,3,"H"
NA,1989,"Welling United","Barrow","0-0",0,0,5,5,0,0,"D"
NA,1989,"Wycombe Wanderers","Barrow","4-0",4,0,5,5,4,4,"H"
NA,1989,"Yeovil","Barrow","2-2",2,2,5,5,4,0,"D"
NA,1989,"Altrincham","Boston United","0-0",0,0,5,5,0,0,"D"
NA,1989,"Barnet","Boston United","1-2",1,2,5,5,3,-1,"A"
NA,1989,"Barrow","Boston United","2-1",2,1,5,5,3,1,"H"
NA,1989,"Cheltenham","Boston United","0-0",0,0,5,5,0,0,"D"
NA,1989,"Chorley","Boston United","0-0",0,0,5,5,0,0,"D"
NA,1989,"Darlington","Boston United","6-1",6,1,5,5,7,5,"H"
NA,1989,"Enfield","Boston United","0-1",0,1,5,5,1,-1,"A"
NA,1989,"Farnborough Town","Boston United","1-0",1,0,5,5,1,1,"H"
NA,1989,"Fisher Athletic","Boston United","1-0",1,0,5,5,1,1,"H"
NA,1989,"Kettering Town","Boston United","5-0",5,0,5,5,5,5,"H"
NA,1989,"Kidderminster Harriers","Boston United","1-3",1,3,5,5,4,-2,"A"
NA,1989,"Macclesfield","Boston United","0-0",0,0,5,5,0,0,"D"
NA,1989,"Merthyr Tydfil","Boston United","1-0",1,0,5,5,1,1,"H"
NA,1989,"Northwich Victoria","Boston United","1-0",1,0,5,5,1,1,"H"
NA,1989,"Runcorn","Boston United","3-1",3,1,5,5,4,2,"H"
NA,1989,"Stafford Rangers","Boston United","0-0",0,0,5,5,0,0,"D"
NA,1989,"Sutton United","Boston United","2-0",2,0,5,5,2,2,"H"
NA,1989,"Telford United","Boston United","4-2",4,2,5,5,6,2,"H"
NA,1989,"Welling United","Boston United","6-0",6,0,5,5,6,6,"H"
NA,1989,"Wycombe Wanderers","Boston United","1-0",1,0,5,5,1,1,"H"
NA,1989,"Yeovil","Boston United","2-1",2,1,5,5,3,1,"H"
NA,1989,"Altrincham","Cheltenham","5-0",5,0,5,5,5,5,"H"
NA,1989,"Barnet","Cheltenham","4-0",4,0,5,5,4,4,"H"
NA,1989,"Barrow","Cheltenham","2-1",2,1,5,5,3,1,"H"
NA,1989,"Boston United","Cheltenham","2-1",2,1,5,5,3,1,"H"
NA,1989,"Chorley","Cheltenham","0-2",0,2,5,5,2,-2,"A"
NA,1989,"Darlington","Cheltenham","5-1",5,1,5,5,6,4,"H"
NA,1989,"Enfield","Cheltenham","4-2",4,2,5,5,6,2,"H"
NA,1989,"Farnborough Town","Cheltenham","4-0",4,0,5,5,4,4,"H"
NA,1989,"Fisher Athletic","Cheltenham","2-5",2,5,5,5,7,-3,"A"
NA,1989,"Kettering Town","Cheltenham","1-0",1,0,5,5,1,1,"H"
NA,1989,"Kidderminster Harriers","Cheltenham","1-2",1,2,5,5,3,-1,"A"
NA,1989,"Macclesfield","Cheltenham","3-0",3,0,5,5,3,3,"H"
NA,1989,"Merthyr Tydfil","Cheltenham","1-1",1,1,5,5,2,0,"D"
NA,1989,"Northwich Victoria","Cheltenham","0-0",0,0,5,5,0,0,"D"
NA,1989,"Runcorn","Cheltenham","2-4",2,4,5,5,6,-2,"A"
NA,1989,"Stafford Rangers","Cheltenham","0-1",0,1,5,5,1,-1,"A"
NA,1989,"Sutton United","Cheltenham","0-2",0,2,5,5,2,-2,"A"
NA,1989,"Telford United","Cheltenham","0-0",0,0,5,5,0,0,"D"
NA,1989,"Welling United","Cheltenham","1-1",1,1,5,5,2,0,"D"
NA,1989,"Wycombe Wanderers","Cheltenham","0-4",0,4,5,5,4,-4,"A"
NA,1989,"Yeovil","Cheltenham","1-1",1,1,5,5,2,0,"D"
NA,1989,"Altrincham","Chorley","1-0",1,0,5,5,1,1,"H"
NA,1989,"Barnet","Chorley","5-0",5,0,5,5,5,5,"H"
NA,1989,"Barrow","Chorley","3-1",3,1,5,5,4,2,"H"
NA,1989,"Boston United","Chorley","0-1",0,1,5,5,1,-1,"A"
NA,1989,"Cheltenham","Chorley","2-0",2,0,5,5,2,2,"H"
NA,1989,"Darlington","Chorley","3-0",3,0,5,5,3,3,"H"
NA,1989,"Enfield","Chorley","2-0",2,0,5,5,2,2,"H"
NA,1989,"Farnborough Town","Chorley","1-3",1,3,5,5,4,-2,"A"
NA,1989,"Fisher Athletic","Chorley","2-0",2,0,5,5,2,2,"H"
NA,1989,"Kettering Town","Chorley","2-1",2,1,5,5,3,1,"H"
NA,1989,"Kidderminster Harriers","Chorley","3-1",3,1,5,5,4,2,"H"
NA,1989,"Macclesfield","Chorley","0-0",0,0,5,5,0,0,"D"
NA,1989,"Merthyr Tydfil","Chorley","1-0",1,0,5,5,1,1,"H"
NA,1989,"Northwich Victoria","Chorley","0-1",0,1,5,5,1,-1,"A"
NA,1989,"Runcorn","Chorley","3-2",3,2,5,5,5,1,"H"
NA,1989,"Stafford Rangers","Chorley","1-0",1,0,5,5,1,1,"H"
NA,1989,"Sutton United","Chorley","3-0",3,0,5,5,3,3,"H"
NA,1989,"Telford United","Chorley","0-4",0,4,5,5,4,-4,"A"
NA,1989,"Welling United","Chorley","3-1",3,1,5,5,4,2,"H"
NA,1989,"Wycombe Wanderers","Chorley","4-0",4,0,5,5,4,4,"H"
NA,1989,"Yeovil","Chorley","2-1",2,1,5,5,3,1,"H"
NA,1989,"Altrincham","Darlington","0-1",0,1,5,5,1,-1,"A"
NA,1989,"Barnet","Darlington","0-2",0,2,5,5,2,-2,"A"
NA,1989,"Barrow","Darlington","1-1",1,1,5,5,2,0,"D"
NA,1989,"Boston United","Darlington","1-3",1,3,5,5,4,-2,"A"
NA,1989,"Cheltenham","Darlington","0-1",0,1,5,5,1,-1,"A"
NA,1989,"Chorley","Darlington","0-3",0,3,5,5,3,-3,"A"
NA,1989,"Enfield","Darlington","0-3",0,3,5,5,3,-3,"A"
NA,1989,"Farnborough Town","Darlington","1-0",1,0,5,5,1,1,"H"
NA,1989,"Fisher Athletic","Darlington","0-2",0,2,5,5,2,-2,"A"
NA,1989,"Kettering Town","Darlington","1-3",1,3,5,5,4,-2,"A"
NA,1989,"Kidderminster Harriers","Darlington","3-2",3,2,5,5,5,1,"H"
NA,1989,"Macclesfield","Darlington","0-0",0,0,5,5,0,0,"D"
NA,1989,"Merthyr Tydfil","Darlington","1-1",1,1,5,5,2,0,"D"
NA,1989,"Northwich Victoria","Darlington","1-0",1,0,5,5,1,1,"H"
NA,1989,"Runcorn","Darlington","2-1",2,1,5,5,3,1,"H"
NA,1989,"Stafford Rangers","Darlington","0-4",0,4,5,5,4,-4,"A"
NA,1989,"Sutton United","Darlington","2-1",2,1,5,5,3,1,"H"
NA,1989,"Telford United","Darlington","0-1",0,1,5,5,1,-1,"A"
NA,1989,"Welling United","Darlington","0-1",0,1,5,5,1,-1,"A"
NA,1989,"Wycombe Wanderers","Darlington","0-1",0,1,5,5,1,-1,"A"
NA,1989,"Yeovil","Darlington","0-2",0,2,5,5,2,-2,"A"
NA,1989,"Altrincham","Enfield","3-0",3,0,5,5,3,3,"H"
NA,1989,"Barnet","Enfield","2-0",2,0,5,5,2,2,"H"
NA,1989,"Barrow","Enfield","2-2",2,2,5,5,4,0,"D"
NA,1989,"Boston United","Enfield","1-0",1,0,5,5,1,1,"H"
NA,1989,"Cheltenham","Enfield","3-1",3,1,5,5,4,2,"H"
NA,1989,"Chorley","Enfield","2-2",2,2,5,5,4,0,"D"
NA,1989,"Darlington","Enfield","2-1",2,1,5,5,3,1,"H"
NA,1989,"Farnborough Town","Enfield","2-3",2,3,5,5,5,-1,"A"
NA,1989,"Fisher Athletic","Enfield","3-2",3,2,5,5,5,1,"H"
NA,1989,"Kettering Town","Enfield","3-2",3,2,5,5,5,1,"H"
NA,1989,"Kidderminster Harriers","Enfield","2-0",2,0,5,5,2,2,"H"
NA,1989,"Macclesfield","Enfield","4-0",4,0,5,5,4,4,"H"
NA,1989,"Merthyr Tydfil","Enfield","5-1",5,1,5,5,6,4,"H"
NA,1989,"Northwich Victoria","Enfield","1-0",1,0,5,5,1,1,"H"
NA,1989,"Runcorn","Enfield","9-0",9,0,5,5,9,9,"H"
NA,1989,"Stafford Rangers","Enfield","1-0",1,0,5,5,1,1,"H"
NA,1989,"Sutton United","Enfield","2-0",2,0,5,5,2,2,"H"
NA,1989,"Telford United","Enfield","1-1",1,1,5,5,2,0,"D"
NA,1989,"Welling United","Enfield","3-0",3,0,5,5,3,3,"H"
NA,1989,"Wycombe Wanderers","Enfield","1-0",1,0,5,5,1,1,"H"
NA,1989,"Yeovil","Enfield","3-1",3,1,5,5,4,2,"H"
NA,1989,"Altrincham","Farnborough Town","2-3",2,3,5,5,5,-1,"A"
NA,1989,"Barnet","Farnborough Town","4-1",4,1,5,5,5,3,"H"
NA,1989,"Barrow","Farnborough Town","3-1",3,1,5,5,4,2,"H"
NA,1989,"Boston United","Farnborough Town","2-2",2,2,5,5,4,0,"D"
NA,1989,"Cheltenham","Farnborough Town","4-0",4,0,5,5,4,4,"H"
NA,1989,"Chorley","Farnborough Town","1-0",1,0,5,5,1,1,"H"
NA,1989,"Darlington","Farnborough Town","1-1",1,1,5,5,2,0,"D"
NA,1989,"Enfield","Farnborough Town","0-0",0,0,5,5,0,0,"D"
NA,1989,"Fisher Athletic","Farnborough Town","4-2",4,2,5,5,6,2,"H"
NA,1989,"Kettering Town","Farnborough Town","1-1",1,1,5,5,2,0,"D"
NA,1989,"Kidderminster Harriers","Farnborough Town","3-1",3,1,5,5,4,2,"H"
NA,1989,"Macclesfield","Farnborough Town","0-0",0,0,5,5,0,0,"D"
NA,1989,"Merthyr Tydfil","Farnborough Town","1-1",1,1,5,5,2,0,"D"
NA,1989,"Northwich Victoria","Farnborough Town","0-2",0,2,5,5,2,-2,"A"
NA,1989,"Runcorn","Farnborough Town","3-2",3,2,5,5,5,1,"H"
NA,1989,"Stafford Rangers","Farnborough Town","3-2",3,2,5,5,5,1,"H"
NA,1989,"Sutton United","Farnborough Town","2-3",2,3,5,5,5,-1,"A"
NA,1989,"Telford United","Farnborough Town","4-2",4,2,5,5,6,2,"H"
NA,1989,"Welling United","Farnborough Town","4-3",4,3,5,5,7,1,"H"
NA,1989,"Wycombe Wanderers","Farnborough Town","1-0",1,0,5,5,1,1,"H"
NA,1989,"Yeovil","Farnborough Town","0-0",0,0,5,5,0,0,"D"
NA,1989,"Altrincham","Fisher Athletic","1-1",1,1,5,5,2,0,"D"
NA,1989,"Barnet","Fisher Athletic","4-1",4,1,5,5,5,3,"H"
NA,1989,"Barrow","Fisher Athletic","1-1",1,1,5,5,2,0,"D"
NA,1989,"Boston United","Fisher Athletic","2-0",2,0,5,5,2,2,"H"
NA,1989,"Cheltenham","Fisher Athletic","0-0",0,0,5,5,0,0,"D"
NA,1989,"Chorley","Fisher Athletic","2-0",2,0,5,5,2,2,"H"
NA,1989,"Darlington","Fisher Athletic","5-0",5,0,5,5,5,5,"H"
NA,1989,"Enfield","Fisher Athletic","1-2",1,2,5,5,3,-1,"A"
NA,1989,"Farnborough Town","Fisher Athletic","1-1",1,1,5,5,2,0,"D"
NA,1989,"Kettering Town","Fisher Athletic","3-0",3,0,5,5,3,3,"H"
NA,1989,"Kidderminster Harriers","Fisher Athletic","1-1",1,1,5,5,2,0,"D"
NA,1989,"Macclesfield","Fisher Athletic","0-1",0,1,5,5,1,-1,"A"
NA,1989,"Merthyr Tydfil","Fisher Athletic","1-4",1,4,5,5,5,-3,"A"
NA,1989,"Northwich Victoria","Fisher Athletic","2-1",2,1,5,5,3,1,"H"
NA,1989,"Runcorn","Fisher Athletic","4-0",4,0,5,5,4,4,"H"
NA,1989,"Stafford Rangers","Fisher Athletic","1-3",1,3,5,5,4,-2,"A"
NA,1989,"Sutton United","Fisher Athletic","2-1",2,1,5,5,3,1,"H"
NA,1989,"Telford United","Fisher Athletic","3-1",3,1,5,5,4,2,"H"
NA,1989,"Welling United","Fisher Athletic","2-0",2,0,5,5,2,2,"H"
NA,1989,"Wycombe Wanderers","Fisher Athletic","6-1",6,1,5,5,7,5,"H"
NA,1989,"Yeovil","Fisher Athletic","2-2",2,2,5,5,4,0,"D"
NA,1989,"Altrincham","Kettering Town","1-1",1,1,5,5,2,0,"D"
NA,1989,"Barnet","Kettering Town","4-1",4,1,5,5,5,3,"H"
NA,1989,"Barrow","Kettering Town","1-0",1,0,5,5,1,1,"H"
NA,1989,"Boston United","Kettering Town","1-2",1,2,5,5,3,-1,"A"
NA,1989,"Cheltenham","Kettering Town","1-1",1,1,5,5,2,0,"D"
NA,1989,"Chorley","Kettering Town","2-2",2,2,5,5,4,0,"D"
NA,1989,"Darlington","Kettering Town","2-1",2,1,5,5,3,1,"H"
NA,1989,"Enfield","Kettering Town","0-3",0,3,5,5,3,-3,"A"
NA,1989,"Farnborough Town","Kettering Town","1-1",1,1,5,5,2,0,"D"
NA,1989,"Fisher Athletic","Kettering Town","3-1",3,1,5,5,4,2,"H"
NA,1989,"Kidderminster Harriers","Kettering Town","2-3",2,3,5,5,5,-1,"A"
NA,1989,"Macclesfield","Kettering Town","3-1",3,1,5,5,4,2,"H"
NA,1989,"Merthyr Tydfil","Kettering Town","3-2",3,2,5,5,5,1,"H"
NA,1989,"Northwich Victoria","Kettering Town","2-2",2,2,5,5,4,0,"D"
NA,1989,"Runcorn","Kettering Town","3-1",3,1,5,5,4,2,"H"
NA,1989,"Stafford Rangers","Kettering Town","1-1",1,1,5,5,2,0,"D"
NA,1989,"Sutton United","Kettering Town","2-1",2,1,5,5,3,1,"H"
NA,1989,"Telford United","Kettering Town","1-3",1,3,5,5,4,-2,"A"
NA,1989,"Welling United","Kettering Town","3-0",3,0,5,5,3,3,"H"
NA,1989,"Wycombe Wanderers","Kettering Town","2-2",2,2,5,5,4,0,"D"
NA,1989,"Yeovil","Kettering Town","0-2",0,2,5,5,2,-2,"A"
NA,1989,"Altrincham","Kidderminster Harriers","0-1",0,1,5,5,1,-1,"A"
NA,1989,"Barnet","Kidderminster Harriers","2-1",2,1,5,5,3,1,"H"
NA,1989,"Barrow","Kidderminster Harriers","2-1",2,1,5,5,3,1,"H"
NA,1989,"Boston United","Kidderminster Harriers","2-3",2,3,5,5,5,-1,"A"
NA,1989,"Cheltenham","Kidderminster Harriers","2-1",2,1,5,5,3,1,"H"
NA,1989,"Chorley","Kidderminster Harriers","1-0",1,0,5,5,1,1,"H"
NA,1989,"Darlington","Kidderminster Harriers","3-0",3,0,5,5,3,3,"H"
NA,1989,"Enfield","Kidderminster Harriers","2-1",2,1,5,5,3,1,"H"
NA,1989,"Farnborough Town","Kidderminster Harriers","0-1",0,1,5,5,1,-1,"A"
NA,1989,"Fisher Athletic","Kidderminster Harriers","1-1",1,1,5,5,2,0,"D"
NA,1989,"Kettering Town","Kidderminster Harriers","0-2",0,2,5,5,2,-2,"A"
NA,1989,"Macclesfield","Kidderminster Harriers","1-2",1,2,5,5,3,-1,"A"
NA,1989,"Merthyr Tydfil","Kidderminster Harriers","3-1",3,1,5,5,4,2,"H"
NA,1989,"Northwich Victoria","Kidderminster Harriers","1-2",1,2,5,5,3,-1,"A"
NA,1989,"Runcorn","Kidderminster Harriers","2-1",2,1,5,5,3,1,"H"
NA,1989,"Stafford Rangers","Kidderminster Harriers","0-1",0,1,5,5,1,-1,"A"
NA,1989,"Sutton United","Kidderminster Harriers","1-2",1,2,5,5,3,-1,"A"
NA,1989,"Telford United","Kidderminster Harriers","1-1",1,1,5,5,2,0,"D"
NA,1989,"Welling United","Kidderminster Harriers","4-1",4,1,5,5,5,3,"H"
NA,1989,"Wycombe Wanderers","Kidderminster Harriers","3-3",3,3,5,5,6,0,"D"
NA,1989,"Yeovil","Kidderminster Harriers","3-1",3,1,5,5,4,2,"H"
NA,1989,"Altrincham","Macclesfield","0-1",0,1,5,5,1,-1,"A"
NA,1989,"Barnet","Macclesfield","0-0",0,0,5,5,0,0,"D"
NA,1989,"Barrow","Macclesfield","1-1",1,1,5,5,2,0,"D"
NA,1989,"Boston United","Macclesfield","3-0",3,0,5,5,3,3,"H"
NA,1989,"Cheltenham","Macclesfield","2-1",2,1,5,5,3,1,"H"
NA,1989,"Chorley","Macclesfield","0-0",0,0,5,5,0,0,"D"
NA,1989,"Darlington","Macclesfield","1-1",1,1,5,5,2,0,"D"
NA,1989,"Enfield","Macclesfield","1-1",1,1,5,5,2,0,"D"
NA,1989,"Farnborough Town","Macclesfield","1-2",1,2,5,5,3,-1,"A"
NA,1989,"Fisher Athletic","Macclesfield","1-3",1,3,5,5,4,-2,"A"
NA,1989,"Kettering Town","Macclesfield","0-0",0,0,5,5,0,0,"D"
NA,1989,"Kidderminster Harriers","Macclesfield","2-2",2,2,5,5,4,0,"D"
NA,1989,"Merthyr Tydfil","Macclesfield","2-3",2,3,5,5,5,-1,"A"
NA,1989,"Northwich Victoria","Macclesfield","2-0",2,0,5,5,2,2,"H"
NA,1989,"Runcorn","Macclesfield","2-0",2,0,5,5,2,2,"H"
NA,1989,"Stafford Rangers","Macclesfield","4-2",4,2,5,5,6,2,"H"
NA,1989,"Sutton United","Macclesfield","2-1",2,1,5,5,3,1,"H"
NA,1989,"Telford United","Macclesfield","1-0",1,0,5,5,1,1,"H"
NA,1989,"Welling United","Macclesfield","0-1",0,1,5,5,1,-1,"A"
NA,1989,"Wycombe Wanderers","Macclesfield","1-1",1,1,5,5,2,0,"D"
NA,1989,"Yeovil","Macclesfield","0-0",0,0,5,5,0,0,"D"
NA,1989,"Altrincham","Merthyr Tydfil","4-1",4,1,5,5,5,3,"H"
NA,1989,"Barnet","Merthyr Tydfil","4-0",4,0,5,5,4,4,"H"
NA,1989,"Barrow","Merthyr Tydfil","1-5",1,5,5,5,6,-4,"A"
NA,1989,"Boston United","Merthyr Tydfil","2-2",2,2,5,5,4,0,"D"
NA,1989,"Cheltenham","Merthyr Tydfil","0-2",0,2,5,5,2,-2,"A"
NA,1989,"Chorley","Merthyr Tydfil","1-0",1,0,5,5,1,1,"H"
NA,1989,"Darlington","Merthyr Tydfil","0-0",0,0,5,5,0,0,"D"
NA,1989,"Enfield","Merthyr Tydfil","2-0",2,0,5,5,2,2,"H"
NA,1989,"Farnborough Town","Merthyr Tydfil","0-1",0,1,5,5,1,-1,"A"
NA,1989,"Fisher Athletic","Merthyr Tydfil","1-2",1,2,5,5,3,-1,"A"
NA,1989,"Kettering Town","Merthyr Tydfil","2-0",2,0,5,5,2,2,"H"
NA,1989,"Kidderminster Harriers","Merthyr Tydfil","1-2",1,2,5,5,3,-1,"A"
NA,1989,"Macclesfield","Merthyr Tydfil","3-2",3,2,5,5,5,1,"H"
NA,1989,"Northwich Victoria","Merthyr Tydfil","3-1",3,1,5,5,4,2,"H"
NA,1989,"Runcorn","Merthyr Tydfil","1-0",1,0,5,5,1,1,"H"
NA,1989,"Stafford Rangers","Merthyr Tydfil","1-1",1,1,5,5,2,0,"D"
NA,1989,"Sutton United","Merthyr Tydfil","1-1",1,1,5,5,2,0,"D"
NA,1989,"Telford United","Merthyr Tydfil","1-1",1,1,5,5,2,0,"D"
NA,1989,"Welling United","Merthyr Tydfil","0-3",0,3,5,5,3,-3,"A"
NA,1989,"Wycombe Wanderers","Merthyr Tydfil","1-2",1,2,5,5,3,-1,"A"
NA,1989,"Yeovil","Merthyr Tydfil","4-0",4,0,5,5,4,4,"H"
NA,1989,"Altrincham","Northwich Victoria","0-2",0,2,5,5,2,-2,"A"
NA,1989,"Barnet","Northwich Victoria","1-0",1,0,5,5,1,1,"H"
NA,1989,"Barrow","Northwich Victoria","1-0",1,0,5,5,1,1,"H"
NA,1989,"Boston United","Northwich Victoria","1-3",1,3,5,5,4,-2,"A"
NA,1989,"Cheltenham","Northwich Victoria","2-3",2,3,5,5,5,-1,"A"
NA,1989,"Chorley","Northwich Victoria","1-2",1,2,5,5,3,-1,"A"
NA,1989,"Darlington","Northwich Victoria","4-0",4,0,5,5,4,4,"H"
NA,1989,"Enfield","Northwich Victoria","2-0",2,0,5,5,2,2,"H"
NA,1989,"Farnborough Town","Northwich Victoria","0-1",0,1,5,5,1,-1,"A"
NA,1989,"Fisher Athletic","Northwich Victoria","1-0",1,0,5,5,1,1,"H"
NA,1989,"Kettering Town","Northwich Victoria","3-0",3,0,5,5,3,3,"H"
NA,1989,"Kidderminster Harriers","Northwich Victoria","4-0",4,0,5,5,4,4,"H"
NA,1989,"Macclesfield","Northwich Victoria","3-1",3,1,5,5,4,2,"H"
NA,1989,"Merthyr Tydfil","Northwich Victoria","1-1",1,1,5,5,2,0,"D"
NA,1989,"Runcorn","Northwich Victoria","2-1",2,1,5,5,3,1,"H"
NA,1989,"Stafford Rangers","Northwich Victoria","1-0",1,0,5,5,1,1,"H"
NA,1989,"Sutton United","Northwich Victoria","2-1",2,1,5,5,3,1,"H"
NA,1989,"Telford United","Northwich Victoria","2-1",2,1,5,5,3,1,"H"
NA,1989,"Welling United","Northwich Victoria","2-0",2,0,5,5,2,2,"H"
NA,1989,"Wycombe Wanderers","Northwich Victoria","3-3",3,3,5,5,6,0,"D"
NA,1989,"Yeovil","Northwich Victoria","1-2",1,2,5,5,3,-1,"A"
NA,1989,"Altrincham","Runcorn","1-2",1,2,5,5,3,-1,"A"
NA,1989,"Barnet","Runcorn","2-2",2,2,5,5,4,0,"D"
NA,1989,"Barrow","Runcorn","2-2",2,2,5,5,4,0,"D"
NA,1989,"Boston United","Runcorn","3-2",3,2,5,5,5,1,"H"
NA,1989,"Cheltenham","Runcorn","2-2",2,2,5,5,4,0,"D"
NA,1989,"Chorley","Runcorn","0-2",0,2,5,5,2,-2,"A"
NA,1989,"Darlington","Runcorn","1-1",1,1,5,5,2,0,"D"
NA,1989,"Enfield","Runcorn","3-2",3,2,5,5,5,1,"H"
NA,1989,"Farnborough Town","Runcorn","6-3",6,3,5,5,9,3,"H"
NA,1989,"Fisher Athletic","Runcorn","0-1",0,1,5,5,1,-1,"A"
NA,1989,"Kettering Town","Runcorn","1-1",1,1,5,5,2,0,"D"
NA,1989,"Kidderminster Harriers","Runcorn","0-0",0,0,5,5,0,0,"D"
NA,1989,"Macclesfield","Runcorn","4-0",4,0,5,5,4,4,"H"
NA,1989,"Merthyr Tydfil","Runcorn","3-2",3,2,5,5,5,1,"H"
NA,1989,"Northwich Victoria","Runcorn","1-1",1,1,5,5,2,0,"D"
NA,1989,"Stafford Rangers","Runcorn","1-1",1,1,5,5,2,0,"D"
NA,1989,"Sutton United","Runcorn","3-0",3,0,5,5,3,3,"H"
NA,1989,"Telford United","Runcorn","2-1",2,1,5,5,3,1,"H"
NA,1989,"Welling United","Runcorn","1-1",1,1,5,5,2,0,"D"
NA,1989,"Wycombe Wanderers","Runcorn","5-0",5,0,5,5,5,5,"H"
NA,1989,"Yeovil","Runcorn","1-1",1,1,5,5,2,0,"D"
NA,1989,"Altrincham","Stafford Rangers","3-1",3,1,5,5,4,2,"H"
NA,1989,"Barnet","Stafford Rangers","1-1",1,1,5,5,2,0,"D"
NA,1989,"Barrow","Stafford Rangers","2-1",2,1,5,5,3,1,"H"
NA,1989,"Boston United","Stafford Rangers","3-0",3,0,5,5,3,3,"H"
NA,1989,"Cheltenham","Stafford Rangers","1-3",1,3,5,5,4,-2,"A"
NA,1989,"Chorley","Stafford Rangers","1-1",1,1,5,5,2,0,"D"
NA,1989,"Darlington","Stafford Rangers","2-1",2,1,5,5,3,1,"H"
NA,1989,"Enfield","Stafford Rangers","4-1",4,1,5,5,5,3,"H"
NA,1989,"Farnborough Town","Stafford Rangers","3-3",3,3,5,5,6,0,"D"
NA,1989,"Fisher Athletic","Stafford Rangers","0-2",0,2,5,5,2,-2,"A"
NA,1989,"Kettering Town","Stafford Rangers","0-0",0,0,5,5,0,0,"D"
NA,1989,"Kidderminster Harriers","Stafford Rangers","3-0",3,0,5,5,3,3,"H"
NA,1989,"Macclesfield","Stafford Rangers","2-2",2,2,5,5,4,0,"D"
NA,1989,"Merthyr Tydfil","Stafford Rangers","4-3",4,3,5,5,7,1,"H"
NA,1989,"Northwich Victoria","Stafford Rangers","4-3",4,3,5,5,7,1,"H"
NA,1989,"Runcorn","Stafford Rangers","3-0",3,0,5,5,3,3,"H"
NA,1989,"Sutton United","Stafford Rangers","1-0",1,0,5,5,1,1,"H"
NA,1989,"Telford United","Stafford Rangers","0-2",0,2,5,5,2,-2,"A"
NA,1989,"Welling United","Stafford Rangers","1-0",1,0,5,5,1,1,"H"
NA,1989,"Wycombe Wanderers","Stafford Rangers","2-1",2,1,5,5,3,1,"H"
NA,1989,"Yeovil","Stafford Rangers","0-0",0,0,5,5,0,0,"D"
NA,1989,"Altrincham","Sutton United","0-0",0,0,5,5,0,0,"D"
NA,1989,"Barnet","Sutton United","4-1",4,1,5,5,5,3,"H"
NA,1989,"Barrow","Sutton United","1-0",1,0,5,5,1,1,"H"
NA,1989,"Boston United","Sutton United","3-1",3,1,5,5,4,2,"H"
NA,1989,"Cheltenham","Sutton United","2-0",2,0,5,5,2,2,"H"
NA,1989,"Chorley","Sutton United","3-2",3,2,5,5,5,1,"H"
NA,1989,"Darlington","Sutton United","2-0",2,0,5,5,2,2,"H"
NA,1989,"Enfield","Sutton United","2-3",2,3,5,5,5,-1,"A"
NA,1989,"Farnborough Town","Sutton United","1-3",1,3,5,5,4,-2,"A"
NA,1989,"Fisher Athletic","Sutton United","1-2",1,2,5,5,3,-1,"A"
NA,1989,"Kettering Town","Sutton United","2-0",2,0,5,5,2,2,"H"
NA,1989,"Kidderminster Harriers","Sutton United","2-2",2,2,5,5,4,0,"D"
NA,1989,"Macclesfield","Sutton United","1-1",1,1,5,5,2,0,"D"
NA,1989,"Merthyr Tydfil","Sutton United","2-3",2,3,5,5,5,-1,"A"
NA,1989,"Northwich Victoria","Sutton United","2-3",2,3,5,5,5,-1,"A"
NA,1989,"Runcorn","Sutton United","1-0",1,0,5,5,1,1,"H"
NA,1989,"Stafford Rangers","Sutton United","3-1",3,1,5,5,4,2,"H"
NA,1989,"Telford United","Sutton United","1-1",1,1,5,5,2,0,"D"
NA,1989,"Welling United","Sutton United","1-0",1,0,5,5,1,1,"H"
NA,1989,"Wycombe Wanderers","Sutton United","3-2",3,2,5,5,5,1,"H"
NA,1989,"Yeovil","Sutton United","3-1",3,1,5,5,4,2,"H"
NA,1989,"Altrincham","Telford United","0-1",0,1,5,5,1,-1,"A"
NA,1989,"Barnet","Telford United","2-1",2,1,5,5,3,1,"H"
NA,1989,"Barrow","Telford United","3-0",3,0,5,5,3,3,"H"
NA,1989,"Boston United","Telford United","2-2",2,2,5,5,4,0,"D"
NA,1989,"Cheltenham","Telford United","1-2",1,2,5,5,3,-1,"A"
NA,1989,"Chorley","Telford United","1-2",1,2,5,5,3,-1,"A"
NA,1989,"Darlington","Telford United","1-1",1,1,5,5,2,0,"D"
NA,1989,"Enfield","Telford United","1-2",1,2,5,5,3,-1,"A"
NA,1989,"Farnborough Town","Telford United","2-1",2,1,5,5,3,1,"H"
NA,1989,"Fisher Athletic","Telford United","1-3",1,3,5,5,4,-2,"A"
NA,1989,"Kettering Town","Telford United","1-1",1,1,5,5,2,0,"D"
NA,1989,"Kidderminster Harriers","Telford United","2-4",2,4,5,5,6,-2,"A"
NA,1989,"Macclesfield","Telford United","3-0",3,0,5,5,3,3,"H"
NA,1989,"Merthyr Tydfil","Telford United","0-0",0,0,5,5,0,0,"D"
NA,1989,"Northwich Victoria","Telford United","0-2",0,2,5,5,2,-2,"A"
NA,1989,"Runcorn","Telford United","3-0",3,0,5,5,3,3,"H"
NA,1989,"Stafford Rangers","Telford United","2-0",2,0,5,5,2,2,"H"
NA,1989,"Sutton United","Telford United","6-1",6,1,5,5,7,5,"H"
NA,1989,"Welling United","Telford United","1-1",1,1,5,5,2,0,"D"
NA,1989,"Wycombe Wanderers","Telford United","1-1",1,1,5,5,2,0,"D"
NA,1989,"Yeovil","Telford United","1-0",1,0,5,5,1,1,"H"
NA,1989,"Altrincham","Welling United","4-0",4,0,5,5,4,4,"H"
NA,1989,"Barnet","Welling United","1-1",1,1,5,5,2,0,"D"
NA,1989,"Barrow","Welling United","1-1",1,1,5,5,2,0,"D"
NA,1989,"Boston United","Welling United","2-1",2,1,5,5,3,1,"H"
NA,1989,"Cheltenham","Welling United","3-2",3,2,5,5,5,1,"H"
NA,1989,"Chorley","Welling United","4-0",4,0,5,5,4,4,"H"
NA,1989,"Darlington","Welling United","1-0",1,0,5,5,1,1,"H"
NA,1989,"Enfield","Welling United","2-3",2,3,5,5,5,-1,"A"
NA,1989,"Farnborough Town","Welling United","3-1",3,1,5,5,4,2,"H"
NA,1989,"Fisher Athletic","Welling United","1-3",1,3,5,5,4,-2,"A"
NA,1989,"Kettering Town","Welling United","0-1",0,1,5,5,1,-1,"A"
NA,1989,"Kidderminster Harriers","Welling United","1-1",1,1,5,5,2,0,"D"
NA,1989,"Macclesfield","Welling United","3-2",3,2,5,5,5,1,"H"
NA,1989,"Merthyr Tydfil","Welling United","4-0",4,0,5,5,4,4,"H"
NA,1989,"Northwich Victoria","Welling United","2-3",2,3,5,5,5,-1,"A"
NA,1989,"Runcorn","Welling United","0-1",0,1,5,5,1,-1,"A"
NA,1989,"Stafford Rangers","Welling United","0-2",0,2,5,5,2,-2,"A"
NA,1989,"Sutton United","Welling United","1-0",1,0,5,5,1,1,"H"
NA,1989,"Telford United","Welling United","0-0",0,0,5,5,0,0,"D"
NA,1989,"Wycombe Wanderers","Welling United","1-0",1,0,5,5,1,1,"H"
NA,1989,"Yeovil","Welling United","0-4",0,4,5,5,4,-4,"A"
NA,1989,"Altrincham","Wycombe Wanderers","1-2",1,2,5,5,3,-1,"A"
NA,1989,"Barnet","Wycombe Wanderers","2-0",2,0,5,5,2,2,"H"
NA,1989,"Barrow","Wycombe Wanderers","0-3",0,3,5,5,3,-3,"A"
NA,1989,"Boston United","Wycombe Wanderers","2-0",2,0,5,5,2,2,"H"
NA,1989,"Cheltenham","Wycombe Wanderers","1-1",1,1,5,5,2,0,"D"
NA,1989,"Chorley","Wycombe Wanderers","1-0",1,0,5,5,1,1,"H"
NA,1989,"Darlington","Wycombe Wanderers","0-1",0,1,5,5,1,-1,"A"
NA,1989,"Enfield","Wycombe Wanderers","3-5",3,5,5,5,8,-2,"A"
NA,1989,"Farnborough Town","Wycombe Wanderers","1-1",1,1,5,5,2,0,"D"
NA,1989,"Fisher Athletic","Wycombe Wanderers","3-1",3,1,5,5,4,2,"H"
NA,1989,"Kettering Town","Wycombe Wanderers","1-0",1,0,5,5,1,1,"H"
NA,1989,"Kidderminster Harriers","Wycombe Wanderers","0-2",0,2,5,5,2,-2,"A"
NA,1989,"Macclesfield","Wycombe Wanderers","1-0",1,0,5,5,1,1,"H"
NA,1989,"Merthyr Tydfil","Wycombe Wanderers","1-1",1,1,5,5,2,0,"D"
NA,1989,"Northwich Victoria","Wycombe Wanderers","3-0",3,0,5,5,3,3,"H"
NA,1989,"Runcorn","Wycombe Wanderers","2-0",2,0,5,5,2,2,"H"
NA,1989,"Stafford Rangers","Wycombe Wanderers","1-0",1,0,5,5,1,1,"H"
NA,1989,"Sutton United","Wycombe Wanderers","1-2",1,2,5,5,3,-1,"A"
NA,1989,"Telford United","Wycombe Wanderers","4-1",4,1,5,5,5,3,"H"
NA,1989,"Welling United","Wycombe Wanderers","0-0",0,0,5,5,0,0,"D"
NA,1989,"Yeovil","Wycombe Wanderers","4-2",4,2,5,5,6,2,"H"
NA,1989,"Altrincham","Yeovil","2-1",2,1,5,5,3,1,"H"
NA,1989,"Barnet","Yeovil","1-0",1,0,5,5,1,1,"H"
NA,1989,"Barrow","Yeovil","2-1",2,1,5,5,3,1,"H"
NA,1989,"Boston United","Yeovil","0-1",0,1,5,5,1,-1,"A"
NA,1989,"Cheltenham","Yeovil","2-1",2,1,5,5,3,1,"H"
NA,1989,"Chorley","Yeovil","3-2",3,2,5,5,5,1,"H"
NA,1989,"Darlington","Yeovil","1-0",1,0,5,5,1,1,"H"
NA,1989,"Enfield","Yeovil","1-1",1,1,5,5,2,0,"D"
NA,1989,"Farnborough Town","Yeovil","2-4",2,4,5,5,6,-2,"A"
NA,1989,"Fisher Athletic","Yeovil","1-2",1,2,5,5,3,-1,"A"
NA,1989,"Kettering Town","Yeovil","1-0",1,0,5,5,1,1,"H"
NA,1989,"Kidderminster Harriers","Yeovil","3-2",3,2,5,5,5,1,"H"
NA,1989,"Macclesfield","Yeovil","1-2",1,2,5,5,3,-1,"A"
NA,1989,"Merthyr Tydfil","Yeovil","2-2",2,2,5,5,4,0,"D"
NA,1989,"Northwich Victoria","Yeovil","1-4",1,4,5,5,5,-3,"A"
NA,1989,"Runcorn","Yeovil","1-1",1,1,5,5,2,0,"D"
NA,1989,"Stafford Rangers","Yeovil","0-1",0,1,5,5,1,-1,"A"
NA,1989,"Sutton United","Yeovil","3-1",3,1,5,5,4,2,"H"
NA,1989,"Telford United","Yeovil","1-1",1,1,5,5,2,0,"D"
NA,1989,"Welling United","Yeovil","0-1",0,1,5,5,1,-1,"A"
NA,1989,"Wycombe Wanderers","Yeovil","1-2",1,2,5,5,3,-1,"A"
NA,1990,"Barnet","Altrincham","0-0",0,0,5,5,0,0,"D"
NA,1990,"Barrow","Altrincham","1-0",1,0,5,5,1,1,"H"
NA,1990,"Bath City","Altrincham","2-3",2,3,5,5,5,-1,"A"
NA,1990,"Boston United","Altrincham","2-6",2,6,5,5,8,-4,"A"
NA,1990,"Cheltenham","Altrincham","1-4",1,4,5,5,5,-3,"A"
NA,1990,"Colchester United","Altrincham","1-1",1,1,5,5,2,0,"D"
NA,1990,"Fisher Athletic","Altrincham","0-0",0,0,5,5,0,0,"D"
NA,1990,"Gateshead","Altrincham","0-3",0,3,5,5,3,-3,"A"
NA,1990,"Kettering Town","Altrincham","1-1",1,1,5,5,2,0,"D"
NA,1990,"Kidderminster Harriers","Altrincham","0-1",0,1,5,5,1,-1,"A"
NA,1990,"Macclesfield","Altrincham","0-1",0,1,5,5,1,-1,"A"
NA,1990,"Merthyr Tydfil","Altrincham","0-2",0,2,5,5,2,-2,"A"
NA,1990,"Northwich Victoria","Altrincham","1-1",1,1,5,5,2,0,"D"
NA,1990,"Runcorn","Altrincham","1-3",1,3,5,5,4,-2,"A"
NA,1990,"Slough Town","Altrincham","3-3",3,3,5,5,6,0,"D"
NA,1990,"Stafford Rangers","Altrincham","2-1",2,1,5,5,3,1,"H"
NA,1990,"Sutton United","Altrincham","1-2",1,2,5,5,3,-1,"A"
NA,1990,"Telford United","Altrincham","1-2",1,2,5,5,3,-1,"A"
NA,1990,"Welling United","Altrincham","2-2",2,2,5,5,4,0,"D"
NA,1990,"Wycombe Wanderers","Altrincham","3-0",3,0,5,5,3,3,"H"
NA,1990,"Yeovil","Altrincham","2-3",2,3,5,5,5,-1,"A"
NA,1990,"Altrincham","Barnet","4-1",4,1,5,5,5,3,"H"
NA,1990,"Barrow","Barnet","4-2",4,2,5,5,6,2,"H"
NA,1990,"Bath City","Barnet","1-4",1,4,5,5,5,-3,"A"
NA,1990,"Boston United","Barnet","1-3",1,3,5,5,4,-2,"A"
NA,1990,"Cheltenham","Barnet","1-4",1,4,5,5,5,-3,"A"
NA,1990,"Colchester United","Barnet","0-0",0,0,5,5,0,0,"D"
NA,1990,"Fisher Athletic","Barnet","2-4",2,4,5,5,6,-2,"A"
NA,1990,"Gateshead","Barnet","1-3",1,3,5,5,4,-2,"A"
NA,1990,"Kettering Town","Barnet","1-3",1,3,5,5,4,-2,"A"
NA,1990,"Kidderminster Harriers","Barnet","0-3",0,3,5,5,3,-3,"A"
NA,1990,"Macclesfield","Barnet","3-2",3,2,5,5,5,1,"H"
NA,1990,"Merthyr Tydfil","Barnet","1-1",1,1,5,5,2,0,"D"
NA,1990,"Northwich Victoria","Barnet","0-2",0,2,5,5,2,-2,"A"
NA,1990,"Runcorn","Barnet","3-2",3,2,5,5,5,1,"H"
NA,1990,"Slough Town","Barnet","1-3",1,3,5,5,4,-2,"A"
NA,1990,"Stafford Rangers","Barnet","2-2",2,2,5,5,4,0,"D"
NA,1990,"Sutton United","Barnet","0-1",0,1,5,5,1,-1,"A"
NA,1990,"Telford United","Barnet","1-1",1,1,5,5,2,0,"D"
NA,1990,"Welling United","Barnet","1-4",1,4,5,5,5,-3,"A"
NA,1990,"Wycombe Wanderers","Barnet","1-3",1,3,5,5,4,-2,"A"
NA,1990,"Yeovil","Barnet","1-4",1,4,5,5,5,-3,"A"
NA,1990,"Altrincham","Barrow","1-1",1,1,5,5,2,0,"D"
NA,1990,"Barnet","Barrow","3-1",3,1,5,5,4,2,"H"
NA,1990,"Bath City","Barrow","1-1",1,1,5,5,2,0,"D"
NA,1990,"Boston United","Barrow","0-2",0,2,5,5,2,-2,"A"
NA,1990,"Cheltenham","Barrow","3-1",3,1,5,5,4,2,"H"
NA,1990,"Colchester United","Barrow","1-0",1,0,5,5,1,1,"H"
NA,1990,"Fisher Athletic","Barrow","1-2",1,2,5,5,3,-1,"A"
NA,1990,"Gateshead","Barrow","5-1",5,1,5,5,6,4,"H"
NA,1990,"Kettering Town","Barrow","2-0",2,0,5,5,2,2,"H"
NA,1990,"Kidderminster Harriers","Barrow","3-1",3,1,5,5,4,2,"H"
NA,1990,"Macclesfield","Barrow","3-0",3,0,5,5,3,3,"H"
NA,1990,"Merthyr Tydfil","Barrow","0-2",0,2,5,5,2,-2,"A"
NA,1990,"Northwich Victoria","Barrow","2-2",2,2,5,5,4,0,"D"
NA,1990,"Runcorn","Barrow","3-1",3,1,5,5,4,2,"H"
NA,1990,"Slough Town","Barrow","3-0",3,0,5,5,3,3,"H"
NA,1990,"Stafford Rangers","Barrow","2-2",2,2,5,5,4,0,"D"
NA,1990,"Sutton United","Barrow","2-1",2,1,5,5,3,1,"H"
NA,1990,"Telford United","Barrow","0-1",0,1,5,5,1,-1,"A"
NA,1990,"Welling United","Barrow","4-2",4,2,5,5,6,2,"H"
NA,1990,"Wycombe Wanderers","Barrow","2-1",2,1,5,5,3,1,"H"
NA,1990,"Yeovil","Barrow","0-3",0,3,5,5,3,-3,"A"
NA,1990,"Altrincham","Bath City","2-0",2,0,5,5,2,2,"H"
NA,1990,"Barnet","Bath City","2-0",2,0,5,5,2,2,"H"
NA,1990,"Barrow","Bath City","1-1",1,1,5,5,2,0,"D"
NA,1990,"Boston United","Bath City","3-0",3,0,5,5,3,3,"H"
NA,1990,"Cheltenham","Bath City","0-0",0,0,5,5,0,0,"D"
NA,1990,"Colchester United","Bath City","2-0",2,0,5,5,2,2,"H"
NA,1990,"Fisher Athletic","Bath City","0-3",0,3,5,5,3,-3,"A"
NA,1990,"Gateshead","Bath City","2-0",2,0,5,5,2,2,"H"
NA,1990,"Kettering Town","Bath City","1-1",1,1,5,5,2,0,"D"
NA,1990,"Kidderminster Harriers","Bath City","3-2",3,2,5,5,5,1,"H"
NA,1990,"Macclesfield","Bath City","3-1",3,1,5,5,4,2,"H"
NA,1990,"Merthyr Tydfil","Bath City","0-0",0,0,5,5,0,0,"D"
NA,1990,"Northwich Victoria","Bath City","2-0",2,0,5,5,2,2,"H"
NA,1990,"Runcorn","Bath City","1-1",1,1,5,5,2,0,"D"
NA,1990,"Slough Town","Bath City","2-0",2,0,5,5,2,2,"H"
NA,1990,"Stafford Rangers","Bath City","2-1",2,1,5,5,3,1,"H"
NA,1990,"Sutton United","Bath City","1-1",1,1,5,5,2,0,"D"
NA,1990,"Telford United","Bath City","2-2",2,2,5,5,4,0,"D"
NA,1990,"Welling United","Bath City","2-1",2,1,5,5,3,1,"H"
NA,1990,"Wycombe Wanderers","Bath City","0-0",0,0,5,5,0,0,"D"
NA,1990,"Yeovil","Bath City","3-2",3,2,5,5,5,1,"H"
NA,1990,"Altrincham","Boston United","1-1",1,1,5,5,2,0,"D"
NA,1990,"Barnet","Boston United","5-0",5,0,5,5,5,5,"H"
NA,1990,"Barrow","Boston United","1-1",1,1,5,5,2,0,"D"
NA,1990,"Bath City","Boston United","1-0",1,0,5,5,1,1,"H"
NA,1990,"Cheltenham","Boston United","5-0",5,0,5,5,5,5,"H"
NA,1990,"Colchester United","Boston United","3-1",3,1,5,5,4,2,"H"
NA,1990,"Fisher Athletic","Boston United","1-2",1,2,5,5,3,-1,"A"
NA,1990,"Gateshead","Boston United","0-1",0,1,5,5,1,-1,"A"
NA,1990,"Kettering Town","Boston United","1-1",1,1,5,5,2,0,"D"
NA,1990,"Kidderminster Harriers","Boston United","3-3",3,3,5,5,6,0,"D"
NA,1990,"Macclesfield","Boston United","2-0",2,0,5,5,2,2,"H"
NA,1990,"Merthyr Tydfil","Boston United","2-0",2,0,5,5,2,2,"H"
NA,1990,"Northwich Victoria","Boston United","3-1",3,1,5,5,4,2,"H"
NA,1990,"Runcorn","Boston United","2-1",2,1,5,5,3,1,"H"
NA,1990,"Slough Town","Boston United","2-0",2,0,5,5,2,2,"H"
NA,1990,"Stafford Rangers","Boston United","1-2",1,2,5,5,3,-1,"A"
NA,1990,"Sutton United","Boston United","0-0",0,0,5,5,0,0,"D"
NA,1990,"Telford United","Boston United","1-0",1,0,5,5,1,1,"H"
NA,1990,"Welling United","Boston United","0-0",0,0,5,5,0,0,"D"
NA,1990,"Wycombe Wanderers","Boston United","3-0",3,0,5,5,3,3,"H"
NA,1990,"Yeovil","Boston United","1-1",1,1,5,5,2,0,"D"
NA,1990,"Altrincham","Cheltenham","3-0",3,0,5,5,3,3,"H"
NA,1990,"Barnet","Cheltenham","2-1",2,1,5,5,3,1,"H"
NA,1990,"Barrow","Cheltenham","0-0",0,0,5,5,0,0,"D"
NA,1990,"Bath City","Cheltenham","2-0",2,0,5,5,2,2,"H"
NA,1990,"Boston United","Cheltenham","2-1",2,1,5,5,3,1,"H"
NA,1990,"Colchester United","Cheltenham","3-1",3,1,5,5,4,2,"H"
NA,1990,"Fisher Athletic","Cheltenham","1-1",1,1,5,5,2,0,"D"
NA,1990,"Gateshead","Cheltenham","3-3",3,3,5,5,6,0,"D"
NA,1990,"Kettering Town","Cheltenham","5-1",5,1,5,5,6,4,"H"
NA,1990,"Kidderminster Harriers","Cheltenham","2-0",2,0,5,5,2,2,"H"
NA,1990,"Macclesfield","Cheltenham","5-1",5,1,5,5,6,4,"H"
NA,1990,"Merthyr Tydfil","Cheltenham","3-0",3,0,5,5,3,3,"H"
NA,1990,"Northwich Victoria","Cheltenham","5-2",5,2,5,5,7,3,"H"
NA,1990,"Runcorn","Cheltenham","2-2",2,2,5,5,4,0,"D"
NA,1990,"Slough Town","Cheltenham","0-3",0,3,5,5,3,-3,"A"
NA,1990,"Stafford Rangers","Cheltenham","2-2",2,2,5,5,4,0,"D"
NA,1990,"Sutton United","Cheltenham","2-3",2,3,5,5,5,-1,"A"
NA,1990,"Telford United","Cheltenham","1-2",1,2,5,5,3,-1,"A"
NA,1990,"Welling United","Cheltenham","0-0",0,0,5,5,0,0,"D"
NA,1990,"Wycombe Wanderers","Cheltenham","0-2",0,2,5,5,2,-2,"A"
NA,1990,"Yeovil","Cheltenham","4-0",4,0,5,5,4,4,"H"
NA,1990,"Altrincham","Colchester United","2-2",2,2,5,5,4,0,"D"
NA,1990,"Barnet","Colchester United","1-3",1,3,5,5,4,-2,"A"
NA,1990,"Barrow","Colchester United","2-2",2,2,5,5,4,0,"D"
NA,1990,"Bath City","Colchester United","1-2",1,2,5,5,3,-1,"A"
NA,1990,"Boston United","Colchester United","1-3",1,3,5,5,4,-2,"A"
NA,1990,"Cheltenham","Colchester United","1-2",1,2,5,5,3,-1,"A"
NA,1990,"Fisher Athletic","Colchester United","0-0",0,0,5,5,0,0,"D"
NA,1990,"Gateshead","Colchester United","1-2",1,2,5,5,3,-1,"A"
NA,1990,"Kettering Town","Colchester United","1-0",1,0,5,5,1,1,"H"
NA,1990,"Kidderminster Harriers","Colchester United","0-0",0,0,5,5,0,0,"D"
NA,1990,"Macclesfield","Colchester United","1-0",1,0,5,5,1,1,"H"
NA,1990,"Merthyr Tydfil","Colchester United","3-0",3,0,5,5,3,3,"H"
NA,1990,"Northwich Victoria","Colchester United","2-2",2,2,5,5,4,0,"D"
NA,1990,"Runcorn","Colchester United","0-3",0,3,5,5,3,-3,"A"
NA,1990,"Slough Town","Colchester United","0-2",0,2,5,5,2,-2,"A"
NA,1990,"Stafford Rangers","Colchester United","0-2",0,2,5,5,2,-2,"A"
NA,1990,"Sutton United","Colchester United","0-1",0,1,5,5,1,-1,"A"
NA,1990,"Telford United","Colchester United","2-0",2,0,5,5,2,2,"H"
NA,1990,"Welling United","Colchester United","1-1",1,1,5,5,2,0,"D"
NA,1990,"Wycombe Wanderers","Colchester United","1-0",1,0,5,5,1,1,"H"
NA,1990,"Yeovil","Colchester United","2-0",2,0,5,5,2,2,"H"
NA,1990,"Altrincham","Fisher Athletic","0-0",0,0,5,5,0,0,"D"
NA,1990,"Barnet","Fisher Athletic","8-1",8,1,5,5,9,7,"H"
NA,1990,"Barrow","Fisher Athletic","3-1",3,1,5,5,4,2,"H"
NA,1990,"Bath City","Fisher Athletic","0-1",0,1,5,5,1,-1,"A"
NA,1990,"Boston United","Fisher Athletic","4-1",4,1,5,5,5,3,"H"
NA,1990,"Cheltenham","Fisher Athletic","0-0",0,0,5,5,0,0,"D"
NA,1990,"Colchester United","Fisher Athletic","2-1",2,1,5,5,3,1,"H"
NA,1990,"Gateshead","Fisher Athletic","1-0",1,0,5,5,1,1,"H"
NA,1990,"Kettering Town","Fisher Athletic","3-2",3,2,5,5,5,1,"H"
NA,1990,"Kidderminster Harriers","Fisher Athletic","3-3",3,3,5,5,6,0,"D"
NA,1990,"Macclesfield","Fisher Athletic","1-1",1,1,5,5,2,0,"D"
NA,1990,"Merthyr Tydfil","Fisher Athletic","7-0",7,0,5,5,7,7,"H"
NA,1990,"Northwich Victoria","Fisher Athletic","0-0",0,0,5,5,0,0,"D"
NA,1990,"Runcorn","Fisher Athletic","5-1",5,1,5,5,6,4,"H"
NA,1990,"Slough Town","Fisher Athletic","1-0",1,0,5,5,1,1,"H"
NA,1990,"Stafford Rangers","Fisher Athletic","2-0",2,0,5,5,2,2,"H"
NA,1990,"Sutton United","Fisher Athletic","3-1",3,1,5,5,4,2,"H"
NA,1990,"Telford United","Fisher Athletic","3-1",3,1,5,5,4,2,"H"
NA,1990,"Welling United","Fisher Athletic","1-1",1,1,5,5,2,0,"D"
NA,1990,"Wycombe Wanderers","Fisher Athletic","2-0",2,0,5,5,2,2,"H"
NA,1990,"Yeovil","Fisher Athletic","0-1",0,1,5,5,1,-1,"A"
NA,1990,"Altrincham","Gateshead","4-1",4,1,5,5,5,3,"H"
NA,1990,"Barnet","Gateshead","1-1",1,1,5,5,2,0,"D"
NA,1990,"Barrow","Gateshead","3-1",3,1,5,5,4,2,"H"
NA,1990,"Bath City","Gateshead","3-0",3,0,5,5,3,3,"H"
NA,1990,"Boston United","Gateshead","5-1",5,1,5,5,6,4,"H"
NA,1990,"Cheltenham","Gateshead","1-0",1,0,5,5,1,1,"H"
NA,1990,"Colchester United","Gateshead","3-0",3,0,5,5,3,3,"H"
NA,1990,"Fisher Athletic","Gateshead","0-2",0,2,5,5,2,-2,"A"
NA,1990,"Kettering Town","Gateshead","1-0",1,0,5,5,1,1,"H"
NA,1990,"Kidderminster Harriers","Gateshead","2-3",2,3,5,5,5,-1,"A"
NA,1990,"Macclesfield","Gateshead","4-0",4,0,5,5,4,4,"H"
NA,1990,"Merthyr Tydfil","Gateshead","3-1",3,1,5,5,4,2,"H"
NA,1990,"Northwich Victoria","Gateshead","3-2",3,2,5,5,5,1,"H"
NA,1990,"Runcorn","Gateshead","2-0",2,0,5,5,2,2,"H"
NA,1990,"Slough Town","Gateshead","1-1",1,1,5,5,2,0,"D"
NA,1990,"Stafford Rangers","Gateshead","0-1",0,1,5,5,1,-1,"A"
NA,1990,"Sutton United","Gateshead","3-3",3,3,5,5,6,0,"D"
NA,1990,"Telford United","Gateshead","1-2",1,2,5,5,3,-1,"A"
NA,1990,"Welling United","Gateshead","6-0",6,0,5,5,6,6,"H"
NA,1990,"Wycombe Wanderers","Gateshead","4-0",4,0,5,5,4,4,"H"
NA,1990,"Yeovil","Gateshead","4-1",4,1,5,5,5,3,"H"
NA,1990,"Altrincham","Kettering Town","3-2",3,2,5,5,5,1,"H"
NA,1990,"Barnet","Kettering Town","0-1",0,1,5,5,1,-1,"A"
NA,1990,"Barrow","Kettering Town","0-1",0,1,5,5,1,-1,"A"
NA,1990,"Bath City","Kettering Town","3-3",3,3,5,5,6,0,"D"
NA,1990,"Boston United","Kettering Town","1-2",1,2,5,5,3,-1,"A"
NA,1990,"Cheltenham","Kettering Town","2-2",2,2,5,5,4,0,"D"
NA,1990,"Colchester United","Kettering Town","3-1",3,1,5,5,4,2,"H"
NA,1990,"Fisher Athletic","Kettering Town","0-0",0,0,5,5,0,0,"D"
NA,1990,"Gateshead","Kettering Town","1-2",1,2,5,5,3,-1,"A"
NA,1990,"Kidderminster Harriers","Kettering Town","3-0",3,0,5,5,3,3,"H"
NA,1990,"Macclesfield","Kettering Town","1-2",1,2,5,5,3,-1,"A"
NA,1990,"Merthyr Tydfil","Kettering Town","1-3",1,3,5,5,4,-2,"A"
NA,1990,"Northwich Victoria","Kettering Town","0-1",0,1,5,5,1,-1,"A"
NA,1990,"Runcorn","Kettering Town","2-1",2,1,5,5,3,1,"H"
NA,1990,"Slough Town","Kettering Town","0-3",0,3,5,5,3,-3,"A"
NA,1990,"Stafford Rangers","Kettering Town","0-0",0,0,5,5,0,0,"D"
NA,1990,"Sutton United","Kettering Town","1-2",1,2,5,5,3,-1,"A"
NA,1990,"Telford United","Kettering Town","0-1",0,1,5,5,1,-1,"A"
NA,1990,"Welling United","Kettering Town","0-0",0,0,5,5,0,0,"D"
NA,1990,"Wycombe Wanderers","Kettering Town","5-1",5,1,5,5,6,4,"H"
NA,1990,"Yeovil","Kettering Town","0-1",0,1,5,5,1,-1,"A"
NA,1990,"Altrincham","Kidderminster Harriers","1-2",1,2,5,5,3,-1,"A"
NA,1990,"Barnet","Kidderminster Harriers","2-3",2,3,5,5,5,-1,"A"
NA,1990,"Barrow","Kidderminster Harriers","1-3",1,3,5,5,4,-2,"A"
NA,1990,"Bath City","Kidderminster Harriers","4-1",4,1,5,5,5,3,"H"
NA,1990,"Boston United","Kidderminster Harriers","3-1",3,1,5,5,4,2,"H"
NA,1990,"Cheltenham","Kidderminster Harriers","0-0",0,0,5,5,0,0,"D"
NA,1990,"Colchester United","Kidderminster Harriers","2-0",2,0,5,5,2,2,"H"
NA,1990,"Fisher Athletic","Kidderminster Harriers","1-1",1,1,5,5,2,0,"D"
NA,1990,"Gateshead","Kidderminster Harriers","2-1",2,1,5,5,3,1,"H"
NA,1990,"Kettering Town","Kidderminster Harriers","4-1",4,1,5,5,5,3,"H"
NA,1990,"Macclesfield","Kidderminster Harriers","0-0",0,0,5,5,0,0,"D"
NA,1990,"Merthyr Tydfil","Kidderminster Harriers","1-2",1,2,5,5,3,-1,"A"
NA,1990,"Northwich Victoria","Kidderminster Harriers","1-1",1,1,5,5,2,0,"D"
NA,1990,"Runcorn","Kidderminster Harriers","5-1",5,1,5,5,6,4,"H"
NA,1990,"Slough Town","Kidderminster Harriers","0-0",0,0,5,5,0,0,"D"
NA,1990,"Stafford Rangers","Kidderminster Harriers","3-1",3,1,5,5,4,2,"H"
NA,1990,"Sutton United","Kidderminster Harriers","1-2",1,2,5,5,3,-1,"A"
NA,1990,"Telford United","Kidderminster Harriers","1-0",1,0,5,5,1,1,"H"
NA,1990,"Welling United","Kidderminster Harriers","1-0",1,0,5,5,1,1,"H"
NA,1990,"Wycombe Wanderers","Kidderminster Harriers","2-3",2,3,5,5,5,-1,"A"
NA,1990,"Yeovil","Kidderminster Harriers","2-0",2,0,5,5,2,2,"H"
NA,1990,"Altrincham","Macclesfield","5-2",5,2,5,5,7,3,"H"
NA,1990,"Barnet","Macclesfield","3-1",3,1,5,5,4,2,"H"
NA,1990,"Barrow","Macclesfield","1-1",1,1,5,5,2,0,"D"
NA,1990,"Bath City","Macclesfield","0-2",0,2,5,5,2,-2,"A"
NA,1990,"Boston United","Macclesfield","1-1",1,1,5,5,2,0,"D"
NA,1990,"Cheltenham","Macclesfield","2-2",2,2,5,5,4,0,"D"
NA,1990,"Colchester United","Macclesfield","1-0",1,0,5,5,1,1,"H"
NA,1990,"Fisher Athletic","Macclesfield","1-2",1,2,5,5,3,-1,"A"
NA,1990,"Gateshead","Macclesfield","1-1",1,1,5,5,2,0,"D"
NA,1990,"Kettering Town","Macclesfield","2-0",2,0,5,5,2,2,"H"
NA,1990,"Kidderminster Harriers","Macclesfield","0-0",0,0,5,5,0,0,"D"
NA,1990,"Merthyr Tydfil","Macclesfield","0-2",0,2,5,5,2,-2,"A"
NA,1990,"Northwich Victoria","Macclesfield","4-1",4,1,5,5,5,3,"H"
NA,1990,"Runcorn","Macclesfield","1-2",1,2,5,5,3,-1,"A"
NA,1990,"Slough Town","Macclesfield","0-1",0,1,5,5,1,-1,"A"
NA,1990,"Stafford Rangers","Macclesfield","2-2",2,2,5,5,4,0,"D"
NA,1990,"Sutton United","Macclesfield","3-1",3,1,5,5,4,2,"H"
NA,1990,"Telford United","Macclesfield","1-2",1,2,5,5,3,-1,"A"
NA,1990,"Welling United","Macclesfield","0-0",0,0,5,5,0,0,"D"
NA,1990,"Wycombe Wanderers","Macclesfield","0-0",0,0,5,5,0,0,"D"
NA,1990,"Yeovil","Macclesfield","2-1",2,1,5,5,3,1,"H"
NA,1990,"Altrincham","Merthyr Tydfil","9-2",9,2,5,5,11,7,"H"
NA,1990,"Barnet","Merthyr Tydfil","2-3",2,3,5,5,5,-1,"A"
NA,1990,"Barrow","Merthyr Tydfil","0-2",0,2,5,5,2,-2,"A"
NA,1990,"Bath City","Merthyr Tydfil","0-0",0,0,5,5,0,0,"D"
NA,1990,"Boston United","Merthyr Tydfil","3-0",3,0,5,5,3,3,"H"
NA,1990,"Cheltenham","Merthyr Tydfil","0-1",0,1,5,5,1,-1,"A"
NA,1990,"Colchester United","Merthyr Tydfil","3-1",3,1,5,5,4,2,"H"
NA,1990,"Fisher Athletic","Merthyr Tydfil","0-0",0,0,5,5,0,0,"D"
NA,1990,"Gateshead","Merthyr Tydfil","1-0",1,0,5,5,1,1,"H"
NA,1990,"Kettering Town","Merthyr Tydfil","2-0",2,0,5,5,2,2,"H"
NA,1990,"Kidderminster Harriers","Merthyr Tydfil","1-2",1,2,5,5,3,-1,"A"
NA,1990,"Macclesfield","Merthyr Tydfil","0-1",0,1,5,5,1,-1,"A"
NA,1990,"Northwich Victoria","Merthyr Tydfil","0-3",0,3,5,5,3,-3,"A"
NA,1990,"Runcorn","Merthyr Tydfil","2-1",2,1,5,5,3,1,"H"
NA,1990,"Slough Town","Merthyr Tydfil","1-2",1,2,5,5,3,-1,"A"
NA,1990,"Stafford Rangers","Merthyr Tydfil","2-0",2,0,5,5,2,2,"H"
NA,1990,"Sutton United","Merthyr Tydfil","1-1",1,1,5,5,2,0,"D"
NA,1990,"Telford United","Merthyr Tydfil","3-1",3,1,5,5,4,2,"H"
NA,1990,"Welling United","Merthyr Tydfil","2-1",2,1,5,5,3,1,"H"
NA,1990,"Wycombe Wanderers","Merthyr Tydfil","2-1",2,1,5,5,3,1,"H"
NA,1990,"Yeovil","Merthyr Tydfil","3-3",3,3,5,5,6,0,"D"
NA,1990,"Altrincham","Northwich Victoria","0-2",0,2,5,5,2,-2,"A"
NA,1990,"Barnet","Northwich Victoria","1-1",1,1,5,5,2,0,"D"
NA,1990,"Barrow","Northwich Victoria","2-2",2,2,5,5,4,0,"D"
NA,1990,"Bath City","Northwich Victoria","4-1",4,1,5,5,5,3,"H"
NA,1990,"Boston United","Northwich Victoria","4-1",4,1,5,5,5,3,"H"
NA,1990,"Cheltenham","Northwich Victoria","1-1",1,1,5,5,2,0,"D"
NA,1990,"Colchester United","Northwich Victoria","4-0",4,0,5,5,4,4,"H"
NA,1990,"Fisher Athletic","Northwich Victoria","5-2",5,2,5,5,7,3,"H"
NA,1990,"Gateshead","Northwich Victoria","0-4",0,4,5,5,4,-4,"A"
NA,1990,"Kettering Town","Northwich Victoria","1-0",1,0,5,5,1,1,"H"
NA,1990,"Kidderminster Harriers","Northwich Victoria","3-1",3,1,5,5,4,2,"H"
NA,1990,"Macclesfield","Northwich Victoria","1-2",1,2,5,5,3,-1,"A"
NA,1990,"Merthyr Tydfil","Northwich Victoria","3-2",3,2,5,5,5,1,"H"
NA,1990,"Runcorn","Northwich Victoria","2-1",2,1,5,5,3,1,"H"
NA,1990,"Slough Town","Northwich Victoria","2-4",2,4,5,5,6,-2,"A"
NA,1990,"Stafford Rangers","Northwich Victoria","0-0",0,0,5,5,0,0,"D"
NA,1990,"Sutton United","Northwich Victoria","2-2",2,2,5,5,4,0,"D"
NA,1990,"Telford United","Northwich Victoria","1-0",1,0,5,5,1,1,"H"
NA,1990,"Welling United","Northwich Victoria","4-5",4,5,5,5,9,-1,"A"
NA,1990,"Wycombe Wanderers","Northwich Victoria","3-0",3,0,5,5,3,3,"H"
NA,1990,"Yeovil","Northwich Victoria","1-1",1,1,5,5,2,0,"D"
NA,1990,"Altrincham","Runcorn","1-0",1,0,5,5,1,1,"H"
NA,1990,"Barnet","Runcorn","2-0",2,0,5,5,2,2,"H"
NA,1990,"Barrow","Runcorn","2-1",2,1,5,5,3,1,"H"
NA,1990,"Bath City","Runcorn","6-1",6,1,5,5,7,5,"H"
NA,1990,"Boston United","Runcorn","2-2",2,2,5,5,4,0,"D"
NA,1990,"Cheltenham","Runcorn","1-3",1,3,5,5,4,-2,"A"
NA,1990,"Colchester United","Runcorn","2-2",2,2,5,5,4,0,"D"
NA,1990,"Fisher Athletic","Runcorn","0-1",0,1,5,5,1,-1,"A"
NA,1990,"Gateshead","Runcorn","3-1",3,1,5,5,4,2,"H"
NA,1990,"Kettering Town","Runcorn","3-0",3,0,5,5,3,3,"H"
NA,1990,"Kidderminster Harriers","Runcorn","3-1",3,1,5,5,4,2,"H"
NA,1990,"Macclesfield","Runcorn","2-1",2,1,5,5,3,1,"H"
NA,1990,"Merthyr Tydfil","Runcorn","0-0",0,0,5,5,0,0,"D"
NA,1990,"Northwich Victoria","Runcorn","1-4",1,4,5,5,5,-3,"A"
NA,1990,"Slough Town","Runcorn","2-1",2,1,5,5,3,1,"H"
NA,1990,"Stafford Rangers","Runcorn","1-1",1,1,5,5,2,0,"D"
NA,1990,"Sutton United","Runcorn","1-3",1,3,5,5,4,-2,"A"
NA,1990,"Telford United","Runcorn","2-0",2,0,5,5,2,2,"H"
NA,1990,"Welling United","Runcorn","2-2",2,2,5,5,4,0,"D"
NA,1990,"Wycombe Wanderers","Runcorn","1-1",1,1,5,5,2,0,"D"
NA,1990,"Yeovil","Runcorn","1-0",1,0,5,5,1,1,"H"
NA,1990,"Altrincham","Slough Town","3-0",3,0,5,5,3,3,"H"
NA,1990,"Barnet","Slough Town","6-1",6,1,5,5,7,5,"H"
NA,1990,"Barrow","Slough Town","2-1",2,1,5,5,3,1,"H"
NA,1990,"Bath City","Slough Town","4-0",4,0,5,5,4,4,"H"
NA,1990,"Boston United","Slough Town","0-1",0,1,5,5,1,-1,"A"
NA,1990,"Cheltenham","Slough Town","2-0",2,0,5,5,2,2,"H"
NA,1990,"Colchester United","Slough Town","2-1",2,1,5,5,3,1,"H"
NA,1990,"Fisher Athletic","Slough Town","1-1",1,1,5,5,2,0,"D"
NA,1990,"Gateshead","Slough Town","1-0",1,0,5,5,1,1,"H"
NA,1990,"Kettering Town","Slough Town","0-0",0,0,5,5,0,0,"D"
NA,1990,"Kidderminster Harriers","Slough Town","1-2",1,2,5,5,3,-1,"A"
NA,1990,"Macclesfield","Slough Town","1-2",1,2,5,5,3,-1,"A"
NA,1990,"Merthyr Tydfil","Slough Town","3-0",3,0,5,5,3,3,"H"
NA,1990,"Northwich Victoria","Slough Town","1-0",1,0,5,5,1,1,"H"
NA,1990,"Runcorn","Slough Town","3-1",3,1,5,5,4,2,"H"
NA,1990,"Stafford Rangers","Slough Town","3-4",3,4,5,5,7,-1,"A"
NA,1990,"Sutton United","Slough Town","5-2",5,2,5,5,7,3,"H"
NA,1990,"Telford United","Slough Town","2-1",2,1,5,5,3,1,"H"
NA,1990,"Welling United","Slough Town","2-0",2,0,5,5,2,2,"H"
NA,1990,"Wycombe Wanderers","Slough Town","2-1",2,1,5,5,3,1,"H"
NA,1990,"Yeovil","Slough Town","7-2",7,2,5,5,9,5,"H"
NA,1990,"Altrincham","Stafford Rangers","0-0",0,0,5,5,0,0,"D"
NA,1990,"Barnet","Stafford Rangers","2-0",2,0,5,5,2,2,"H"
NA,1990,"Barrow","Stafford Rangers","2-0",2,0,5,5,2,2,"H"
NA,1990,"Bath City","Stafford Rangers","0-1",0,1,5,5,1,-1,"A"
NA,1990,"Boston United","Stafford Rangers","0-2",0,2,5,5,2,-2,"A"
NA,1990,"Cheltenham","Stafford Rangers","1-2",1,2,5,5,3,-1,"A"
NA,1990,"Colchester United","Stafford Rangers","2-0",2,0,5,5,2,2,"H"
NA,1990,"Fisher Athletic","Stafford Rangers","1-3",1,3,5,5,4,-2,"A"
NA,1990,"Gateshead","Stafford Rangers","2-1",2,1,5,5,3,1,"H"
NA,1990,"Kettering Town","Stafford Rangers","2-0",2,0,5,5,2,2,"H"
NA,1990,"Kidderminster Harriers","Stafford Rangers","2-1",2,1,5,5,3,1,"H"
NA,1990,"Macclesfield","Stafford Rangers","2-1",2,1,5,5,3,1,"H"
NA,1990,"Merthyr Tydfil","Stafford Rangers","1-1",1,1,5,5,2,0,"D"
NA,1990,"Northwich Victoria","Stafford Rangers","1-1",1,1,5,5,2,0,"D"
NA,1990,"Runcorn","Stafford Rangers","1-0",1,0,5,5,1,1,"H"
NA,1990,"Slough Town","Stafford Rangers","2-1",2,1,5,5,3,1,"H"
NA,1990,"Sutton United","Stafford Rangers","0-3",0,3,5,5,3,-3,"A"
NA,1990,"Telford United","Stafford Rangers","0-0",0,0,5,5,0,0,"D"
NA,1990,"Welling United","Stafford Rangers","2-1",2,1,5,5,3,1,"H"
NA,1990,"Wycombe Wanderers","Stafford Rangers","3-0",3,0,5,5,3,3,"H"
NA,1990,"Yeovil","Stafford Rangers","0-0",0,0,5,5,0,0,"D"
NA,1990,"Altrincham","Sutton United","4-1",4,1,5,5,5,3,"H"
NA,1990,"Barnet","Sutton United","1-0",1,0,5,5,1,1,"H"
NA,1990,"Barrow","Sutton United","3-1",3,1,5,5,4,2,"H"
NA,1990,"Bath City","Sutton United","2-2",2,2,5,5,4,0,"D"
NA,1990,"Boston United","Sutton United","2-2",2,2,5,5,4,0,"D"
NA,1990,"Cheltenham","Sutton United","3-2",3,2,5,5,5,1,"H"
NA,1990,"Colchester United","Sutton United","1-0",1,0,5,5,1,1,"H"
NA,1990,"Fisher Athletic","Sutton United","1-1",1,1,5,5,2,0,"D"
NA,1990,"Gateshead","Sutton United","0-9",0,9,5,5,9,-9,"A"
NA,1990,"Kettering Town","Sutton United","5-2",5,2,5,5,7,3,"H"
NA,1990,"Kidderminster Harriers","Sutton United","1-0",1,0,5,5,1,1,"H"
NA,1990,"Macclesfield","Sutton United","4-2",4,2,5,5,6,2,"H"
NA,1990,"Merthyr Tydfil","Sutton United","3-0",3,0,5,5,3,3,"H"
NA,1990,"Northwich Victoria","Sutton United","1-0",1,0,5,5,1,1,"H"
NA,1990,"Runcorn","Sutton United","5-1",5,1,5,5,6,4,"H"
NA,1990,"Slough Town","Sutton United","1-2",1,2,5,5,3,-1,"A"
NA,1990,"Stafford Rangers","Sutton United","1-2",1,2,5,5,3,-1,"A"
NA,1990,"Telford United","Sutton United","4-2",4,2,5,5,6,2,"H"
NA,1990,"Welling United","Sutton United","1-2",1,2,5,5,3,-1,"A"
NA,1990,"Wycombe Wanderers","Sutton United","4-1",4,1,5,5,5,3,"H"
NA,1990,"Yeovil","Sutton United","2-1",2,1,5,5,3,1,"H"
NA,1990,"Altrincham","Telford United","2-1",2,1,5,5,3,1,"H"
NA,1990,"Barnet","Telford United","0-0",0,0,5,5,0,0,"D"
NA,1990,"Barrow","Telford United","2-1",2,1,5,5,3,1,"H"
NA,1990,"Bath City","Telford United","0-1",0,1,5,5,1,-1,"A"
NA,1990,"Boston United","Telford United","2-1",2,1,5,5,3,1,"H"
NA,1990,"Cheltenham","Telford United","0-1",0,1,5,5,1,-1,"A"
NA,1990,"Colchester United","Telford United","2-0",2,0,5,5,2,2,"H"
NA,1990,"Fisher Athletic","Telford United","2-0",2,0,5,5,2,2,"H"
NA,1990,"Gateshead","Telford United","5-1",5,1,5,5,6,4,"H"
NA,1990,"Kettering Town","Telford United","2-5",2,5,5,5,7,-3,"A"
NA,1990,"Kidderminster Harriers","Telford United","1-3",1,3,5,5,4,-2,"A"
NA,1990,"Macclesfield","Telford United","1-2",1,2,5,5,3,-1,"A"
NA,1990,"Merthyr Tydfil","Telford United","2-3",2,3,5,5,5,-1,"A"
NA,1990,"Northwich Victoria","Telford United","2-4",2,4,5,5,6,-2,"A"
NA,1990,"Runcorn","Telford United","0-0",0,0,5,5,0,0,"D"
NA,1990,"Slough Town","Telford United","2-0",2,0,5,5,2,2,"H"
NA,1990,"Stafford Rangers","Telford United","1-1",1,1,5,5,2,0,"D"
NA,1990,"Sutton United","Telford United","0-3",0,3,5,5,3,-3,"A"
NA,1990,"Welling United","Telford United","1-1",1,1,5,5,2,0,"D"
NA,1990,"Wycombe Wanderers","Telford United","3-2",3,2,5,5,5,1,"H"
NA,1990,"Yeovil","Telford United","1-2",1,2,5,5,3,-1,"A"
NA,1990,"Altrincham","Welling United","0-1",0,1,5,5,1,-1,"A"
NA,1990,"Barnet","Welling United","1-1",1,1,5,5,2,0,"D"
NA,1990,"Barrow","Welling United","1-1",1,1,5,5,2,0,"D"
NA,1990,"Bath City","Welling United","2-1",2,1,5,5,3,1,"H"
NA,1990,"Boston United","Welling United","0-0",0,0,5,5,0,0,"D"
NA,1990,"Cheltenham","Welling United","3-0",3,0,5,5,3,3,"H"
NA,1990,"Colchester United","Welling United","2-1",2,1,5,5,3,1,"H"
NA,1990,"Fisher Athletic","Welling United","1-1",1,1,5,5,2,0,"D"
NA,1990,"Gateshead","Welling United","0-3",0,3,5,5,3,-3,"A"
NA,1990,"Kettering Town","Welling United","0-0",0,0,5,5,0,0,"D"
NA,1990,"Kidderminster Harriers","Welling United","1-2",1,2,5,5,3,-1,"A"
NA,1990,"Macclesfield","Welling United","2-1",2,1,5,5,3,1,"H"
NA,1990,"Merthyr Tydfil","Welling United","1-0",1,0,5,5,1,1,"H"
NA,1990,"Northwich Victoria","Welling United","1-2",1,2,5,5,3,-1,"A"
NA,1990,"Runcorn","Welling United","2-3",2,3,5,5,5,-1,"A"
NA,1990,"Slough Town","Welling United","3-0",3,0,5,5,3,3,"H"
NA,1990,"Stafford Rangers","Welling United","1-0",1,0,5,5,1,1,"H"
NA,1990,"Sutton United","Welling United","1-1",1,1,5,5,2,0,"D"
NA,1990,"Telford United","Welling United","2-1",2,1,5,5,3,1,"H"
NA,1990,"Wycombe Wanderers","Welling United","4-1",4,1,5,5,5,3,"H"
NA,1990,"Yeovil","Welling United","0-1",0,1,5,5,1,-1,"A"
NA,1990,"Altrincham","Wycombe Wanderers","1-0",1,0,5,5,1,1,"H"
NA,1990,"Barnet","Wycombe Wanderers","2-2",2,2,5,5,4,0,"D"
NA,1990,"Barrow","Wycombe Wanderers","2-2",2,2,5,5,4,0,"D"
NA,1990,"Bath City","Wycombe Wanderers","1-2",1,2,5,5,3,-1,"A"
NA,1990,"Boston United","Wycombe Wanderers","0-1",0,1,5,5,1,-1,"A"
NA,1990,"Cheltenham","Wycombe Wanderers","1-0",1,0,5,5,1,1,"H"
NA,1990,"Colchester United","Wycombe Wanderers","2-2",2,2,5,5,4,0,"D"
NA,1990,"Fisher Athletic","Wycombe Wanderers","2-3",2,3,5,5,5,-1,"A"
NA,1990,"Gateshead","Wycombe Wanderers","2-1",2,1,5,5,3,1,"H"
NA,1990,"Kettering Town","Wycombe Wanderers","0-1",0,1,5,5,1,-1,"A"
NA,1990,"Kidderminster Harriers","Wycombe Wanderers","1-2",1,2,5,5,3,-1,"A"
NA,1990,"Macclesfield","Wycombe Wanderers","0-0",0,0,5,5,0,0,"D"
NA,1990,"Merthyr Tydfil","Wycombe Wanderers","2-4",2,4,5,5,6,-2,"A"
NA,1990,"Northwich Victoria","Wycombe Wanderers","1-1",1,1,5,5,2,0,"D"
NA,1990,"Runcorn","Wycombe Wanderers","1-1",1,1,5,5,2,0,"D"
NA,1990,"Slough Town","Wycombe Wanderers","3-3",3,3,5,5,6,0,"D"
NA,1990,"Stafford Rangers","Wycombe Wanderers","2-1",2,1,5,5,3,1,"H"
NA,1990,"Sutton United","Wycombe Wanderers","1-0",1,0,5,5,1,1,"H"
NA,1990,"Telford United","Wycombe Wanderers","1-0",1,0,5,5,1,1,"H"
NA,1990,"Welling United","Wycombe Wanderers","1-1",1,1,5,5,2,0,"D"
NA,1990,"Yeovil","Wycombe Wanderers","2-2",2,2,5,5,4,0,"D"
NA,1990,"Altrincham","Yeovil","2-2",2,2,5,5,4,0,"D"
NA,1990,"Barnet","Yeovil","1-0",1,0,5,5,1,1,"H"
NA,1990,"Barrow","Yeovil","1-0",1,0,5,5,1,1,"H"
NA,1990,"Bath City","Yeovil","2-1",2,1,5,5,3,1,"H"
NA,1990,"Boston United","Yeovil","4-0",4,0,5,5,4,4,"H"
NA,1990,"Cheltenham","Yeovil","1-0",1,0,5,5,1,1,"H"
NA,1990,"Colchester United","Yeovil","0-1",0,1,5,5,1,-1,"A"
NA,1990,"Fisher Athletic","Yeovil","2-1",2,1,5,5,3,1,"H"
NA,1990,"Gateshead","Yeovil","1-1",1,1,5,5,2,0,"D"
NA,1990,"Kettering Town","Yeovil","1-1",1,1,5,5,2,0,"D"
NA,1990,"Kidderminster Harriers","Yeovil","0-0",0,0,5,5,0,0,"D"
NA,1990,"Macclesfield","Yeovil","2-1",2,1,5,5,3,1,"H"
NA,1990,"Merthyr Tydfil","Yeovil","1-1",1,1,5,5,2,0,"D"
NA,1990,"Northwich Victoria","Yeovil","2-0",2,0,5,5,2,2,"H"
NA,1990,"Runcorn","Yeovil","0-3",0,3,5,5,3,-3,"A"
NA,1990,"Slough Town","Yeovil","2-0",2,0,5,5,2,2,"H"
NA,1990,"Stafford Rangers","Yeovil","1-1",1,1,5,5,2,0,"D"
NA,1990,"Sutton United","Yeovil","1-0",1,0,5,5,1,1,"H"
NA,1990,"Telford United","Yeovil","1-2",1,2,5,5,3,-1,"A"
NA,1990,"Welling United","Yeovil","0-3",0,3,5,5,3,-3,"A"
NA,1990,"Wycombe Wanderers","Yeovil","2-0",2,0,5,5,2,2,"H"
NA,1991,"Barrow","Altrincham","0-2",0,2,5,5,2,-2,"A"
NA,1991,"Bath City","Altrincham","3-2",3,2,5,5,5,1,"H"
NA,1991,"Boston United","Altrincham","2-1",2,1,5,5,3,1,"H"
NA,1991,"Cheltenham","Altrincham","0-2",0,2,5,5,2,-2,"A"
NA,1991,"Colchester United","Altrincham","3-3",3,3,5,5,6,0,"D"
NA,1991,"Farnborough Town","Altrincham","3-0",3,0,5,5,3,3,"H"
NA,1991,"Gateshead","Altrincham","5-0",5,0,5,5,5,5,"H"
NA,1991,"Kettering Town","Altrincham","5-0",5,0,5,5,5,5,"H"
NA,1991,"Kidderminster Harriers","Altrincham","1-0",1,0,5,5,1,1,"H"
NA,1991,"Macclesfield","Altrincham","1-1",1,1,5,5,2,0,"D"
NA,1991,"Merthyr Tydfil","Altrincham","3-1",3,1,5,5,4,2,"H"
NA,1991,"Northwich Victoria","Altrincham","1-2",1,2,5,5,3,-1,"A"
NA,1991,"Redbridge Forest","Altrincham","0-1",0,1,5,5,1,-1,"A"
NA,1991,"Runcorn","Altrincham","2-2",2,2,5,5,4,0,"D"
NA,1991,"Slough Town","Altrincham","2-3",2,3,5,5,5,-1,"A"
NA,1991,"Stafford Rangers","Altrincham","1-2",1,2,5,5,3,-1,"A"
NA,1991,"Telford United","Altrincham","2-1",2,1,5,5,3,1,"H"
NA,1991,"Welling United","Altrincham","2-2",2,2,5,5,4,0,"D"
NA,1991,"Witton Albion","Altrincham","2-0",2,0,5,5,2,2,"H"
NA,1991,"Wycombe Wanderers","Altrincham","4-2",4,2,5,5,6,2,"H"
NA,1991,"Yeovil","Altrincham","2-1",2,1,5,5,3,1,"H"
NA,1991,"Altrincham","Barrow","1-1",1,1,5,5,2,0,"D"
NA,1991,"Bath City","Barrow","2-1",2,1,5,5,3,1,"H"
NA,1991,"Boston United","Barrow","4-1",4,1,5,5,5,3,"H"
NA,1991,"Cheltenham","Barrow","0-0",0,0,5,5,0,0,"D"
NA,1991,"Colchester United","Barrow","5-0",5,0,5,5,5,5,"H"
NA,1991,"Farnborough Town","Barrow","5-0",5,0,5,5,5,5,"H"
NA,1991,"Gateshead","Barrow","1-1",1,1,5,5,2,0,"D"
NA,1991,"Kettering Town","Barrow","3-2",3,2,5,5,5,1,"H"
NA,1991,"Kidderminster Harriers","Barrow","1-2",1,2,5,5,3,-1,"A"
NA,1991,"Macclesfield","Barrow","0-1",0,1,5,5,1,-1,"A"
NA,1991,"Merthyr Tydfil","Barrow","2-1",2,1,5,5,3,1,"H"
NA,1991,"Northwich Victoria","Barrow","6-1",6,1,5,5,7,5,"H"
NA,1991,"Redbridge Forest","Barrow","2-2",2,2,5,5,4,0,"D"
NA,1991,"Runcorn","Barrow","2-2",2,2,5,5,4,0,"D"
NA,1991,"Slough Town","Barrow","1-0",1,0,5,5,1,1,"H"
NA,1991,"Stafford Rangers","Barrow","0-0",0,0,5,5,0,0,"D"
NA,1991,"Telford United","Barrow","4-2",4,2,5,5,6,2,"H"
NA,1991,"Welling United","Barrow","5-3",5,3,5,5,8,2,"H"
NA,1991,"Witton Albion","Barrow","0-1",0,1,5,5,1,-1,"A"
NA,1991,"Wycombe Wanderers","Barrow","3-2",3,2,5,5,5,1,"H"
NA,1991,"Yeovil","Barrow","2-0",2,0,5,5,2,2,"H"
NA,1991,"Altrincham","Bath City","4-0",4,0,5,5,4,4,"H"
NA,1991,"Barrow","Bath City","2-0",2,0,5,5,2,2,"H"
NA,1991,"Boston United","Bath City","1-0",1,0,5,5,1,1,"H"
NA,1991,"Cheltenham","Bath City","1-2",1,2,5,5,3,-1,"A"
NA,1991,"Colchester United","Bath City","5-0",5,0,5,5,5,5,"H"
NA,1991,"Farnborough Town","Bath City","1-2",1,2,5,5,3,-1,"A"
NA,1991,"Gateshead","Bath City","0-1",0,1,5,5,1,-1,"A"
NA,1991,"Kettering Town","Bath City","2-2",2,2,5,5,4,0,"D"
NA,1991,"Kidderminster Harriers","Bath City","0-1",0,1,5,5,1,-1,"A"
NA,1991,"Macclesfield","Bath City","0-0",0,0,5,5,0,0,"D"
NA,1991,"Merthyr Tydfil","Bath City","1-1",1,1,5,5,2,0,"D"
NA,1991,"Northwich Victoria","Bath City","1-3",1,3,5,5,4,-2,"A"
NA,1991,"Redbridge Forest","Bath City","3-1",3,1,5,5,4,2,"H"
NA,1991,"Runcorn","Bath City","0-2",0,2,5,5,2,-2,"A"
NA,1991,"Slough Town","Bath City","2-2",2,2,5,5,4,0,"D"
NA,1991,"Stafford Rangers","Bath City","2-0",2,0,5,5,2,2,"H"
NA,1991,"Telford United","Bath City","0-2",0,2,5,5,2,-2,"A"
NA,1991,"Welling United","Bath City","0-5",0,5,5,5,5,-5,"A"
NA,1991,"Witton Albion","Bath City","2-2",2,2,5,5,4,0,"D"
NA,1991,"Wycombe Wanderers","Bath City","1-0",1,0,5,5,1,1,"H"
NA,1991,"Yeovil","Bath City","1-1",1,1,5,5,2,0,"D"
NA,1991,"Altrincham","Boston United","2-4",2,4,5,5,6,-2,"A"
NA,1991,"Barrow","Boston United","2-2",2,2,5,5,4,0,"D"
NA,1991,"Bath City","Boston United","2-0",2,0,5,5,2,2,"H"
NA,1991,"Cheltenham","Boston United","1-1",1,1,5,5,2,0,"D"
NA,1991,"Colchester United","Boston United","1-0",1,0,5,5,1,1,"H"
NA,1991,"Farnborough Town","Boston United","5-0",5,0,5,5,5,5,"H"
NA,1991,"Gateshead","Boston United","2-1",2,1,5,5,3,1,"H"
NA,1991,"Kettering Town","Boston United","1-3",1,3,5,5,4,-2,"A"
NA,1991,"Kidderminster Harriers","Boston United","1-3",1,3,5,5,4,-2,"A"
NA,1991,"Macclesfield","Boston United","0-1",0,1,5,5,1,-1,"A"
NA,1991,"Merthyr Tydfil","Boston United","2-0",2,0,5,5,2,2,"H"
NA,1991,"Northwich Victoria","Boston United","1-1",1,1,5,5,2,0,"D"
NA,1991,"Redbridge Forest","Boston United","1-4",1,4,5,5,5,-3,"A"
NA,1991,"Runcorn","Boston United","2-2",2,2,5,5,4,0,"D"
NA,1991,"Slough Town","Boston United","3-1",3,1,5,5,4,2,"H"
NA,1991,"Stafford Rangers","Boston United","0-1",0,1,5,5,1,-1,"A"
NA,1991,"Telford United","Boston United","1-2",1,2,5,5,3,-1,"A"
NA,1991,"Welling United","Boston United","1-3",1,3,5,5,4,-2,"A"
NA,1991,"Witton Albion","Boston United","1-0",1,0,5,5,1,1,"H"
NA,1991,"Wycombe Wanderers","Boston United","2-1",2,1,5,5,3,1,"H"
NA,1991,"Yeovil","Boston United","1-1",1,1,5,5,2,0,"D"
NA,1991,"Altrincham","Cheltenham","2-1",2,1,5,5,3,1,"H"
NA,1991,"Barrow","Cheltenham","0-0",0,0,5,5,0,0,"D"
NA,1991,"Bath City","Cheltenham","5-1",5,1,5,5,6,4,"H"
NA,1991,"Boston United","Cheltenham","3-3",3,3,5,5,6,0,"D"
NA,1991,"Colchester United","Cheltenham","4-0",4,0,5,5,4,4,"H"
NA,1991,"Farnborough Town","Cheltenham","1-1",1,1,5,5,2,0,"D"
NA,1991,"Gateshead","Cheltenham","2-1",2,1,5,5,3,1,"H"
NA,1991,"Kettering Town","Cheltenham","3-0",3,0,5,5,3,3,"H"
NA,1991,"Kidderminster Harriers","Cheltenham","2-1",2,1,5,5,3,1,"H"
NA,1991,"Macclesfield","Cheltenham","3-3",3,3,5,5,6,0,"D"
NA,1991,"Merthyr Tydfil","Cheltenham","3-1",3,1,5,5,4,2,"H"
NA,1991,"Northwich Victoria","Cheltenham","3-1",3,1,5,5,4,2,"H"
NA,1991,"Redbridge Forest","Cheltenham","1-2",1,2,5,5,3,-1,"A"
NA,1991,"Runcorn","Cheltenham","2-1",2,1,5,5,3,1,"H"
NA,1991,"Slough Town","Cheltenham","1-3",1,3,5,5,4,-2,"A"
NA,1991,"Stafford Rangers","Cheltenham","2-2",2,2,5,5,4,0,"D"
NA,1991,"Telford United","Cheltenham","2-1",2,1,5,5,3,1,"H"
NA,1991,"Welling United","Cheltenham","1-1",1,1,5,5,2,0,"D"
NA,1991,"Witton Albion","Cheltenham","4-2",4,2,5,5,6,2,"H"
NA,1991,"Wycombe Wanderers","Cheltenham","2-2",2,2,5,5,4,0,"D"
NA,1991,"Yeovil","Cheltenham","1-1",1,1,5,5,2,0,"D"
NA,1991,"Altrincham","Colchester United","1-2",1,2,5,5,3,-1,"A"
NA,1991,"Barrow","Colchester United","1-1",1,1,5,5,2,0,"D"
NA,1991,"Bath City","Colchester United","0-0",0,0,5,5,0,0,"D"
NA,1991,"Boston United","Colchester United","0-4",0,4,5,5,4,-4,"A"
NA,1991,"Cheltenham","Colchester United","1-1",1,1,5,5,2,0,"D"
NA,1991,"Farnborough Town","Colchester United","0-2",0,2,5,5,2,-2,"A"
NA,1991,"Gateshead","Colchester United","0-2",0,2,5,5,2,-2,"A"
NA,1991,"Kettering Town","Colchester United","2-2",2,2,5,5,4,0,"D"
NA,1991,"Kidderminster Harriers","Colchester United","2-2",2,2,5,5,4,0,"D"
NA,1991,"Macclesfield","Colchester United","4-4",4,4,5,5,8,0,"D"
NA,1991,"Merthyr Tydfil","Colchester United","2-0",2,0,5,5,2,2,"H"
NA,1991,"Northwich Victoria","Colchester United","1-1",1,1,5,5,2,0,"D"
NA,1991,"Redbridge Forest","Colchester United","2-1",2,1,5,5,3,1,"H"
NA,1991,"Runcorn","Colchester United","1-3",1,3,5,5,4,-2,"A"
NA,1991,"Slough Town","Colchester United","2-4",2,4,5,5,6,-2,"A"
NA,1991,"Stafford Rangers","Colchester United","3-3",3,3,5,5,6,0,"D"
NA,1991,"Telford United","Colchester United","0-3",0,3,5,5,3,-3,"A"
NA,1991,"Welling United","Colchester United","4-1",4,1,5,5,5,3,"H"
NA,1991,"Witton Albion","Colchester United","2-2",2,2,5,5,4,0,"D"
NA,1991,"Wycombe Wanderers","Colchester United","1-2",1,2,5,5,3,-1,"A"
NA,1991,"Yeovil","Colchester United","0-1",0,1,5,5,1,-1,"A"
NA,1991,"Altrincham","Farnborough Town","1-1",1,1,5,5,2,0,"D"
NA,1991,"Barrow","Farnborough Town","0-1",0,1,5,5,1,-1,"A"
NA,1991,"Bath City","Farnborough Town","1-2",1,2,5,5,3,-1,"A"
NA,1991,"Boston United","Farnborough Town","0-1",0,1,5,5,1,-1,"A"
NA,1991,"Cheltenham","Farnborough Town","4-3",4,3,5,5,7,1,"H"
NA,1991,"Colchester United","Farnborough Town","2-3",2,3,5,5,5,-1,"A"
NA,1991,"Gateshead","Farnborough Town","0-2",0,2,5,5,2,-2,"A"
NA,1991,"Kettering Town","Farnborough Town","1-2",1,2,5,5,3,-1,"A"
NA,1991,"Kidderminster Harriers","Farnborough Town","1-1",1,1,5,5,2,0,"D"
NA,1991,"Macclesfield","Farnborough Town","1-2",1,2,5,5,3,-1,"A"
NA,1991,"Merthyr Tydfil","Farnborough Town","1-0",1,0,5,5,1,1,"H"
NA,1991,"Northwich Victoria","Farnborough Town","1-1",1,1,5,5,2,0,"D"
NA,1991,"Redbridge Forest","Farnborough Town","2-0",2,0,5,5,2,2,"H"
NA,1991,"Runcorn","Farnborough Town","1-1",1,1,5,5,2,0,"D"
NA,1991,"Slough Town","Farnborough Town","0-5",0,5,5,5,5,-5,"A"
NA,1991,"Stafford Rangers","Farnborough Town","0-1",0,1,5,5,1,-1,"A"
NA,1991,"Telford United","Farnborough Town","1-2",1,2,5,5,3,-1,"A"
NA,1991,"Welling United","Farnborough Town","1-0",1,0,5,5,1,1,"H"
NA,1991,"Witton Albion","Farnborough Town","4-1",4,1,5,5,5,3,"H"
NA,1991,"Wycombe Wanderers","Farnborough Town","2-1",2,1,5,5,3,1,"H"
NA,1991,"Yeovil","Farnborough Town","2-2",2,2,5,5,4,0,"D"
NA,1991,"Altrincham","Gateshead","1-1",1,1,5,5,2,0,"D"
NA,1991,"Barrow","Gateshead","1-1",1,1,5,5,2,0,"D"
NA,1991,"Bath City","Gateshead","0-1",0,1,5,5,1,-1,"A"
NA,1991,"Boston United","Gateshead","4-0",4,0,5,5,4,4,"H"
NA,1991,"Cheltenham","Gateshead","3-2",3,2,5,5,5,1,"H"
NA,1991,"Colchester United","Gateshead","2-0",2,0,5,5,2,2,"H"
NA,1991,"Farnborough Town","Gateshead","3-1",3,1,5,5,4,2,"H"
NA,1991,"Kettering Town","Gateshead","1-1",1,1,5,5,2,0,"D"
NA,1991,"Kidderminster Harriers","Gateshead","5-3",5,3,5,5,8,2,"H"
NA,1991,"Macclesfield","Gateshead","1-0",1,0,5,5,1,1,"H"
NA,1991,"Merthyr Tydfil","Gateshead","1-4",1,4,5,5,5,-3,"A"
NA,1991,"Northwich Victoria","Gateshead","1-1",1,1,5,5,2,0,"D"
NA,1991,"Redbridge Forest","Gateshead","2-1",2,1,5,5,3,1,"H"
NA,1991,"Runcorn","Gateshead","1-1",1,1,5,5,2,0,"D"
NA,1991,"Slough Town","Gateshead","2-0",2,0,5,5,2,2,"H"
NA,1991,"Stafford Rangers","Gateshead","1-3",1,3,5,5,4,-2,"A"
NA,1991,"Telford United","Gateshead","1-1",1,1,5,5,2,0,"D"
NA,1991,"Welling United","Gateshead","2-2",2,2,5,5,4,0,"D"
NA,1991,"Witton Albion","Gateshead","0-3",0,3,5,5,3,-3,"A"
NA,1991,"Wycombe Wanderers","Gateshead","2-1",2,1,5,5,3,1,"H"
NA,1991,"Yeovil","Gateshead","1-0",1,0,5,5,1,1,"H"
NA,1991,"Altrincham","Kettering Town","1-1",1,1,5,5,2,0,"D"
NA,1991,"Barrow","Kettering Town","0-0",0,0,5,5,0,0,"D"
NA,1991,"Bath City","Kettering Town","1-1",1,1,5,5,2,0,"D"
NA,1991,"Boston United","Kettering Town","1-1",1,1,5,5,2,0,"D"
NA,1991,"Cheltenham","Kettering Town","0-3",0,3,5,5,3,-3,"A"
NA,1991,"Colchester United","Kettering Town","3-1",3,1,5,5,4,2,"H"
NA,1991,"Farnborough Town","Kettering Town","1-3",1,3,5,5,4,-2,"A"
NA,1991,"Gateshead","Kettering Town","0-0",0,0,5,5,0,0,"D"
NA,1991,"Kidderminster Harriers","Kettering Town","2-3",2,3,5,5,5,-1,"A"
NA,1991,"Macclesfield","Kettering Town","0-2",0,2,5,5,2,-2,"A"
NA,1991,"Merthyr Tydfil","Kettering Town","4-1",4,1,5,5,5,3,"H"
NA,1991,"Northwich Victoria","Kettering Town","4-3",4,3,5,5,7,1,"H"
NA,1991,"Redbridge Forest","Kettering Town","4-0",4,0,5,5,4,4,"H"
NA,1991,"Runcorn","Kettering Town","0-0",0,0,5,5,0,0,"D"
NA,1991,"Slough Town","Kettering Town","0-2",0,2,5,5,2,-2,"A"
NA,1991,"Stafford Rangers","Kettering Town","1-2",1,2,5,5,3,-1,"A"
NA,1991,"Telford United","Kettering Town","1-1",1,1,5,5,2,0,"D"
NA,1991,"Welling United","Kettering Town","2-3",2,3,5,5,5,-1,"A"
NA,1991,"Witton Albion","Kettering Town","1-0",1,0,5,5,1,1,"H"
NA,1991,"Wycombe Wanderers","Kettering Town","1-0",1,0,5,5,1,1,"H"
NA,1991,"Yeovil","Kettering Town","0-1",0,1,5,5,1,-1,"A"
NA,1991,"Altrincham","Kidderminster Harriers","1-1",1,1,5,5,2,0,"D"
NA,1991,"Barrow","Kidderminster Harriers","5-1",5,1,5,5,6,4,"H"
NA,1991,"Bath City","Kidderminster Harriers","0-1",0,1,5,5,1,-1,"A"
NA,1991,"Boston United","Kidderminster Harriers","1-1",1,1,5,5,2,0,"D"
NA,1991,"Cheltenham","Kidderminster Harriers","1-2",1,2,5,5,3,-1,"A"
NA,1991,"Colchester United","Kidderminster Harriers","3-0",3,0,5,5,3,3,"H"
NA,1991,"Farnborough Town","Kidderminster Harriers","2-1",2,1,5,5,3,1,"H"
NA,1991,"Gateshead","Kidderminster Harriers","0-3",0,3,5,5,3,-3,"A"
NA,1991,"Kettering Town","Kidderminster Harriers","2-1",2,1,5,5,3,1,"H"
NA,1991,"Macclesfield","Kidderminster Harriers","0-0",0,0,5,5,0,0,"D"
NA,1991,"Merthyr Tydfil","Kidderminster Harriers","2-1",2,1,5,5,3,1,"H"
NA,1991,"Northwich Victoria","Kidderminster Harriers","3-1",3,1,5,5,4,2,"H"
NA,1991,"Redbridge Forest","Kidderminster Harriers","5-0",5,0,5,5,5,5,"H"
NA,1991,"Runcorn","Kidderminster Harriers","4-1",4,1,5,5,5,3,"H"
NA,1991,"Slough Town","Kidderminster Harriers","3-1",3,1,5,5,4,2,"H"
NA,1991,"Stafford Rangers","Kidderminster Harriers","2-0",2,0,5,5,2,2,"H"
NA,1991,"Telford United","Kidderminster Harriers","3-1",3,1,5,5,4,2,"H"
NA,1991,"Welling United","Kidderminster Harriers","3-2",3,2,5,5,5,1,"H"
NA,1991,"Witton Albion","Kidderminster Harriers","2-1",2,1,5,5,3,1,"H"
NA,1991,"Wycombe Wanderers","Kidderminster Harriers","2-0",2,0,5,5,2,2,"H"
NA,1991,"Yeovil","Kidderminster Harriers","1-1",1,1,5,5,2,0,"D"
NA,1991,"Altrincham","Macclesfield","3-1",3,1,5,5,4,2,"H"
NA,1991,"Barrow","Macclesfield","2-0",2,0,5,5,2,2,"H"
NA,1991,"Bath City","Macclesfield","1-1",1,1,5,5,2,0,"D"
NA,1991,"Boston United","Macclesfield","1-5",1,5,5,5,6,-4,"A"
NA,1991,"Cheltenham","Macclesfield","2-3",2,3,5,5,5,-1,"A"
NA,1991,"Colchester United","Macclesfield","2-0",2,0,5,5,2,2,"H"
NA,1991,"Farnborough Town","Macclesfield","4-2",4,2,5,5,6,2,"H"
NA,1991,"Gateshead","Macclesfield","2-0",2,0,5,5,2,2,"H"
NA,1991,"Kettering Town","Macclesfield","2-0",2,0,5,5,2,2,"H"
NA,1991,"Kidderminster Harriers","Macclesfield","1-1",1,1,5,5,2,0,"D"
NA,1991,"Merthyr Tydfil","Macclesfield","3-2",3,2,5,5,5,1,"H"
NA,1991,"Northwich Victoria","Macclesfield","2-1",2,1,5,5,3,1,"H"
NA,1991,"Redbridge Forest","Macclesfield","0-0",0,0,5,5,0,0,"D"
NA,1991,"Runcorn","Macclesfield","0-0",0,0,5,5,0,0,"D"
NA,1991,"Slough Town","Macclesfield","0-3",0,3,5,5,3,-3,"A"
NA,1991,"Stafford Rangers","Macclesfield","1-1",1,1,5,5,2,0,"D"
NA,1991,"Telford United","Macclesfield","0-1",0,1,5,5,1,-1,"A"
NA,1991,"Welling United","Macclesfield","2-1",2,1,5,5,3,1,"H"
NA,1991,"Witton Albion","Macclesfield","1-1",1,1,5,5,2,0,"D"
NA,1991,"Wycombe Wanderers","Macclesfield","0-1",0,1,5,5,1,-1,"A"
NA,1991,"Yeovil","Macclesfield","0-1",0,1,5,5,1,-1,"A"
NA,1991,"Altrincham","Merthyr Tydfil","1-1",1,1,5,5,2,0,"D"
NA,1991,"Barrow","Merthyr Tydfil","2-2",2,2,5,5,4,0,"D"
NA,1991,"Bath City","Merthyr Tydfil","0-0",0,0,5,5,0,0,"D"
NA,1991,"Boston United","Merthyr Tydfil","2-0",2,0,5,5,2,2,"H"
NA,1991,"Cheltenham","Merthyr Tydfil","1-2",1,2,5,5,3,-1,"A"
NA,1991,"Colchester United","Merthyr Tydfil","2-0",2,0,5,5,2,2,"H"
NA,1991,"Farnborough Town","Merthyr Tydfil","0-0",0,0,5,5,0,0,"D"
NA,1991,"Gateshead","Merthyr Tydfil","0-1",0,1,5,5,1,-1,"A"
NA,1991,"Kettering Town","Merthyr Tydfil","3-1",3,1,5,5,4,2,"H"
NA,1991,"Kidderminster Harriers","Merthyr Tydfil","2-2",2,2,5,5,4,0,"D"
NA,1991,"Macclesfield","Merthyr Tydfil","3-0",3,0,5,5,3,3,"H"
NA,1991,"Northwich Victoria","Merthyr Tydfil","4-1",4,1,5,5,5,3,"H"
NA,1991,"Redbridge Forest","Merthyr Tydfil","1-1",1,1,5,5,2,0,"D"
NA,1991,"Runcorn","Merthyr Tydfil","1-1",1,1,5,5,2,0,"D"
NA,1991,"Slough Town","Merthyr Tydfil","0-0",0,0,5,5,0,0,"D"
NA,1991,"Stafford Rangers","Merthyr Tydfil","0-0",0,0,5,5,0,0,"D"
NA,1991,"Telford United","Merthyr Tydfil","1-2",1,2,5,5,3,-1,"A"
NA,1991,"Welling United","Merthyr Tydfil","1-2",1,2,5,5,3,-1,"A"
NA,1991,"Witton Albion","Merthyr Tydfil","3-2",3,2,5,5,5,1,"H"
NA,1991,"Wycombe Wanderers","Merthyr Tydfil","4-0",4,0,5,5,4,4,"H"
NA,1991,"Yeovil","Merthyr Tydfil","1-1",1,1,5,5,2,0,"D"
NA,1991,"Altrincham","Northwich Victoria","0-1",0,1,5,5,1,-1,"A"
NA,1991,"Barrow","Northwich Victoria","0-2",0,2,5,5,2,-2,"A"
NA,1991,"Bath City","Northwich Victoria","2-0",2,0,5,5,2,2,"H"
NA,1991,"Boston United","Northwich Victoria","0-2",0,2,5,5,2,-2,"A"
NA,1991,"Cheltenham","Northwich Victoria","1-0",1,0,5,5,1,1,"H"
NA,1991,"Colchester United","Northwich Victoria","1-0",1,0,5,5,1,1,"H"
NA,1991,"Farnborough Town","Northwich Victoria","2-4",2,4,5,5,6,-2,"A"
NA,1991,"Gateshead","Northwich Victoria","2-0",2,0,5,5,2,2,"H"
NA,1991,"Kettering Town","Northwich Victoria","1-0",1,0,5,5,1,1,"H"
NA,1991,"Kidderminster Harriers","Northwich Victoria","1-0",1,0,5,5,1,1,"H"
NA,1991,"Macclesfield","Northwich Victoria","0-0",0,0,5,5,0,0,"D"
NA,1991,"Merthyr Tydfil","Northwich Victoria","2-1",2,1,5,5,3,1,"H"
NA,1991,"Redbridge Forest","Northwich Victoria","4-3",4,3,5,5,7,1,"H"
NA,1991,"Runcorn","Northwich Victoria","3-1",3,1,5,5,4,2,"H"
NA,1991,"Slough Town","Northwich Victoria","0-1",0,1,5,5,1,-1,"A"
NA,1991,"Stafford Rangers","Northwich Victoria","2-1",2,1,5,5,3,1,"H"
NA,1991,"Telford United","Northwich Victoria","1-4",1,4,5,5,5,-3,"A"
NA,1991,"Welling United","Northwich Victoria","6-1",6,1,5,5,7,5,"H"
NA,1991,"Witton Albion","Northwich Victoria","1-1",1,1,5,5,2,0,"D"
NA,1991,"Wycombe Wanderers","Northwich Victoria","2-0",2,0,5,5,2,2,"H"
NA,1991,"Yeovil","Northwich Victoria","2-1",2,1,5,5,3,1,"H"
NA,1991,"Altrincham","Redbridge Forest","0-3",0,3,5,5,3,-3,"A"
NA,1991,"Barrow","Redbridge Forest","0-1",0,1,5,5,1,-1,"A"
NA,1991,"Bath City","Redbridge Forest","0-0",0,0,5,5,0,0,"D"
NA,1991,"Boston United","Redbridge Forest","2-1",2,1,5,5,3,1,"H"
NA,1991,"Cheltenham","Redbridge Forest","0-7",0,7,5,5,7,-7,"A"
NA,1991,"Colchester United","Redbridge Forest","1-0",1,0,5,5,1,1,"H"
NA,1991,"Farnborough Town","Redbridge Forest","1-0",1,0,5,5,1,1,"H"
NA,1991,"Gateshead","Redbridge Forest","0-1",0,1,5,5,1,-1,"A"
NA,1991,"Kettering Town","Redbridge Forest","3-2",3,2,5,5,5,1,"H"
NA,1991,"Kidderminster Harriers","Redbridge Forest","5-1",5,1,5,5,6,4,"H"
NA,1991,"Macclesfield","Redbridge Forest","0-0",0,0,5,5,0,0,"D"
NA,1991,"Merthyr Tydfil","Redbridge Forest","2-2",2,2,5,5,4,0,"D"
NA,1991,"Northwich Victoria","Redbridge Forest","0-2",0,2,5,5,2,-2,"A"
NA,1991,"Runcorn","Redbridge Forest","1-0",1,0,5,5,1,1,"H"
NA,1991,"Slough Town","Redbridge Forest","4-0",4,0,5,5,4,4,"H"
NA,1991,"Stafford Rangers","Redbridge Forest","3-0",3,0,5,5,3,3,"H"
NA,1991,"Telford United","Redbridge Forest","3-3",3,3,5,5,6,0,"D"
NA,1991,"Welling United","Redbridge Forest","2-2",2,2,5,5,4,0,"D"
NA,1991,"Witton Albion","Redbridge Forest","2-0",2,0,5,5,2,2,"H"
NA,1991,"Wycombe Wanderers","Redbridge Forest","1-0",1,0,5,5,1,1,"H"
NA,1991,"Yeovil","Redbridge Forest","0-1",0,1,5,5,1,-1,"A"
NA,1991,"Altrincham","Runcorn","2-2",2,2,5,5,4,0,"D"
NA,1991,"Barrow","Runcorn","2-3",2,3,5,5,5,-1,"A"
NA,1991,"Bath City","Runcorn","3-1",3,1,5,5,4,2,"H"
NA,1991,"Boston United","Runcorn","2-1",2,1,5,5,3,1,"H"
NA,1991,"Cheltenham","Runcorn","4-1",4,1,5,5,5,3,"H"
NA,1991,"Colchester United","Runcorn","2-1",2,1,5,5,3,1,"H"
NA,1991,"Farnborough Town","Runcorn","0-2",0,2,5,5,2,-2,"A"
NA,1991,"Gateshead","Runcorn","1-1",1,1,5,5,2,0,"D"
NA,1991,"Kettering Town","Runcorn","3-0",3,0,5,5,3,3,"H"
NA,1991,"Kidderminster Harriers","Runcorn","2-1",2,1,5,5,3,1,"H"
NA,1991,"Macclesfield","Runcorn","3-0",3,0,5,5,3,3,"H"
NA,1991,"Merthyr Tydfil","Runcorn","2-0",2,0,5,5,2,2,"H"
NA,1991,"Northwich Victoria","Runcorn","3-0",3,0,5,5,3,3,"H"
NA,1991,"Redbridge Forest","Runcorn","1-2",1,2,5,5,3,-1,"A"
NA,1991,"Slough Town","Runcorn","1-0",1,0,5,5,1,1,"H"
NA,1991,"Stafford Rangers","Runcorn","1-0",1,0,5,5,1,1,"H"
NA,1991,"Telford United","Runcorn","2-1",2,1,5,5,3,1,"H"
NA,1991,"Welling United","Runcorn","1-2",1,2,5,5,3,-1,"A"
NA,1991,"Witton Albion","Runcorn","1-3",1,3,5,5,4,-2,"A"
NA,1991,"Wycombe Wanderers","Runcorn","1-0",1,0,5,5,1,1,"H"
NA,1991,"Yeovil","Runcorn","1-4",1,4,5,5,5,-3,"A"
NA,1991,"Altrincham","Slough Town","3-7",3,7,5,5,10,-4,"A"
NA,1991,"Barrow","Slough Town","3-4",3,4,5,5,7,-1,"A"
NA,1991,"Bath City","Slough Town","2-1",2,1,5,5,3,1,"H"
NA,1991,"Boston United","Slough Town","3-1",3,1,5,5,4,2,"H"
NA,1991,"Cheltenham","Slough Town","1-0",1,0,5,5,1,1,"H"
NA,1991,"Colchester United","Slough Town","4-0",4,0,5,5,4,4,"H"
NA,1991,"Farnborough Town","Slough Town","2-1",2,1,5,5,3,1,"H"
NA,1991,"Gateshead","Slough Town","2-1",2,1,5,5,3,1,"H"
NA,1991,"Kettering Town","Slough Town","2-3",2,3,5,5,5,-1,"A"
NA,1991,"Kidderminster Harriers","Slough Town","3-3",3,3,5,5,6,0,"D"
NA,1991,"Macclesfield","Slough Town","0-1",0,1,5,5,1,-1,"A"
NA,1991,"Merthyr Tydfil","Slough Town","1-2",1,2,5,5,3,-1,"A"
NA,1991,"Northwich Victoria","Slough Town","3-0",3,0,5,5,3,3,"H"
NA,1991,"Redbridge Forest","Slough Town","4-0",4,0,5,5,4,4,"H"
NA,1991,"Runcorn","Slough Town","1-0",1,0,5,5,1,1,"H"
NA,1991,"Stafford Rangers","Slough Town","1-1",1,1,5,5,2,0,"D"
NA,1991,"Telford United","Slough Town","2-2",2,2,5,5,4,0,"D"
NA,1991,"Welling United","Slough Town","0-2",0,2,5,5,2,-2,"A"
NA,1991,"Witton Albion","Slough Town","2-1",2,1,5,5,3,1,"H"
NA,1991,"Wycombe Wanderers","Slough Town","3-0",3,0,5,5,3,3,"H"
NA,1991,"Yeovil","Slough Town","1-0",1,0,5,5,1,1,"H"
NA,1991,"Altrincham","Stafford Rangers","3-0",3,0,5,5,3,3,"H"
NA,1991,"Barrow","Stafford Rangers","0-0",0,0,5,5,0,0,"D"
NA,1991,"Bath City","Stafford Rangers","0-1",0,1,5,5,1,-1,"A"
NA,1991,"Boston United","Stafford Rangers","2-2",2,2,5,5,4,0,"D"
NA,1991,"Cheltenham","Stafford Rangers","0-0",0,0,5,5,0,0,"D"
NA,1991,"Colchester United","Stafford Rangers","2-0",2,0,5,5,2,2,"H"
NA,1991,"Farnborough Town","Stafford Rangers","1-1",1,1,5,5,2,0,"D"
NA,1991,"Gateshead","Stafford Rangers","0-0",0,0,5,5,0,0,"D"
NA,1991,"Kettering Town","Stafford Rangers","2-1",2,1,5,5,3,1,"H"
NA,1991,"Kidderminster Harriers","Stafford Rangers","2-1",2,1,5,5,3,1,"H"
NA,1991,"Macclesfield","Stafford Rangers","1-0",1,0,5,5,1,1,"H"
NA,1991,"Merthyr Tydfil","Stafford Rangers","1-0",1,0,5,5,1,1,"H"
NA,1991,"Northwich Victoria","Stafford Rangers","1-2",1,2,5,5,3,-1,"A"
NA,1991,"Redbridge Forest","Stafford Rangers","4-3",4,3,5,5,7,1,"H"
NA,1991,"Runcorn","Stafford Rangers","0-0",0,0,5,5,0,0,"D"
NA,1991,"Slough Town","Stafford Rangers","2-2",2,2,5,5,4,0,"D"
NA,1991,"Telford United","Stafford Rangers","4-1",4,1,5,5,5,3,"H"
NA,1991,"Welling United","Stafford Rangers","1-1",1,1,5,5,2,0,"D"
NA,1991,"Witton Albion","Stafford Rangers","6-0",6,0,5,5,6,6,"H"
NA,1991,"Wycombe Wanderers","Stafford Rangers","3-0",3,0,5,5,3,3,"H"
NA,1991,"Yeovil","Stafford Rangers","0-1",0,1,5,5,1,-1,"A"
NA,1991,"Altrincham","Telford United","2-3",2,3,5,5,5,-1,"A"
NA,1991,"Barrow","Telford United","3-0",3,0,5,5,3,3,"H"
NA,1991,"Bath City","Telford United","1-2",1,2,5,5,3,-1,"A"
NA,1991,"Boston United","Telford United","1-2",1,2,5,5,3,-1,"A"
NA,1991,"Cheltenham","Telford United","2-1",2,1,5,5,3,1,"H"
NA,1991,"Colchester United","Telford United","2-0",2,0,5,5,2,2,"H"
NA,1991,"Farnborough Town","Telford United","2-2",2,2,5,5,4,0,"D"
NA,1991,"Gateshead","Telford United","0-2",0,2,5,5,2,-2,"A"
NA,1991,"Kettering Town","Telford United","3-0",3,0,5,5,3,3,"H"
NA,1991,"Kidderminster Harriers","Telford United","1-2",1,2,5,5,3,-1,"A"
NA,1991,"Macclesfield","Telford United","2-1",2,1,5,5,3,1,"H"
NA,1991,"Merthyr Tydfil","Telford United","2-2",2,2,5,5,4,0,"D"
NA,1991,"Northwich Victoria","Telford United","0-1",0,1,5,5,1,-1,"A"
NA,1991,"Redbridge Forest","Telford United","1-0",1,0,5,5,1,1,"H"
NA,1991,"Runcorn","Telford United","0-2",0,2,5,5,2,-2,"A"
NA,1991,"Slough Town","Telford United","0-3",0,3,5,5,3,-3,"A"
NA,1991,"Stafford Rangers","Telford United","3-2",3,2,5,5,5,1,"H"
NA,1991,"Welling United","Telford United","3-1",3,1,5,5,4,2,"H"
NA,1991,"Witton Albion","Telford United","1-1",1,1,5,5,2,0,"D"
NA,1991,"Wycombe Wanderers","Telford United","6-1",6,1,5,5,7,5,"H"
NA,1991,"Yeovil","Telford United","0-2",0,2,5,5,2,-2,"A"
NA,1991,"Altrincham","Welling United","1-2",1,2,5,5,3,-1,"A"
NA,1991,"Barrow","Welling United","6-1",6,1,5,5,7,5,"H"
NA,1991,"Bath City","Welling United","3-2",3,2,5,5,5,1,"H"
NA,1991,"Boston United","Welling United","5-1",5,1,5,5,6,4,"H"
NA,1991,"Cheltenham","Welling United","3-2",3,2,5,5,5,1,"H"
NA,1991,"Colchester United","Welling United","3-1",3,1,5,5,4,2,"H"
NA,1991,"Farnborough Town","Welling United","1-1",1,1,5,5,2,0,"D"
NA,1991,"Gateshead","Welling United","1-1",1,1,5,5,2,0,"D"
NA,1991,"Kettering Town","Welling United","1-1",1,1,5,5,2,0,"D"
NA,1991,"Kidderminster Harriers","Welling United","1-3",1,3,5,5,4,-2,"A"
NA,1991,"Macclesfield","Welling United","1-2",1,2,5,5,3,-1,"A"
NA,1991,"Merthyr Tydfil","Welling United","2-1",2,1,5,5,3,1,"H"
NA,1991,"Northwich Victoria","Welling United","1-2",1,2,5,5,3,-1,"A"
NA,1991,"Redbridge Forest","Welling United","2-0",2,0,5,5,2,2,"H"
NA,1991,"Runcorn","Welling United","2-2",2,2,5,5,4,0,"D"
NA,1991,"Slough Town","Welling United","0-3",0,3,5,5,3,-3,"A"
NA,1991,"Stafford Rangers","Welling United","0-0",0,0,5,5,0,0,"D"
NA,1991,"Telford United","Welling United","2-1",2,1,5,5,3,1,"H"
NA,1991,"Witton Albion","Welling United","2-2",2,2,5,5,4,0,"D"
NA,1991,"Wycombe Wanderers","Welling United","4-0",4,0,5,5,4,4,"H"
NA,1991,"Yeovil","Welling United","3-0",3,0,5,5,3,3,"H"
NA,1991,"Altrincham","Witton Albion","2-2",2,2,5,5,4,0,"D"
NA,1991,"Barrow","Witton Albion","0-1",0,1,5,5,1,-1,"A"
NA,1991,"Bath City","Witton Albion","0-2",0,2,5,5,2,-2,"A"
NA,1991,"Boston United","Witton Albion","3-2",3,2,5,5,5,1,"H"
NA,1991,"Cheltenham","Witton Albion","0-1",0,1,5,5,1,-1,"A"
NA,1991,"Colchester United","Witton Albion","3-1",3,1,5,5,4,2,"H"
NA,1991,"Farnborough Town","Witton Albion","1-1",1,1,5,5,2,0,"D"
NA,1991,"Gateshead","Witton Albion","2-1",2,1,5,5,3,1,"H"
NA,1991,"Kettering Town","Witton Albion","1-1",1,1,5,5,2,0,"D"
NA,1991,"Kidderminster Harriers","Witton Albion","0-1",0,1,5,5,1,-1,"A"
NA,1991,"Macclesfield","Witton Albion","1-0",1,0,5,5,1,1,"H"
NA,1991,"Merthyr Tydfil","Witton Albion","1-0",1,0,5,5,1,1,"H"
NA,1991,"Northwich Victoria","Witton Albion","3-0",3,0,5,5,3,3,"H"
NA,1991,"Redbridge Forest","Witton Albion","3-1",3,1,5,5,4,2,"H"
NA,1991,"Runcorn","Witton Albion","0-1",0,1,5,5,1,-1,"A"
NA,1991,"Slough Town","Witton Albion","2-1",2,1,5,5,3,1,"H"
NA,1991,"Stafford Rangers","Witton Albion","2-1",2,1,5,5,3,1,"H"
NA,1991,"Telford United","Witton Albion","2-1",2,1,5,5,3,1,"H"
NA,1991,"Welling United","Witton Albion","1-1",1,1,5,5,2,0,"D"
NA,1991,"Wycombe Wanderers","Witton Albion","4-0",4,0,5,5,4,4,"H"
NA,1991,"Yeovil","Witton Albion","2-1",2,1,5,5,3,1,"H"
NA,1991,"Altrincham","Wycombe Wanderers","0-4",0,4,5,5,4,-4,"A"
NA,1991,"Barrow","Wycombe Wanderers","0-1",0,1,5,5,1,-1,"A"
NA,1991,"Bath City","Wycombe Wanderers","1-1",1,1,5,5,2,0,"D"
NA,1991,"Boston United","Wycombe Wanderers","2-2",2,2,5,5,4,0,"D"
NA,1991,"Cheltenham","Wycombe Wanderers","2-1",2,1,5,5,3,1,"H"
NA,1991,"Colchester United","Wycombe Wanderers","3-0",3,0,5,5,3,3,"H"
NA,1991,"Farnborough Town","Wycombe Wanderers","1-3",1,3,5,5,4,-2,"A"
NA,1991,"Gateshead","Wycombe Wanderers","2-3",2,3,5,5,5,-1,"A"
NA,1991,"Kettering Town","Wycombe Wanderers","1-1",1,1,5,5,2,0,"D"
NA,1991,"Kidderminster Harriers","Wycombe Wanderers","1-0",1,0,5,5,1,1,"H"
NA,1991,"Macclesfield","Wycombe Wanderers","3-1",3,1,5,5,4,2,"H"
NA,1991,"Merthyr Tydfil","Wycombe Wanderers","1-2",1,2,5,5,3,-1,"A"
NA,1991,"Northwich Victoria","Wycombe Wanderers","0-1",0,1,5,5,1,-1,"A"
NA,1991,"Redbridge Forest","Wycombe Wanderers","0-5",0,5,5,5,5,-5,"A"
NA,1991,"Runcorn","Wycombe Wanderers","1-2",1,2,5,5,3,-1,"A"
NA,1991,"Slough Town","Wycombe Wanderers","0-1",0,1,5,5,1,-1,"A"
NA,1991,"Stafford Rangers","Wycombe Wanderers","0-2",0,2,5,5,2,-2,"A"
NA,1991,"Telford United","Wycombe Wanderers","1-1",1,1,5,5,2,0,"D"
NA,1991,"Welling United","Wycombe Wanderers","1-3",1,3,5,5,4,-2,"A"
NA,1991,"Witton Albion","Wycombe Wanderers","1-2",1,2,5,5,3,-1,"A"
NA,1991,"Yeovil","Wycombe Wanderers","1-0",1,0,5,5,1,1,"H"
NA,1991,"Altrincham","Yeovil","2-1",2,1,5,5,3,1,"H"
NA,1991,"Barrow","Yeovil","0-0",0,0,5,5,0,0,"D"
NA,1991,"Bath City","Yeovil","3-1",3,1,5,5,4,2,"H"
NA,1991,"Boston United","Yeovil","1-3",1,3,5,5,4,-2,"A"
NA,1991,"Cheltenham","Yeovil","1-1",1,1,5,5,2,0,"D"
NA,1991,"Colchester United","Yeovil","4-0",4,0,5,5,4,4,"H"
NA,1991,"Farnborough Town","Yeovil","0-0",0,0,5,5,0,0,"D"
NA,1991,"Gateshead","Yeovil","1-0",1,0,5,5,1,1,"H"
NA,1991,"Kettering Town","Yeovil","2-0",2,0,5,5,2,2,"H"
NA,1991,"Kidderminster Harriers","Yeovil","1-1",1,1,5,5,2,0,"D"
NA,1991,"Macclesfield","Yeovil","1-2",1,2,5,5,3,-1,"A"
NA,1991,"Merthyr Tydfil","Yeovil","2-2",2,2,5,5,4,0,"D"
NA,1991,"Northwich Victoria","Yeovil","1-0",1,0,5,5,1,1,"H"
NA,1991,"Redbridge Forest","Yeovil","0-0",0,0,5,5,0,0,"D"
NA,1991,"Runcorn","Yeovil","2-2",2,2,5,5,4,0,"D"
NA,1991,"Slough Town","Yeovil","1-4",1,4,5,5,5,-3,"A"
NA,1991,"Stafford Rangers","Yeovil","0-0",0,0,5,5,0,0,"D"
NA,1991,"Telford United","Yeovil","1-0",1,0,5,5,1,1,"H"
NA,1991,"Welling United","Yeovil","1-0",1,0,5,5,1,1,"H"
NA,1991,"Witton Albion","Yeovil","3-1",3,1,5,5,4,2,"H"
NA,1991,"Wycombe Wanderers","Yeovil","1-0",1,0,5,5,1,1,"H"
NA,1992,"Bath City","Altrincham","3-0",3,0,5,5,3,3,"H"
NA,1992,"Boston United","Altrincham","1-2",1,2,5,5,3,-1,"A"
NA,1992,"Bromsgrove Rovers","Altrincham","4-1",4,1,5,5,5,3,"H"
NA,1992,"Dagenham and Redbridge","Altrincham","2-2",2,2,5,5,4,0,"D"
NA,1992,"Farnborough Town","Altrincham","2-5",2,5,5,5,7,-3,"A"
NA,1992,"Gateshead","Altrincham","2-0",2,0,5,5,2,2,"H"
NA,1992,"Kettering Town","Altrincham","1-1",1,1,5,5,2,0,"D"
NA,1992,"Kidderminster Harriers","Altrincham","0-1",0,1,5,5,1,-1,"A"
NA,1992,"Macclesfield","Altrincham","1-1",1,1,5,5,2,0,"D"
NA,1992,"Merthyr Tydfil","Altrincham","2-2",2,2,5,5,4,0,"D"
NA,1992,"Northwich Victoria","Altrincham","1-2",1,2,5,5,3,-1,"A"
NA,1992,"Runcorn","Altrincham","0-1",0,1,5,5,1,-1,"A"
NA,1992,"Slough Town","Altrincham","1-4",1,4,5,5,5,-3,"A"
NA,1992,"Stafford Rangers","Altrincham","0-0",0,0,5,5,0,0,"D"
NA,1992,"Stalybridge Celtic","Altrincham","1-0",1,0,5,5,1,1,"H"
NA,1992,"Telford United","Altrincham","2-1",2,1,5,5,3,1,"H"
NA,1992,"Welling United","Altrincham","2-0",2,0,5,5,2,2,"H"
NA,1992,"Witton Albion","Altrincham","1-1",1,1,5,5,2,0,"D"
NA,1992,"Woking","Altrincham","0-2",0,2,5,5,2,-2,"A"
NA,1992,"Wycombe Wanderers","Altrincham","0-2",0,2,5,5,2,-2,"A"
NA,1992,"Yeovil","Altrincham","1-0",1,0,5,5,1,1,"H"
NA,1992,"Altrincham","Bath City","1-0",1,0,5,5,1,1,"H"
NA,1992,"Boston United","Bath City","1-2",1,2,5,5,3,-1,"A"
NA,1992,"Bromsgrove Rovers","Bath City","1-1",1,1,5,5,2,0,"D"
NA,1992,"Dagenham and Redbridge","Bath City","2-1",2,1,5,5,3,1,"H"
NA,1992,"Farnborough Town","Bath City","2-1",2,1,5,5,3,1,"H"
NA,1992,"Gateshead","Bath City","0-4",0,4,5,5,4,-4,"A"
NA,1992,"Kettering Town","Bath City","0-1",0,1,5,5,1,-1,"A"
NA,1992,"Kidderminster Harriers","Bath City","1-0",1,0,5,5,1,1,"H"
NA,1992,"Macclesfield","Bath City","1-0",1,0,5,5,1,1,"H"
NA,1992,"Merthyr Tydfil","Bath City","1-1",1,1,5,5,2,0,"D"
NA,1992,"Northwich Victoria","Bath City","3-1",3,1,5,5,4,2,"H"
NA,1992,"Runcorn","Bath City","1-3",1,3,5,5,4,-2,"A"
NA,1992,"Slough Town","Bath City","1-1",1,1,5,5,2,0,"D"
NA,1992,"Stafford Rangers","Bath City","3-2",3,2,5,5,5,1,"H"
NA,1992,"Stalybridge Celtic","Bath City","1-1",1,1,5,5,2,0,"D"
NA,1992,"Telford United","Bath City","0-0",0,0,5,5,0,0,"D"
NA,1992,"Welling United","Bath City","0-3",0,3,5,5,3,-3,"A"
NA,1992,"Witton Albion","Bath City","0-0",0,0,5,5,0,0,"D"
NA,1992,"Woking","Bath City","0-1",0,1,5,5,1,-1,"A"
NA,1992,"Wycombe Wanderers","Bath City","2-0",2,0,5,5,2,2,"H"
NA,1992,"Yeovil","Bath City","2-1",2,1,5,5,3,1,"H"
NA,1992,"Altrincham","Boston United","1-1",1,1,5,5,2,0,"D"
NA,1992,"Bath City","Boston United","2-1",2,1,5,5,3,1,"H"
NA,1992,"Bromsgrove Rovers","Boston United","2-1",2,1,5,5,3,1,"H"
NA,1992,"Dagenham and Redbridge","Boston United","1-0",1,0,5,5,1,1,"H"
NA,1992,"Farnborough Town","Boston United","4-0",4,0,5,5,4,4,"H"
NA,1992,"Gateshead","Boston United","2-2",2,2,5,5,4,0,"D"
NA,1992,"Kettering Town","Boston United","3-3",3,3,5,5,6,0,"D"
NA,1992,"Kidderminster Harriers","Boston United","0-2",0,2,5,5,2,-2,"A"
NA,1992,"Macclesfield","Boston United","2-1",2,1,5,5,3,1,"H"
NA,1992,"Merthyr Tydfil","Boston United","0-3",0,3,5,5,3,-3,"A"
NA,1992,"Northwich Victoria","Boston United","3-3",3,3,5,5,6,0,"D"
NA,1992,"Runcorn","Boston United","1-2",1,2,5,5,3,-1,"A"
NA,1992,"Slough Town","Boston United","3-0",3,0,5,5,3,3,"H"
NA,1992,"Stafford Rangers","Boston United","0-0",0,0,5,5,0,0,"D"
NA,1992,"Stalybridge Celtic","Boston United","2-1",2,1,5,5,3,1,"H"
NA,1992,"Telford United","Boston United","0-1",0,1,5,5,1,-1,"A"
NA,1992,"Welling United","Boston United","2-2",2,2,5,5,4,0,"D"
NA,1992,"Witton Albion","Boston United","2-0",2,0,5,5,2,2,"H"
NA,1992,"Woking","Boston United","3-0",3,0,5,5,3,3,"H"
NA,1992,"Wycombe Wanderers","Boston United","3-3",3,3,5,5,6,0,"D"
NA,1992,"Yeovil","Boston United","2-1",2,1,5,5,3,1,"H"
NA,1992,"Altrincham","Bromsgrove Rovers","2-2",2,2,5,5,4,0,"D"
NA,1992,"Bath City","Bromsgrove Rovers","0-3",0,3,5,5,3,-3,"A"
NA,1992,"Boston United","Bromsgrove Rovers","1-2",1,2,5,5,3,-1,"A"
NA,1992,"Dagenham and Redbridge","Bromsgrove Rovers","1-1",1,1,5,5,2,0,"D"
NA,1992,"Farnborough Town","Bromsgrove Rovers","1-1",1,1,5,5,2,0,"D"
NA,1992,"Gateshead","Bromsgrove Rovers","0-0",0,0,5,5,0,0,"D"
NA,1992,"Kettering Town","Bromsgrove Rovers","3-2",3,2,5,5,5,1,"H"
NA,1992,"Kidderminster Harriers","Bromsgrove Rovers","1-0",1,0,5,5,1,1,"H"
NA,1992,"Macclesfield","Bromsgrove Rovers","0-2",0,2,5,5,2,-2,"A"
NA,1992,"Merthyr Tydfil","Bromsgrove Rovers","1-1",1,1,5,5,2,0,"D"
NA,1992,"Northwich Victoria","Bromsgrove Rovers","0-1",0,1,5,5,1,-1,"A"
NA,1992,"Runcorn","Bromsgrove Rovers","2-1",2,1,5,5,3,1,"H"
NA,1992,"Slough Town","Bromsgrove Rovers","1-3",1,3,5,5,4,-2,"A"
NA,1992,"Stafford Rangers","Bromsgrove Rovers","3-4",3,4,5,5,7,-1,"A"
NA,1992,"Stalybridge Celtic","Bromsgrove Rovers","0-1",0,1,5,5,1,-1,"A"
NA,1992,"Telford United","Bromsgrove Rovers","0-1",0,1,5,5,1,-1,"A"
NA,1992,"Welling United","Bromsgrove Rovers","4-2",4,2,5,5,6,2,"H"
NA,1992,"Witton Albion","Bromsgrove Rovers","1-1",1,1,5,5,2,0,"D"
NA,1992,"Woking","Bromsgrove Rovers","0-2",0,2,5,5,2,-2,"A"
NA,1992,"Wycombe Wanderers","Bromsgrove Rovers","4-0",4,0,5,5,4,4,"H"
NA,1992,"Yeovil","Bromsgrove Rovers","2-2",2,2,5,5,4,0,"D"
NA,1992,"Altrincham","Dagenham and Redbridge","1-0",1,0,5,5,1,1,"H"
NA,1992,"Bath City","Dagenham and Redbridge","2-1",2,1,5,5,3,1,"H"
NA,1992,"Boston United","Dagenham and Redbridge","3-1",3,1,5,5,4,2,"H"
NA,1992,"Bromsgrove Rovers","Dagenham and Redbridge","1-2",1,2,5,5,3,-1,"A"
NA,1992,"Farnborough Town","Dagenham and Redbridge","1-4",1,4,5,5,5,-3,"A"
NA,1992,"Gateshead","Dagenham and Redbridge","1-1",1,1,5,5,2,0,"D"
NA,1992,"Kettering Town","Dagenham and Redbridge","0-0",0,0,5,5,0,0,"D"
NA,1992,"Kidderminster Harriers","Dagenham and Redbridge","0-1",0,1,5,5,1,-1,"A"
NA,1992,"Macclesfield","Dagenham and Redbridge","1-1",1,1,5,5,2,0,"D"
NA,1992,"Merthyr Tydfil","Dagenham and Redbridge","0-2",0,2,5,5,2,-2,"A"
NA,1992,"Northwich Victoria","Dagenham and Redbridge","1-1",1,1,5,5,2,0,"D"
NA,1992,"Runcorn","Dagenham and Redbridge","1-0",1,0,5,5,1,1,"H"
NA,1992,"Slough Town","Dagenham and Redbridge","2-0",2,0,5,5,2,2,"H"
NA,1992,"Stafford Rangers","Dagenham and Redbridge","0-1",0,1,5,5,1,-1,"A"
NA,1992,"Stalybridge Celtic","Dagenham and Redbridge","0-3",0,3,5,5,3,-3,"A"
NA,1992,"Telford United","Dagenham and Redbridge","0-1",0,1,5,5,1,-1,"A"
NA,1992,"Welling United","Dagenham and Redbridge","0-2",0,2,5,5,2,-2,"A"
NA,1992,"Witton Albion","Dagenham and Redbridge","2-2",2,2,5,5,4,0,"D"
NA,1992,"Woking","Dagenham and Redbridge","1-1",1,1,5,5,2,0,"D"
NA,1992,"Wycombe Wanderers","Dagenham and Redbridge","1-0",1,0,5,5,1,1,"H"
NA,1992,"Yeovil","Dagenham and Redbridge","0-3",0,3,5,5,3,-3,"A"
NA,1992,"Altrincham","Farnborough Town","2-2",2,2,5,5,4,0,"D"
NA,1992,"Bath City","Farnborough Town","5-2",5,2,5,5,7,3,"H"
NA,1992,"Boston United","Farnborough Town","0-0",0,0,5,5,0,0,"D"
NA,1992,"Bromsgrove Rovers","Farnborough Town","2-2",2,2,5,5,4,0,"D"
NA,1992,"Dagenham and Redbridge","Farnborough Town","5-1",5,1,5,5,6,4,"H"
NA,1992,"Gateshead","Farnborough Town","1-0",1,0,5,5,1,1,"H"
NA,1992,"Kettering Town","Farnborough Town","2-1",2,1,5,5,3,1,"H"
NA,1992,"Kidderminster Harriers","Farnborough Town","1-5",1,5,5,5,6,-4,"A"
NA,1992,"Macclesfield","Farnborough Town","1-2",1,2,5,5,3,-1,"A"
NA,1992,"Merthyr Tydfil","Farnborough Town","1-3",1,3,5,5,4,-2,"A"
NA,1992,"Northwich Victoria","Farnborough Town","3-0",3,0,5,5,3,3,"H"
NA,1992,"Runcorn","Farnborough Town","1-4",1,4,5,5,5,-3,"A"
NA,1992,"Slough Town","Farnborough Town","3-1",3,1,5,5,4,2,"H"
NA,1992,"Stafford Rangers","Farnborough Town","2-2",2,2,5,5,4,0,"D"
NA,1992,"Stalybridge Celtic","Farnborough Town","2-0",2,0,5,5,2,2,"H"
NA,1992,"Telford United","Farnborough Town","6-3",6,3,5,5,9,3,"H"
NA,1992,"Welling United","Farnborough Town","3-1",3,1,5,5,4,2,"H"
NA,1992,"Witton Albion","Farnborough Town","1-1",1,1,5,5,2,0,"D"
NA,1992,"Woking","Farnborough Town","4-1",4,1,5,5,5,3,"H"
NA,1992,"Wycombe Wanderers","Farnborough Town","1-1",1,1,5,5,2,0,"D"
NA,1992,"Yeovil","Farnborough Town","5-2",5,2,5,5,7,3,"H"
NA,1992,"Altrincham","Gateshead","0-1",0,1,5,5,1,-1,"A"
NA,1992,"Bath City","Gateshead","1-1",1,1,5,5,2,0,"D"
NA,1992,"Boston United","Gateshead","0-2",0,2,5,5,2,-2,"A"
NA,1992,"Bromsgrove Rovers","Gateshead","3-0",3,0,5,5,3,3,"H"
NA,1992,"Dagenham and Redbridge","Gateshead","3-1",3,1,5,5,4,2,"H"
NA,1992,"Farnborough Town","Gateshead","6-1",6,1,5,5,7,5,"H"
NA,1992,"Kettering Town","Gateshead","2-0",2,0,5,5,2,2,"H"
NA,1992,"Kidderminster Harriers","Gateshead","3-3",3,3,5,5,6,0,"D"
NA,1992,"Macclesfield","Gateshead","1-0",1,0,5,5,1,1,"H"
NA,1992,"Merthyr Tydfil","Gateshead","1-1",1,1,5,5,2,0,"D"
NA,1992,"Northwich Victoria","Gateshead","0-0",0,0,5,5,0,0,"D"
NA,1992,"Runcorn","Gateshead","4-2",4,2,5,5,6,2,"H"
NA,1992,"Slough Town","Gateshead","1-0",1,0,5,5,1,1,"H"
NA,1992,"Stafford Rangers","Gateshead","2-1",2,1,5,5,3,1,"H"
NA,1992,"Stalybridge Celtic","Gateshead","2-1",2,1,5,5,3,1,"H"
NA,1992,"Telford United","Gateshead","1-0",1,0,5,5,1,1,"H"
NA,1992,"Welling United","Gateshead","2-1",2,1,5,5,3,1,"H"
NA,1992,"Witton Albion","Gateshead","1-3",1,3,5,5,4,-2,"A"
NA,1992,"Woking","Gateshead","1-4",1,4,5,5,5,-3,"A"
NA,1992,"Wycombe Wanderers","Gateshead","2-1",2,1,5,5,3,1,"H"
NA,1992,"Yeovil","Gateshead","1-3",1,3,5,5,4,-2,"A"
NA,1992,"Altrincham","Kettering Town","3-0",3,0,5,5,3,3,"H"
NA,1992,"Bath City","Kettering Town","0-0",0,0,5,5,0,0,"D"
NA,1992,"Boston United","Kettering Town","0-1",0,1,5,5,1,-1,"A"
NA,1992,"Bromsgrove Rovers","Kettering Town","1-1",1,1,5,5,2,0,"D"
NA,1992,"Dagenham and Redbridge","Kettering Town","1-2",1,2,5,5,3,-1,"A"
NA,1992,"Farnborough Town","Kettering Town","3-2",3,2,5,5,5,1,"H"
NA,1992,"Gateshead","Kettering Town","1-1",1,1,5,5,2,0,"D"
NA,1992,"Kidderminster Harriers","Kettering Town","0-0",0,0,5,5,0,0,"D"
NA,1992,"Macclesfield","Kettering Town","1-0",1,0,5,5,1,1,"H"
NA,1992,"Merthyr Tydfil","Kettering Town","2-1",2,1,5,5,3,1,"H"
NA,1992,"Northwich Victoria","Kettering Town","2-2",2,2,5,5,4,0,"D"
NA,1992,"Runcorn","Kettering Town","2-2",2,2,5,5,4,0,"D"
NA,1992,"Slough Town","Kettering Town","3-0",3,0,5,5,3,3,"H"
NA,1992,"Stafford Rangers","Kettering Town","2-4",2,4,5,5,6,-2,"A"
NA,1992,"Stalybridge Celtic","Kettering Town","0-0",0,0,5,5,0,0,"D"
NA,1992,"Telford United","Kettering Town","3-1",3,1,5,5,4,2,"H"
NA,1992,"Welling United","Kettering Town","1-1",1,1,5,5,2,0,"D"
NA,1992,"Witton Albion","Kettering Town","4-2",4,2,5,5,6,2,"H"
NA,1992,"Woking","Kettering Town","3-2",3,2,5,5,5,1,"H"
NA,1992,"Wycombe Wanderers","Kettering Town","1-2",1,2,5,5,3,-1,"A"
NA,1992,"Yeovil","Kettering Town","2-1",2,1,5,5,3,1,"H"
NA,1992,"Altrincham","Kidderminster Harriers","2-2",2,2,5,5,4,0,"D"
NA,1992,"Bath City","Kidderminster Harriers","2-1",2,1,5,5,3,1,"H"
NA,1992,"Boston United","Kidderminster Harriers","0-3",0,3,5,5,3,-3,"A"
NA,1992,"Bromsgrove Rovers","Kidderminster Harriers","2-2",2,2,5,5,4,0,"D"
NA,1992,"Dagenham and Redbridge","Kidderminster Harriers","3-2",3,2,5,5,5,1,"H"
NA,1992,"Farnborough Town","Kidderminster Harriers","2-2",2,2,5,5,4,0,"D"
NA,1992,"Gateshead","Kidderminster Harriers","1-0",1,0,5,5,1,1,"H"
NA,1992,"Kettering Town","Kidderminster Harriers","1-2",1,2,5,5,3,-1,"A"
NA,1992,"Macclesfield","Kidderminster Harriers","1-1",1,1,5,5,2,0,"D"
NA,1992,"Merthyr Tydfil","Kidderminster Harriers","4-3",4,3,5,5,7,1,"H"
NA,1992,"Northwich Victoria","Kidderminster Harriers","0-1",0,1,5,5,1,-1,"A"
NA,1992,"Runcorn","Kidderminster Harriers","0-0",0,0,5,5,0,0,"D"
NA,1992,"Slough Town","Kidderminster Harriers","3-1",3,1,5,5,4,2,"H"
NA,1992,"Stafford Rangers","Kidderminster Harriers","0-1",0,1,5,5,1,-1,"A"
NA,1992,"Stalybridge Celtic","Kidderminster Harriers","2-2",2,2,5,5,4,0,"D"
NA,1992,"Telford United","Kidderminster Harriers","1-1",1,1,5,5,2,0,"D"
NA,1992,"Welling United","Kidderminster Harriers","0-0",0,0,5,5,0,0,"D"
NA,1992,"Witton Albion","Kidderminster Harriers","2-2",2,2,5,5,4,0,"D"
NA,1992,"Woking","Kidderminster Harriers","1-5",1,5,5,5,6,-4,"A"
NA,1992,"Wycombe Wanderers","Kidderminster Harriers","1-1",1,1,5,5,2,0,"D"
NA,1992,"Yeovil","Kidderminster Harriers","2-2",2,2,5,5,4,0,"D"
NA,1992,"Altrincham","Macclesfield","1-0",1,0,5,5,1,1,"H"
NA,1992,"Bath City","Macclesfield","0-0",0,0,5,5,0,0,"D"
NA,1992,"Boston United","Macclesfield","3-1",3,1,5,5,4,2,"H"
NA,1992,"Bromsgrove Rovers","Macclesfield","3-0",3,0,5,5,3,3,"H"
NA,1992,"Dagenham and Redbridge","Macclesfield","1-2",1,2,5,5,3,-1,"A"
NA,1992,"Farnborough Town","Macclesfield","0-0",0,0,5,5,0,0,"D"
NA,1992,"Gateshead","Macclesfield","1-0",1,0,5,5,1,1,"H"
NA,1992,"Kettering Town","Macclesfield","1-0",1,0,5,5,1,1,"H"
NA,1992,"Kidderminster Harriers","Macclesfield","2-1",2,1,5,5,3,1,"H"
NA,1992,"Merthyr Tydfil","Macclesfield","1-2",1,2,5,5,3,-1,"A"
NA,1992,"Northwich Victoria","Macclesfield","1-3",1,3,5,5,4,-2,"A"
NA,1992,"Runcorn","Macclesfield","1-2",1,2,5,5,3,-1,"A"
NA,1992,"Slough Town","Macclesfield","2-1",2,1,5,5,3,1,"H"
NA,1992,"Stafford Rangers","Macclesfield","1-0",1,0,5,5,1,1,"H"
NA,1992,"Stalybridge Celtic","Macclesfield","2-1",2,1,5,5,3,1,"H"
NA,1992,"Telford United","Macclesfield","3-1",3,1,5,5,4,2,"H"
NA,1992,"Welling United","Macclesfield","1-0",1,0,5,5,1,1,"H"
NA,1992,"Witton Albion","Macclesfield","1-1",1,1,5,5,2,0,"D"
NA,1992,"Woking","Macclesfield","4-0",4,0,5,5,4,4,"H"
NA,1992,"Wycombe Wanderers","Macclesfield","0-1",0,1,5,5,1,-1,"A"
NA,1992,"Yeovil","Macclesfield","1-1",1,1,5,5,2,0,"D"
NA,1992,"Altrincham","Merthyr Tydfil","0-1",0,1,5,5,1,-1,"A"
NA,1992,"Bath City","Merthyr Tydfil","1-3",1,3,5,5,4,-2,"A"
NA,1992,"Boston United","Merthyr Tydfil","2-0",2,0,5,5,2,2,"H"
NA,1992,"Bromsgrove Rovers","Merthyr Tydfil","1-2",1,2,5,5,3,-1,"A"
NA,1992,"Dagenham and Redbridge","Merthyr Tydfil","6-1",6,1,5,5,7,5,"H"
NA,1992,"Farnborough Town","Merthyr Tydfil","2-1",2,1,5,5,3,1,"H"
NA,1992,"Gateshead","Merthyr Tydfil","4-0",4,0,5,5,4,4,"H"
NA,1992,"Kettering Town","Merthyr Tydfil","1-3",1,3,5,5,4,-2,"A"
NA,1992,"Kidderminster Harriers","Merthyr Tydfil","1-0",1,0,5,5,1,1,"H"
NA,1992,"Macclesfield","Merthyr Tydfil","0-1",0,1,5,5,1,-1,"A"
NA,1992,"Northwich Victoria","Merthyr Tydfil","1-2",1,2,5,5,3,-1,"A"
NA,1992,"Runcorn","Merthyr Tydfil","2-3",2,3,5,5,5,-1,"A"
NA,1992,"Slough Town","Merthyr Tydfil","2-1",2,1,5,5,3,1,"H"
NA,1992,"Stafford Rangers","Merthyr Tydfil","0-1",0,1,5,5,1,-1,"A"
NA,1992,"Stalybridge Celtic","Merthyr Tydfil","2-2",2,2,5,5,4,0,"D"
NA,1992,"Telford United","Merthyr Tydfil","5-0",5,0,5,5,5,5,"H"
NA,1992,"Welling United","Merthyr Tydfil","5-0",5,0,5,5,5,5,"H"
NA,1992,"Witton Albion","Merthyr Tydfil","3-1",3,1,5,5,4,2,"H"
NA,1992,"Woking","Merthyr Tydfil","0-2",0,2,5,5,2,-2,"A"
NA,1992,"Wycombe Wanderers","Merthyr Tydfil","4-0",4,0,5,5,4,4,"H"
NA,1992,"Yeovil","Merthyr Tydfil","0-1",0,1,5,5,1,-1,"A"
NA,1992,"Altrincham","Northwich Victoria","0-0",0,0,5,5,0,0,"D"
NA,1992,"Bath City","Northwich Victoria","0-5",0,5,5,5,5,-5,"A"
NA,1992,"Boston United","Northwich Victoria","3-5",3,5,5,5,8,-2,"A"
NA,1992,"Bromsgrove Rovers","Northwich Victoria","1-2",1,2,5,5,3,-1,"A"
NA,1992,"Dagenham and Redbridge","Northwich Victoria","4-1",4,1,5,5,5,3,"H"
NA,1992,"Farnborough Town","Northwich Victoria","0-3",0,3,5,5,3,-3,"A"
NA,1992,"Gateshead","Northwich Victoria","0-2",0,2,5,5,2,-2,"A"
NA,1992,"Kettering Town","Northwich Victoria","2-1",2,1,5,5,3,1,"H"
NA,1992,"Kidderminster Harriers","Northwich Victoria","5-3",5,3,5,5,8,2,"H"
NA,1992,"Macclesfield","Northwich Victoria","1-2",1,2,5,5,3,-1,"A"
NA,1992,"Merthyr Tydfil","Northwich Victoria","3-0",3,0,5,5,3,3,"H"
NA,1992,"Runcorn","Northwich Victoria","0-1",0,1,5,5,1,-1,"A"
NA,1992,"Slough Town","Northwich Victoria","0-4",0,4,5,5,4,-4,"A"
NA,1992,"Stafford Rangers","Northwich Victoria","1-0",1,0,5,5,1,1,"H"
NA,1992,"Stalybridge Celtic","Northwich Victoria","0-6",0,6,5,5,6,-6,"A"
NA,1992,"Telford United","Northwich Victoria","1-0",1,0,5,5,1,1,"H"
NA,1992,"Welling United","Northwich Victoria","1-5",1,5,5,5,6,-4,"A"
NA,1992,"Witton Albion","Northwich Victoria","1-3",1,3,5,5,4,-2,"A"
NA,1992,"Woking","Northwich Victoria","1-0",1,0,5,5,1,1,"H"
NA,1992,"Wycombe Wanderers","Northwich Victoria","1-0",1,0,5,5,1,1,"H"
NA,1992,"Yeovil","Northwich Victoria","1-1",1,1,5,5,2,0,"D"
NA,1992,"Altrincham","Runcorn","0-2",0,2,5,5,2,-2,"A"
NA,1992,"Bath City","Runcorn","1-1",1,1,5,5,2,0,"D"
NA,1992,"Boston United","Runcorn","0-0",0,0,5,5,0,0,"D"
NA,1992,"Bromsgrove Rovers","Runcorn","0-0",0,0,5,5,0,0,"D"
NA,1992,"Dagenham and Redbridge","Runcorn","5-1",5,1,5,5,6,4,"H"
NA,1992,"Farnborough Town","Runcorn","2-3",2,3,5,5,5,-1,"A"
NA,1992,"Gateshead","Runcorn","4-1",4,1,5,5,5,3,"H"
NA,1992,"Kettering Town","Runcorn","3-3",3,3,5,5,6,0,"D"
NA,1992,"Kidderminster Harriers","Runcorn","2-0",2,0,5,5,2,2,"H"
NA,1992,"Macclesfield","Runcorn","1-1",1,1,5,5,2,0,"D"
NA,1992,"Merthyr Tydfil","Runcorn","0-3",0,3,5,5,3,-3,"A"
NA,1992,"Northwich Victoria","Runcorn","3-2",3,2,5,5,5,1,"H"
NA,1992,"Slough Town","Runcorn","1-1",1,1,5,5,2,0,"D"
NA,1992,"Stafford Rangers","Runcorn","0-1",0,1,5,5,1,-1,"A"
NA,1992,"Stalybridge Celtic","Runcorn","0-0",0,0,5,5,0,0,"D"
NA,1992,"Telford United","Runcorn","2-1",2,1,5,5,3,1,"H"
NA,1992,"Welling United","Runcorn","3-2",3,2,5,5,5,1,"H"
NA,1992,"Witton Albion","Runcorn","0-3",0,3,5,5,3,-3,"A"
NA,1992,"Woking","Runcorn","4-0",4,0,5,5,4,4,"H"
NA,1992,"Wycombe Wanderers","Runcorn","5-1",5,1,5,5,6,4,"H"
NA,1992,"Yeovil","Runcorn","4-0",4,0,5,5,4,4,"H"
NA,1992,"Altrincham","Slough Town","1-1",1,1,5,5,2,0,"D"
NA,1992,"Bath City","Slough Town","0-1",0,1,5,5,1,-1,"A"
NA,1992,"Boston United","Slough Town","0-0",0,0,5,5,0,0,"D"
NA,1992,"Bromsgrove Rovers","Slough Town","0-1",0,1,5,5,1,-1,"A"
NA,1992,"Dagenham and Redbridge","Slough Town","4-4",4,4,5,5,8,0,"D"
NA,1992,"Farnborough Town","Slough Town","1-0",1,0,5,5,1,1,"H"
NA,1992,"Gateshead","Slough Town","1-0",1,0,5,5,1,1,"H"
NA,1992,"Kettering Town","Slough Town","5-0",5,0,5,5,5,5,"H"
NA,1992,"Kidderminster Harriers","Slough Town","1-1",1,1,5,5,2,0,"D"
NA,1992,"Macclesfield","Slough Town","1-2",1,2,5,5,3,-1,"A"
NA,1992,"Merthyr Tydfil","Slough Town","1-1",1,1,5,5,2,0,"D"
NA,1992,"Northwich Victoria","Slough Town","0-1",0,1,5,5,1,-1,"A"
NA,1992,"Runcorn","Slough Town","0-3",0,3,5,5,3,-3,"A"
NA,1992,"Stafford Rangers","Slough Town","1-0",1,0,5,5,1,1,"H"
NA,1992,"Stalybridge Celtic","Slough Town","0-0",0,0,5,5,0,0,"D"
NA,1992,"Telford United","Slough Town","1-1",1,1,5,5,2,0,"D"
NA,1992,"Welling United","Slough Town","2-1",2,1,5,5,3,1,"H"
NA,1992,"Witton Albion","Slough Town","1-1",1,1,5,5,2,0,"D"
NA,1992,"Woking","Slough Town","1-2",1,2,5,5,3,-1,"A"
NA,1992,"Wycombe Wanderers","Slough Town","1-0",1,0,5,5,1,1,"H"
NA,1992,"Yeovil","Slough Town","5-1",5,1,5,5,6,4,"H"
NA,1992,"Altrincham","Stafford Rangers","1-5",1,5,5,5,6,-4,"A"
NA,1992,"Bath City","Stafford Rangers","2-1",2,1,5,5,3,1,"H"
NA,1992,"Boston United","Stafford Rangers","0-1",0,1,5,5,1,-1,"A"
NA,1992,"Bromsgrove Rovers","Stafford Rangers","2-3",2,3,5,5,5,-1,"A"
NA,1992,"Dagenham and Redbridge","Stafford Rangers","0-1",0,1,5,5,1,-1,"A"
NA,1992,"Farnborough Town","Stafford Rangers","1-1",1,1,5,5,2,0,"D"
NA,1992,"Gateshead","Stafford Rangers","0-1",0,1,5,5,1,-1,"A"
NA,1992,"Kettering Town","Stafford Rangers","2-0",2,0,5,5,2,2,"H"
NA,1992,"Kidderminster Harriers","Stafford Rangers","0-2",0,2,5,5,2,-2,"A"
NA,1992,"Macclesfield","Stafford Rangers","4-1",4,1,5,5,5,3,"H"
NA,1992,"Merthyr Tydfil","Stafford Rangers","0-0",0,0,5,5,0,0,"D"
NA,1992,"Northwich Victoria","Stafford Rangers","1-2",1,2,5,5,3,-1,"A"
NA,1992,"Runcorn","Stafford Rangers","0-2",0,2,5,5,2,-2,"A"
NA,1992,"Slough Town","Stafford Rangers","2-1",2,1,5,5,3,1,"H"
NA,1992,"Stalybridge Celtic","Stafford Rangers","1-0",1,0,5,5,1,1,"H"
NA,1992,"Telford United","Stafford Rangers","0-0",0,0,5,5,0,0,"D"
NA,1992,"Welling United","Stafford Rangers","1-2",1,2,5,5,3,-1,"A"
NA,1992,"Witton Albion","Stafford Rangers","2-5",2,5,5,5,7,-3,"A"
NA,1992,"Woking","Stafford Rangers","0-3",0,3,5,5,3,-3,"A"
NA,1992,"Wycombe Wanderers","Stafford Rangers","2-2",2,2,5,5,4,0,"D"
NA,1992,"Yeovil","Stafford Rangers","2-0",2,0,5,5,2,2,"H"
NA,1992,"Altrincham","Stalybridge Celtic","0-0",0,0,5,5,0,0,"D"
NA,1992,"Bath City","Stalybridge Celtic","1-1",1,1,5,5,2,0,"D"
NA,1992,"Boston United","Stalybridge Celtic","1-1",1,1,5,5,2,0,"D"
NA,1992,"Bromsgrove Rovers","Stalybridge Celtic","4-0",4,0,5,5,4,4,"H"
NA,1992,"Dagenham and Redbridge","Stalybridge Celtic","1-2",1,2,5,5,3,-1,"A"
NA,1992,"Farnborough Town","Stalybridge Celtic","1-2",1,2,5,5,3,-1,"A"
NA,1992,"Gateshead","Stalybridge Celtic","0-0",0,0,5,5,0,0,"D"
NA,1992,"Kettering Town","Stalybridge Celtic","2-0",2,0,5,5,2,2,"H"
NA,1992,"Kidderminster Harriers","Stalybridge Celtic","2-1",2,1,5,5,3,1,"H"
NA,1992,"Macclesfield","Stalybridge Celtic","1-0",1,0,5,5,1,1,"H"
NA,1992,"Merthyr Tydfil","Stalybridge Celtic","1-1",1,1,5,5,2,0,"D"
NA,1992,"Northwich Victoria","Stalybridge Celtic","1-3",1,3,5,5,4,-2,"A"
NA,1992,"Runcorn","Stalybridge Celtic","2-1",2,1,5,5,3,1,"H"
NA,1992,"Slough Town","Stalybridge Celtic","2-3",2,3,5,5,5,-1,"A"
NA,1992,"Stafford Rangers","Stalybridge Celtic","0-0",0,0,5,5,0,0,"D"
NA,1992,"Telford United","Stalybridge Celtic","0-2",0,2,5,5,2,-2,"A"
NA,1992,"Welling United","Stalybridge Celtic","1-4",1,4,5,5,5,-3,"A"
NA,1992,"Witton Albion","Stalybridge Celtic","2-0",2,0,5,5,2,2,"H"
NA,1992,"Woking","Stalybridge Celtic","2-1",2,1,5,5,3,1,"H"
NA,1992,"Wycombe Wanderers","Stalybridge Celtic","4-0",4,0,5,5,4,4,"H"
NA,1992,"Yeovil","Stalybridge Celtic","1-1",1,1,5,5,2,0,"D"
NA,1992,"Altrincham","Telford United","0-3",0,3,5,5,3,-3,"A"
NA,1992,"Bath City","Telford United","4-1",4,1,5,5,5,3,"H"
NA,1992,"Boston United","Telford United","2-2",2,2,5,5,4,0,"D"
NA,1992,"Bromsgrove Rovers","Telford United","0-0",0,0,5,5,0,0,"D"
NA,1992,"Dagenham and Redbridge","Telford United","0-2",0,2,5,5,2,-2,"A"
NA,1992,"Farnborough Town","Telford United","0-1",0,1,5,5,1,-1,"A"
NA,1992,"Gateshead","Telford United","0-1",0,1,5,5,1,-1,"A"
NA,1992,"Kettering Town","Telford United","1-1",1,1,5,5,2,0,"D"
NA,1992,"Kidderminster Harriers","Telford United","2-1",2,1,5,5,3,1,"H"
NA,1992,"Macclesfield","Telford United","1-1",1,1,5,5,2,0,"D"
NA,1992,"Merthyr Tydfil","Telford United","4-0",4,0,5,5,4,4,"H"
NA,1992,"Northwich Victoria","Telford United","1-0",1,0,5,5,1,1,"H"
NA,1992,"Runcorn","Telford United","3-1",3,1,5,5,4,2,"H"
NA,1992,"Slough Town","Telford United","2-0",2,0,5,5,2,2,"H"
NA,1992,"Stafford Rangers","Telford United","2-1",2,1,5,5,3,1,"H"
NA,1992,"Stalybridge Celtic","Telford United","3-3",3,3,5,5,6,0,"D"
NA,1992,"Welling United","Telford United","1-3",1,3,5,5,4,-2,"A"
NA,1992,"Witton Albion","Telford United","2-1",2,1,5,5,3,1,"H"
NA,1992,"Woking","Telford United","3-2",3,2,5,5,5,1,"H"
NA,1992,"Wycombe Wanderers","Telford United","4-0",4,0,5,5,4,4,"H"
NA,1992,"Yeovil","Telford United","1-0",1,0,5,5,1,1,"H"
NA,1992,"Altrincham","Welling United","2-0",2,0,5,5,2,2,"H"
NA,1992,"Bath City","Welling United","1-1",1,1,5,5,2,0,"D"
NA,1992,"Boston United","Welling United","2-1",2,1,5,5,3,1,"H"
NA,1992,"Bromsgrove Rovers","Welling United","2-2",2,2,5,5,4,0,"D"
NA,1992,"Dagenham and Redbridge","Welling United","1-0",1,0,5,5,1,1,"H"
NA,1992,"Farnborough Town","Welling United","3-2",3,2,5,5,5,1,"H"
NA,1992,"Gateshead","Welling United","1-2",1,2,5,5,3,-1,"A"
NA,1992,"Kettering Town","Welling United","2-4",2,4,5,5,6,-2,"A"
NA,1992,"Kidderminster Harriers","Welling United","2-1",2,1,5,5,3,1,"H"
NA,1992,"Macclesfield","Welling United","1-1",1,1,5,5,2,0,"D"
NA,1992,"Merthyr Tydfil","Welling United","1-1",1,1,5,5,2,0,"D"
NA,1992,"Northwich Victoria","Welling United","1-1",1,1,5,5,2,0,"D"
NA,1992,"Runcorn","Welling United","3-0",3,0,5,5,3,3,"H"
NA,1992,"Slough Town","Welling United","4-2",4,2,5,5,6,2,"H"
NA,1992,"Stafford Rangers","Welling United","4-3",4,3,5,5,7,1,"H"
NA,1992,"Stalybridge Celtic","Welling United","0-0",0,0,5,5,0,0,"D"
NA,1992,"Telford United","Welling United","0-1",0,1,5,5,1,-1,"A"
NA,1992,"Witton Albion","Welling United","0-1",0,1,5,5,1,-1,"A"
NA,1992,"Woking","Welling United","1-0",1,0,5,5,1,1,"H"
NA,1992,"Wycombe Wanderers","Welling United","3-0",3,0,5,5,3,3,"H"
NA,1992,"Yeovil","Welling United","1-0",1,0,5,5,1,1,"H"
NA,1992,"Altrincham","Witton Albion","2-1",2,1,5,5,3,1,"H"
NA,1992,"Bath City","Witton Albion","0-0",0,0,5,5,0,0,"D"
NA,1992,"Boston United","Witton Albion","2-2",2,2,5,5,4,0,"D"
NA,1992,"Bromsgrove Rovers","Witton Albion","3-2",3,2,5,5,5,1,"H"
NA,1992,"Dagenham and Redbridge","Witton Albion","1-1",1,1,5,5,2,0,"D"
NA,1992,"Farnborough Town","Witton Albion","1-1",1,1,5,5,2,0,"D"
NA,1992,"Gateshead","Witton Albion","3-1",3,1,5,5,4,2,"H"
NA,1992,"Kettering Town","Witton Albion","2-1",2,1,5,5,3,1,"H"
NA,1992,"Kidderminster Harriers","Witton Albion","0-0",0,0,5,5,0,0,"D"
NA,1992,"Macclesfield","Witton Albion","1-0",1,0,5,5,1,1,"H"
NA,1992,"Merthyr Tydfil","Witton Albion","0-2",0,2,5,5,2,-2,"A"
NA,1992,"Northwich Victoria","Witton Albion","1-3",1,3,5,5,4,-2,"A"
NA,1992,"Runcorn","Witton Albion","4-4",4,4,5,5,8,0,"D"
NA,1992,"Slough Town","Witton Albion","2-3",2,3,5,5,5,-1,"A"
NA,1992,"Stafford Rangers","Witton Albion","1-1",1,1,5,5,2,0,"D"
NA,1992,"Stalybridge Celtic","Witton Albion","1-2",1,2,5,5,3,-1,"A"
NA,1992,"Telford United","Witton Albion","0-3",0,3,5,5,3,-3,"A"
NA,1992,"Welling United","Witton Albion","2-2",2,2,5,5,4,0,"D"
NA,1992,"Woking","Witton Albion","1-2",1,2,5,5,3,-1,"A"
NA,1992,"Wycombe Wanderers","Witton Albion","2-1",2,1,5,5,3,1,"H"
NA,1992,"Yeovil","Witton Albion","2-0",2,0,5,5,2,2,"H"
NA,1992,"Altrincham","Woking","1-0",1,0,5,5,1,1,"H"
NA,1992,"Bath City","Woking","2-0",2,0,5,5,2,2,"H"
NA,1992,"Boston United","Woking","1-2",1,2,5,5,3,-1,"A"
NA,1992,"Bromsgrove Rovers","Woking","1-0",1,0,5,5,1,1,"H"
NA,1992,"Dagenham and Redbridge","Woking","5-1",5,1,5,5,6,4,"H"
NA,1992,"Farnborough Town","Woking","0-3",0,3,5,5,3,-3,"A"
NA,1992,"Gateshead","Woking","1-1",1,1,5,5,2,0,"D"
NA,1992,"Kettering Town","Woking","0-1",0,1,5,5,1,-1,"A"
NA,1992,"Kidderminster Harriers","Woking","1-3",1,3,5,5,4,-2,"A"
NA,1992,"Macclesfield","Woking","1-1",1,1,5,5,2,0,"D"
NA,1992,"Merthyr Tydfil","Woking","1-5",1,5,5,5,6,-4,"A"
NA,1992,"Northwich Victoria","Woking","1-0",1,0,5,5,1,1,"H"
NA,1992,"Runcorn","Woking","2-3",2,3,5,5,5,-1,"A"
NA,1992,"Slough Town","Woking","0-1",0,1,5,5,1,-1,"A"
NA,1992,"Stafford Rangers","Woking","0-0",0,0,5,5,0,0,"D"
NA,1992,"Stalybridge Celtic","Woking","3-0",3,0,5,5,3,3,"H"
NA,1992,"Telford United","Woking","3-3",3,3,5,5,6,0,"D"
NA,1992,"Welling United","Woking","1-1",1,1,5,5,2,0,"D"
NA,1992,"Witton Albion","Woking","1-2",1,2,5,5,3,-1,"A"
NA,1992,"Wycombe Wanderers","Woking","0-0",0,0,5,5,0,0,"D"
NA,1992,"Yeovil","Woking","4-1",4,1,5,5,5,3,"H"
NA,1992,"Altrincham","Wycombe Wanderers","0-2",0,2,5,5,2,-2,"A"
NA,1992,"Bath City","Wycombe Wanderers","2-0",2,0,5,5,2,2,"H"
NA,1992,"Boston United","Wycombe Wanderers","0-3",0,3,5,5,3,-3,"A"
NA,1992,"Bromsgrove Rovers","Wycombe Wanderers","1-0",1,0,5,5,1,1,"H"
NA,1992,"Dagenham and Redbridge","Wycombe Wanderers","1-2",1,2,5,5,3,-1,"A"
NA,1992,"Farnborough Town","Wycombe Wanderers","0-2",0,2,5,5,2,-2,"A"
NA,1992,"Gateshead","Wycombe Wanderers","0-1",0,1,5,5,1,-1,"A"
NA,1992,"Kettering Town","Wycombe Wanderers","0-4",0,4,5,5,4,-4,"A"
NA,1992,"Kidderminster Harriers","Wycombe Wanderers","1-4",1,4,5,5,5,-3,"A"
NA,1992,"Macclesfield","Wycombe Wanderers","1-1",1,1,5,5,2,0,"D"
NA,1992,"Merthyr Tydfil","Wycombe Wanderers","1-4",1,4,5,5,5,-3,"A"
NA,1992,"Northwich Victoria","Wycombe Wanderers","0-0",0,0,5,5,0,0,"D"
NA,1992,"Runcorn","Wycombe Wanderers","2-1",2,1,5,5,3,1,"H"
NA,1992,"Slough Town","Wycombe Wanderers","1-1",1,1,5,5,2,0,"D"
NA,1992,"Stafford Rangers","Wycombe Wanderers","0-1",0,1,5,5,1,-1,"A"
NA,1992,"Stalybridge Celtic","Wycombe Wanderers","2-2",2,2,5,5,4,0,"D"
NA,1992,"Telford United","Wycombe Wanderers","2-3",2,3,5,5,5,-1,"A"
NA,1992,"Welling United","Wycombe Wanderers","2-2",2,2,5,5,4,0,"D"
NA,1992,"Witton Albion","Wycombe Wanderers","2-2",2,2,5,5,4,0,"D"
NA,1992,"Woking","Wycombe Wanderers","0-3",0,3,5,5,3,-3,"A"
NA,1992,"Yeovil","Wycombe Wanderers","3-0",3,0,5,5,3,3,"H"
NA,1992,"Altrincham","Yeovil","1-2",1,2,5,5,3,-1,"A"
NA,1992,"Bath City","Yeovil","0-0",0,0,5,5,0,0,"D"
NA,1992,"Boston United","Yeovil","1-0",1,0,5,5,1,1,"H"
NA,1992,"Bromsgrove Rovers","Yeovil","1-0",1,0,5,5,1,1,"H"
NA,1992,"Dagenham and Redbridge","Yeovil","1-1",1,1,5,5,2,0,"D"
NA,1992,"Farnborough Town","Yeovil","2-1",2,1,5,5,3,1,"H"
NA,1992,"Gateshead","Yeovil","4-1",4,1,5,5,5,3,"H"
NA,1992,"Kettering Town","Yeovil","3-0",3,0,5,5,3,3,"H"
NA,1992,"Kidderminster Harriers","Yeovil","1-1",1,1,5,5,2,0,"D"
NA,1992,"Macclesfield","Yeovil","1-1",1,1,5,5,2,0,"D"
NA,1992,"Merthyr Tydfil","Yeovil","1-1",1,1,5,5,2,0,"D"
NA,1992,"Northwich Victoria","Yeovil","0-1",0,1,5,5,1,-1,"A"
NA,1992,"Runcorn","Yeovil","1-0",1,0,5,5,1,1,"H"
NA,1992,"Slough Town","Yeovil","3-0",3,0,5,5,3,3,"H"
NA,1992,"Stafford Rangers","Yeovil","0-1",0,1,5,5,1,-1,"A"
NA,1992,"Stalybridge Celtic","Yeovil","1-1",1,1,5,5,2,0,"D"
NA,1992,"Telford United","Yeovil","1-0",1,0,5,5,1,1,"H"
NA,1992,"Welling United","Yeovil","0-3",0,3,5,5,3,-3,"A"
NA,1992,"Witton Albion","Yeovil","1-2",1,2,5,5,3,-1,"A"
NA,1992,"Woking","Yeovil","0-0",0,0,5,5,0,0,"D"
NA,1992,"Wycombe Wanderers","Yeovil","5-1",5,1,5,5,6,4,"H"
NA,1993,"Bath City","Altrincham","0-1",0,1,5,5,1,-1,"A"
NA,1993,"Bromsgrove Rovers","Altrincham","1-2",1,2,5,5,3,-1,"A"
NA,1993,"Dagenham and Redbridge","Altrincham","3-0",3,0,5,5,3,3,"H"
NA,1993,"Dover Athletic","Altrincham","1-0",1,0,5,5,1,1,"H"
NA,1993,"Gateshead","Altrincham","2-1",2,1,5,5,3,1,"H"
NA,1993,"Halifax Town","Altrincham","0-0",0,0,5,5,0,0,"D"
NA,1993,"Kettering Town","Altrincham","1-0",1,0,5,5,1,1,"H"
NA,1993,"Kidderminster Harriers","Altrincham","0-1",0,1,5,5,1,-1,"A"
NA,1993,"Macclesfield","Altrincham","1-0",1,0,5,5,1,1,"H"
NA,1993,"Merthyr Tydfil","Altrincham","0-0",0,0,5,5,0,0,"D"
NA,1993,"Northwich Victoria","Altrincham","2-0",2,0,5,5,2,2,"H"
NA,1993,"Runcorn","Altrincham","2-1",2,1,5,5,3,1,"H"
NA,1993,"Slough Town","Altrincham","0-2",0,2,5,5,2,-2,"A"
NA,1993,"Southport","Altrincham","3-1",3,1,5,5,4,2,"H"
NA,1993,"Stafford Rangers","Altrincham","0-1",0,1,5,5,1,-1,"A"
NA,1993,"Stalybridge Celtic","Altrincham","1-3",1,3,5,5,4,-2,"A"
NA,1993,"Telford United","Altrincham","0-2",0,2,5,5,2,-2,"A"
NA,1993,"Welling United","Altrincham","2-1",2,1,5,5,3,1,"H"
NA,1993,"Witton Albion","Altrincham","0-1",0,1,5,5,1,-1,"A"
NA,1993,"Woking","Altrincham","1-1",1,1,5,5,2,0,"D"
NA,1993,"Yeovil","Altrincham","0-0",0,0,5,5,0,0,"D"
NA,1993,"Altrincham","Bath City","0-2",0,2,5,5,2,-2,"A"
NA,1993,"Bromsgrove Rovers","Bath City","0-1",0,1,5,5,1,-1,"A"
NA,1993,"Dagenham and Redbridge","Bath City","3-0",3,0,5,5,3,3,"H"
NA,1993,"Dover Athletic","Bath City","0-3",0,3,5,5,3,-3,"A"
NA,1993,"Gateshead","Bath City","1-0",1,0,5,5,1,1,"H"
NA,1993,"Halifax Town","Bath City","0-0",0,0,5,5,0,0,"D"
NA,1993,"Kettering Town","Bath City","0-1",0,1,5,5,1,-1,"A"
NA,1993,"Kidderminster Harriers","Bath City","0-0",0,0,5,5,0,0,"D"
NA,1993,"Macclesfield","Bath City","0-0",0,0,5,5,0,0,"D"
NA,1993,"Merthyr Tydfil","Bath City","1-1",1,1,5,5,2,0,"D"
NA,1993,"Northwich Victoria","Bath City","3-1",3,1,5,5,4,2,"H"
NA,1993,"Runcorn","Bath City","0-0",0,0,5,5,0,0,"D"
NA,1993,"Slough Town","Bath City","0-0",0,0,5,5,0,0,"D"
NA,1993,"Southport","Bath City","1-1",1,1,5,5,2,0,"D"
NA,1993,"Stafford Rangers","Bath City","2-0",2,0,5,5,2,2,"H"
NA,1993,"Stalybridge Celtic","Bath City","1-3",1,3,5,5,4,-2,"A"
NA,1993,"Telford United","Bath City","0-0",0,0,5,5,0,0,"D"
NA,1993,"Welling United","Bath City","0-0",0,0,5,5,0,0,"D"
NA,1993,"Witton Albion","Bath City","0-3",0,3,5,5,3,-3,"A"
NA,1993,"Woking","Bath City","4-1",4,1,5,5,5,3,"H"
NA,1993,"Yeovil","Bath City","1-2",1,2,5,5,3,-1,"A"
NA,1993,"Altrincham","Bromsgrove Rovers","2-3",2,3,5,5,5,-1,"A"
NA,1993,"Bath City","Bromsgrove Rovers","0-1",0,1,5,5,1,-1,"A"
NA,1993,"Dagenham and Redbridge","Bromsgrove Rovers","4-2",4,2,5,5,6,2,"H"
NA,1993,"Dover Athletic","Bromsgrove Rovers","4-3",4,3,5,5,7,1,"H"
NA,1993,"Gateshead","Bromsgrove Rovers","0-1",0,1,5,5,1,-1,"A"
NA,1993,"Halifax Town","Bromsgrove Rovers","3-0",3,0,5,5,3,3,"H"
NA,1993,"Kettering Town","Bromsgrove Rovers","0-1",0,1,5,5,1,-1,"A"
NA,1993,"Kidderminster Harriers","Bromsgrove Rovers","1-1",1,1,5,5,2,0,"D"
NA,1993,"Macclesfield","Bromsgrove Rovers","4-3",4,3,5,5,7,1,"H"
NA,1993,"Merthyr Tydfil","Bromsgrove Rovers","2-1",2,1,5,5,3,1,"H"
NA,1993,"Northwich Victoria","Bromsgrove Rovers","1-1",1,1,5,5,2,0,"D"
NA,1993,"Runcorn","Bromsgrove Rovers","4-1",4,1,5,5,5,3,"H"
NA,1993,"Slough Town","Bromsgrove Rovers","1-1",1,1,5,5,2,0,"D"
NA,1993,"Southport","Bromsgrove Rovers","1-2",1,2,5,5,3,-1,"A"
NA,1993,"Stafford Rangers","Bromsgrove Rovers","0-0",0,0,5,5,0,0,"D"
NA,1993,"Stalybridge Celtic","Bromsgrove Rovers","0-2",0,2,5,5,2,-2,"A"
NA,1993,"Telford United","Bromsgrove Rovers","0-0",0,0,5,5,0,0,"D"
NA,1993,"Welling United","Bromsgrove Rovers","1-1",1,1,5,5,2,0,"D"
NA,1993,"Witton Albion","Bromsgrove Rovers","4-1",4,1,5,5,5,3,"H"
NA,1993,"Woking","Bromsgrove Rovers","0-0",0,0,5,5,0,0,"D"
NA,1993,"Yeovil","Bromsgrove Rovers","2-3",2,3,5,5,5,-1,"A"
NA,1993,"Altrincham","Dagenham and Redbridge","1-2",1,2,5,5,3,-1,"A"
NA,1993,"Bath City","Dagenham and Redbridge","0-0",0,0,5,5,0,0,"D"
NA,1993,"Bromsgrove Rovers","Dagenham and Redbridge","2-0",2,0,5,5,2,2,"H"
NA,1993,"Dover Athletic","Dagenham and Redbridge","1-1",1,1,5,5,2,0,"D"
NA,1993,"Gateshead","Dagenham and Redbridge","3-1",3,1,5,5,4,2,"H"
NA,1993,"Halifax Town","Dagenham and Redbridge","0-1",0,1,5,5,1,-1,"A"
NA,1993,"Kettering Town","Dagenham and Redbridge","1-1",1,1,5,5,2,0,"D"
NA,1993,"Kidderminster Harriers","Dagenham and Redbridge","2-1",2,1,5,5,3,1,"H"
NA,1993,"Macclesfield","Dagenham and Redbridge","3-0",3,0,5,5,3,3,"H"
NA,1993,"Merthyr Tydfil","Dagenham and Redbridge","0-0",0,0,5,5,0,0,"D"
NA,1993,"Northwich Victoria","Dagenham and Redbridge","2-2",2,2,5,5,4,0,"D"
NA,1993,"Runcorn","Dagenham and Redbridge","2-1",2,1,5,5,3,1,"H"
NA,1993,"Slough Town","Dagenham and Redbridge","3-1",3,1,5,5,4,2,"H"
NA,1993,"Southport","Dagenham and Redbridge","0-0",0,0,5,5,0,0,"D"
NA,1993,"Stafford Rangers","Dagenham and Redbridge","2-0",2,0,5,5,2,2,"H"
NA,1993,"Stalybridge Celtic","Dagenham and Redbridge","5-0",5,0,5,5,5,5,"H"
NA,1993,"Telford United","Dagenham and Redbridge","0-0",0,0,5,5,0,0,"D"
NA,1993,"Welling United","Dagenham and Redbridge","0-0",0,0,5,5,0,0,"D"
NA,1993,"Witton Albion","Dagenham and Redbridge","1-1",1,1,5,5,2,0,"D"
NA,1993,"Woking","Dagenham and Redbridge","1-8",1,8,5,5,9,-7,"A"
NA,1993,"Yeovil","Dagenham and Redbridge","2-1",2,1,5,5,3,1,"H"
NA,1993,"Altrincham","Dover Athletic","2-0",2,0,5,5,2,2,"H"
NA,1993,"Bath City","Dover Athletic","0-0",0,0,5,5,0,0,"D"
NA,1993,"Bromsgrove Rovers","Dover Athletic","1-2",1,2,5,5,3,-1,"A"
NA,1993,"Dagenham and Redbridge","Dover Athletic","2-1",2,1,5,5,3,1,"H"
NA,1993,"Gateshead","Dover Athletic","1-2",1,2,5,5,3,-1,"A"
NA,1993,"Halifax Town","Dover Athletic","0-1",0,1,5,5,1,-1,"A"
NA,1993,"Kettering Town","Dover Athletic","1-0",1,0,5,5,1,1,"H"
NA,1993,"Kidderminster Harriers","Dover Athletic","3-0",3,0,5,5,3,3,"H"
NA,1993,"Macclesfield","Dover Athletic","0-2",0,2,5,5,2,-2,"A"
NA,1993,"Merthyr Tydfil","Dover Athletic","0-0",0,0,5,5,0,0,"D"
NA,1993,"Northwich Victoria","Dover Athletic","0-1",0,1,5,5,1,-1,"A"
NA,1993,"Runcorn","Dover Athletic","2-1",2,1,5,5,3,1,"H"
NA,1993,"Slough Town","Dover Athletic","1-0",1,0,5,5,1,1,"H"
NA,1993,"Southport","Dover Athletic","3-2",3,2,5,5,5,1,"H"
NA,1993,"Stafford Rangers","Dover Athletic","2-2",2,2,5,5,4,0,"D"
NA,1993,"Stalybridge Celtic","Dover Athletic","0-0",0,0,5,5,0,0,"D"
NA,1993,"Telford United","Dover Athletic","0-1",0,1,5,5,1,-1,"A"
NA,1993,"Welling United","Dover Athletic","2-0",2,0,5,5,2,2,"H"
NA,1993,"Witton Albion","Dover Athletic","1-2",1,2,5,5,3,-1,"A"
NA,1993,"Woking","Dover Athletic","3-0",3,0,5,5,3,3,"H"
NA,1993,"Yeovil","Dover Athletic","1-3",1,3,5,5,4,-2,"A"
NA,1993,"Altrincham","Gateshead","0-3",0,3,5,5,3,-3,"A"
NA,1993,"Bath City","Gateshead","2-3",2,3,5,5,5,-1,"A"
NA,1993,"Bromsgrove Rovers","Gateshead","3-0",3,0,5,5,3,3,"H"
NA,1993,"Dagenham and Redbridge","Gateshead","1-1",1,1,5,5,2,0,"D"
NA,1993,"Dover Athletic","Gateshead","3-1",3,1,5,5,4,2,"H"
NA,1993,"Halifax Town","Gateshead","3-1",3,1,5,5,4,2,"H"
NA,1993,"Kettering Town","Gateshead","0-0",0,0,5,5,0,0,"D"
NA,1993,"Kidderminster Harriers","Gateshead","1-1",1,1,5,5,2,0,"D"
NA,1993,"Macclesfield","Gateshead","6-1",6,1,5,5,7,5,"H"
NA,1993,"Merthyr Tydfil","Gateshead","3-0",3,0,5,5,3,3,"H"
NA,1993,"Northwich Victoria","Gateshead","1-2",1,2,5,5,3,-1,"A"
NA,1993,"Runcorn","Gateshead","1-1",1,1,5,5,2,0,"D"
NA,1993,"Slough Town","Gateshead","2-1",2,1,5,5,3,1,"H"
NA,1993,"Southport","Gateshead","1-1",1,1,5,5,2,0,"D"
NA,1993,"Stafford Rangers","Gateshead","3-1",3,1,5,5,4,2,"H"
NA,1993,"Stalybridge Celtic","Gateshead","2-1",2,1,5,5,3,1,"H"
NA,1993,"Telford United","Gateshead","0-0",0,0,5,5,0,0,"D"
NA,1993,"Welling United","Gateshead","1-2",1,2,5,5,3,-1,"A"
NA,1993,"Witton Albion","Gateshead","1-0",1,0,5,5,1,1,"H"
NA,1993,"Woking","Gateshead","1-0",1,0,5,5,1,1,"H"
NA,1993,"Yeovil","Gateshead","0-2",0,2,5,5,2,-2,"A"
NA,1993,"Altrincham","Halifax Town","0-0",0,0,5,5,0,0,"D"
NA,1993,"Bath City","Halifax Town","2-2",2,2,5,5,4,0,"D"
NA,1993,"Bromsgrove Rovers","Halifax Town","1-0",1,0,5,5,1,1,"H"
NA,1993,"Dagenham and Redbridge","Halifax Town","3-0",3,0,5,5,3,3,"H"
NA,1993,"Dover Athletic","Halifax Town","1-2",1,2,5,5,3,-1,"A"
NA,1993,"Gateshead","Halifax Town","2-1",2,1,5,5,3,1,"H"
NA,1993,"Kettering Town","Halifax Town","0-1",0,1,5,5,1,-1,"A"
NA,1993,"Kidderminster Harriers","Halifax Town","2-1",2,1,5,5,3,1,"H"
NA,1993,"Macclesfield","Halifax Town","0-1",0,1,5,5,1,-1,"A"
NA,1993,"Merthyr Tydfil","Halifax Town","2-1",2,1,5,5,3,1,"H"
NA,1993,"Northwich Victoria","Halifax Town","0-2",0,2,5,5,2,-2,"A"
NA,1993,"Runcorn","Halifax Town","5-0",5,0,5,5,5,5,"H"
NA,1993,"Slough Town","Halifax Town","2-0",2,0,5,5,2,2,"H"
NA,1993,"Southport","Halifax Town","2-2",2,2,5,5,4,0,"D"
NA,1993,"Stafford Rangers","Halifax Town","1-1",1,1,5,5,2,0,"D"
NA,1993,"Stalybridge Celtic","Halifax Town","1-1",1,1,5,5,2,0,"D"
NA,1993,"Telford United","Halifax Town","3-2",3,2,5,5,5,1,"H"
NA,1993,"Welling United","Halifax Town","0-2",0,2,5,5,2,-2,"A"
NA,1993,"Witton Albion","Halifax Town","2-2",2,2,5,5,4,0,"D"
NA,1993,"Woking","Halifax Town","2-6",2,6,5,5,8,-4,"A"
NA,1993,"Yeovil","Halifax Town","0-0",0,0,5,5,0,0,"D"
NA,1993,"Altrincham","Kettering Town","1-1",1,1,5,5,2,0,"D"
NA,1993,"Bath City","Kettering Town","0-3",0,3,5,5,3,-3,"A"
NA,1993,"Bromsgrove Rovers","Kettering Town","0-4",0,4,5,5,4,-4,"A"
NA,1993,"Dagenham and Redbridge","Kettering Town","2-3",2,3,5,5,5,-1,"A"
NA,1993,"Dover Athletic","Kettering Town","0-1",0,1,5,5,1,-1,"A"
NA,1993,"Gateshead","Kettering Town","0-0",0,0,5,5,0,0,"D"
NA,1993,"Halifax Town","Kettering Town","0-0",0,0,5,5,0,0,"D"
NA,1993,"Kidderminster Harriers","Kettering Town","0-2",0,2,5,5,2,-2,"A"
NA,1993,"Macclesfield","Kettering Town","0-0",0,0,5,5,0,0,"D"
NA,1993,"Merthyr Tydfil","Kettering Town","0-1",0,1,5,5,1,-1,"A"
NA,1993,"Northwich Victoria","Kettering Town","1-1",1,1,5,5,2,0,"D"
NA,1993,"Runcorn","Kettering Town","0-0",0,0,5,5,0,0,"D"
NA,1993,"Slough Town","Kettering Town","0-2",0,2,5,5,2,-2,"A"
NA,1993,"Southport","Kettering Town","0-1",0,1,5,5,1,-1,"A"
NA,1993,"Stafford Rangers","Kettering Town","1-0",1,0,5,5,1,1,"H"
NA,1993,"Stalybridge Celtic","Kettering Town","1-1",1,1,5,5,2,0,"D"
NA,1993,"Telford United","Kettering Town","1-2",1,2,5,5,3,-1,"A"
NA,1993,"Welling United","Kettering Town","2-0",2,0,5,5,2,2,"H"
NA,1993,"Witton Albion","Kettering Town","0-1",0,1,5,5,1,-1,"A"
NA,1993,"Woking","Kettering Town","0-0",0,0,5,5,0,0,"D"
NA,1993,"Yeovil","Kettering Town","1-0",1,0,5,5,1,1,"H"
NA,1993,"Altrincham","Kidderminster Harriers","1-0",1,0,5,5,1,1,"H"
NA,1993,"Bath City","Kidderminster Harriers","4-0",4,0,5,5,4,4,"H"
NA,1993,"Bromsgrove Rovers","Kidderminster Harriers","0-3",0,3,5,5,3,-3,"A"
NA,1993,"Dagenham and Redbridge","Kidderminster Harriers","1-1",1,1,5,5,2,0,"D"
NA,1993,"Dover Athletic","Kidderminster Harriers","3-1",3,1,5,5,4,2,"H"
NA,1993,"Gateshead","Kidderminster Harriers","0-2",0,2,5,5,2,-2,"A"
NA,1993,"Halifax Town","Kidderminster Harriers","1-0",1,0,5,5,1,1,"H"
NA,1993,"Kettering Town","Kidderminster Harriers","1-1",1,1,5,5,2,0,"D"
NA,1993,"Macclesfield","Kidderminster Harriers","0-0",0,0,5,5,0,0,"D"
NA,1993,"Merthyr Tydfil","Kidderminster Harriers","1-4",1,4,5,5,5,-3,"A"
NA,1993,"Northwich Victoria","Kidderminster Harriers","3-0",3,0,5,5,3,3,"H"
NA,1993,"Runcorn","Kidderminster Harriers","0-5",0,5,5,5,5,-5,"A"
NA,1993,"Slough Town","Kidderminster Harriers","1-5",1,5,5,5,6,-4,"A"
NA,1993,"Southport","Kidderminster Harriers","1-1",1,1,5,5,2,0,"D"
NA,1993,"Stafford Rangers","Kidderminster Harriers","2-3",2,3,5,5,5,-1,"A"
NA,1993,"Stalybridge Celtic","Kidderminster Harriers","0-2",0,2,5,5,2,-2,"A"
NA,1993,"Telford United","Kidderminster Harriers","1-0",1,0,5,5,1,1,"H"
NA,1993,"Welling United","Kidderminster Harriers","0-3",0,3,5,5,3,-3,"A"
NA,1993,"Witton Albion","Kidderminster Harriers","2-0",2,0,5,5,2,2,"H"
NA,1993,"Woking","Kidderminster Harriers","1-0",1,0,5,5,1,1,"H"
NA,1993,"Yeovil","Kidderminster Harriers","0-1",0,1,5,5,1,-1,"A"
NA,1993,"Altrincham","Macclesfield","0-1",0,1,5,5,1,-1,"A"
NA,1993,"Bath City","Macclesfield","5-1",5,1,5,5,6,4,"H"
NA,1993,"Bromsgrove Rovers","Macclesfield","3-0",3,0,5,5,3,3,"H"
NA,1993,"Dagenham and Redbridge","Macclesfield","1-1",1,1,5,5,2,0,"D"
NA,1993,"Dover Athletic","Macclesfield","1-2",1,2,5,5,3,-1,"A"
NA,1993,"Gateshead","Macclesfield","1-0",1,0,5,5,1,1,"H"
NA,1993,"Halifax Town","Macclesfield","1-2",1,2,5,5,3,-1,"A"
NA,1993,"Kettering Town","Macclesfield","0-1",0,1,5,5,1,-1,"A"
NA,1993,"Kidderminster Harriers","Macclesfield","2-1",2,1,5,5,3,1,"H"
NA,1993,"Merthyr Tydfil","Macclesfield","2-1",2,1,5,5,3,1,"H"
NA,1993,"Northwich Victoria","Macclesfield","1-1",1,1,5,5,2,0,"D"
NA,1993,"Runcorn","Macclesfield","2-1",2,1,5,5,3,1,"H"
NA,1993,"Slough Town","Macclesfield","1-1",1,1,5,5,2,0,"D"
NA,1993,"Southport","Macclesfield","1-0",1,0,5,5,1,1,"H"
NA,1993,"Stafford Rangers","Macclesfield","2-3",2,3,5,5,5,-1,"A"
NA,1993,"Stalybridge Celtic","Macclesfield","0-2",0,2,5,5,2,-2,"A"
NA,1993,"Telford United","Macclesfield","1-3",1,3,5,5,4,-2,"A"
NA,1993,"Welling United","Macclesfield","0-1",0,1,5,5,1,-1,"A"
NA,1993,"Witton Albion","Macclesfield","0-2",0,2,5,5,2,-2,"A"
NA,1993,"Woking","Macclesfield","3-0",3,0,5,5,3,3,"H"
NA,1993,"Yeovil","Macclesfield","4-0",4,0,5,5,4,4,"H"
NA,1993,"Altrincham","Merthyr Tydfil","3-0",3,0,5,5,3,3,"H"
NA,1993,"Bath City","Merthyr Tydfil","0-3",0,3,5,5,3,-3,"A"
NA,1993,"Bromsgrove Rovers","Merthyr Tydfil","3-3",3,3,5,5,6,0,"D"
NA,1993,"Dagenham and Redbridge","Merthyr Tydfil","0-1",0,1,5,5,1,-1,"A"
NA,1993,"Dover Athletic","Merthyr Tydfil","1-0",1,0,5,5,1,1,"H"
NA,1993,"Gateshead","Merthyr Tydfil","0-0",0,0,5,5,0,0,"D"
NA,1993,"Halifax Town","Merthyr Tydfil","2-1",2,1,5,5,3,1,"H"
NA,1993,"Kettering Town","Merthyr Tydfil","0-0",0,0,5,5,0,0,"D"
NA,1993,"Kidderminster Harriers","Merthyr Tydfil","2-0",2,0,5,5,2,2,"H"
NA,1993,"Macclesfield","Merthyr Tydfil","1-2",1,2,5,5,3,-1,"A"
NA,1993,"Northwich Victoria","Merthyr Tydfil","1-2",1,2,5,5,3,-1,"A"
NA,1993,"Runcorn","Merthyr Tydfil","1-1",1,1,5,5,2,0,"D"
NA,1993,"Slough Town","Merthyr Tydfil","3-2",3,2,5,5,5,1,"H"
NA,1993,"Southport","Merthyr Tydfil","3-2",3,2,5,5,5,1,"H"
NA,1993,"Stafford Rangers","Merthyr Tydfil","5-1",5,1,5,5,6,4,"H"
NA,1993,"Stalybridge Celtic","Merthyr Tydfil","2-2",2,2,5,5,4,0,"D"
NA,1993,"Telford United","Merthyr Tydfil","1-0",1,0,5,5,1,1,"H"
NA,1993,"Welling United","Merthyr Tydfil","1-1",1,1,5,5,2,0,"D"
NA,1993,"Witton Albion","Merthyr Tydfil","2-2",2,2,5,5,4,0,"D"
NA,1993,"Woking","Merthyr Tydfil","2-1",2,1,5,5,3,1,"H"
NA,1993,"Yeovil","Merthyr Tydfil","2-2",2,2,5,5,4,0,"D"
NA,1993,"Altrincham","Northwich Victoria","2-2",2,2,5,5,4,0,"D"
NA,1993,"Bath City","Northwich Victoria","0-0",0,0,5,5,0,0,"D"
NA,1993,"Bromsgrove Rovers","Northwich Victoria","0-0",0,0,5,5,0,0,"D"
NA,1993,"Dagenham and Redbridge","Northwich Victoria","1-1",1,1,5,5,2,0,"D"
NA,1993,"Dover Athletic","Northwich Victoria","2-0",2,0,5,5,2,2,"H"
NA,1993,"Gateshead","Northwich Victoria","1-0",1,0,5,5,1,1,"H"
NA,1993,"Halifax Town","Northwich Victoria","1-2",1,2,5,5,3,-1,"A"
NA,1993,"Kettering Town","Northwich Victoria","0-0",0,0,5,5,0,0,"D"
NA,1993,"Kidderminster Harriers","Northwich Victoria","2-0",2,0,5,5,2,2,"H"
NA,1993,"Macclesfield","Northwich Victoria","0-0",0,0,5,5,0,0,"D"
NA,1993,"Merthyr Tydfil","Northwich Victoria","5-0",5,0,5,5,5,5,"H"
NA,1993,"Runcorn","Northwich Victoria","1-2",1,2,5,5,3,-1,"A"
NA,1993,"Slough Town","Northwich Victoria","2-2",2,2,5,5,4,0,"D"
NA,1993,"Southport","Northwich Victoria","0-0",0,0,5,5,0,0,"D"
NA,1993,"Stafford Rangers","Northwich Victoria","3-1",3,1,5,5,4,2,"H"
NA,1993,"Stalybridge Celtic","Northwich Victoria","1-1",1,1,5,5,2,0,"D"
NA,1993,"Telford United","Northwich Victoria","2-1",2,1,5,5,3,1,"H"
NA,1993,"Welling United","Northwich Victoria","0-1",0,1,5,5,1,-1,"A"
NA,1993,"Witton Albion","Northwich Victoria","1-1",1,1,5,5,2,0,"D"
NA,1993,"Woking","Northwich Victoria","2-1",2,1,5,5,3,1,"H"
NA,1993,"Yeovil","Northwich Victoria","0-3",0,3,5,5,3,-3,"A"
NA,1993,"Altrincham","Runcorn","2-1",2,1,5,5,3,1,"H"
NA,1993,"Bath City","Runcorn","0-0",0,0,5,5,0,0,"D"
NA,1993,"Bromsgrove Rovers","Runcorn","0-0",0,0,5,5,0,0,"D"
NA,1993,"Dagenham and Redbridge","Runcorn","2-1",2,1,5,5,3,1,"H"
NA,1993,"Dover Athletic","Runcorn","2-3",2,3,5,5,5,-1,"A"
NA,1993,"Gateshead","Runcorn","2-2",2,2,5,5,4,0,"D"
NA,1993,"Halifax Town","Runcorn","1-1",1,1,5,5,2,0,"D"
NA,1993,"Kettering Town","Runcorn","2-2",2,2,5,5,4,0,"D"
NA,1993,"Kidderminster Harriers","Runcorn","3-0",3,0,5,5,3,3,"H"
NA,1993,"Macclesfield","Runcorn","0-0",0,0,5,5,0,0,"D"
NA,1993,"Merthyr Tydfil","Runcorn","1-1",1,1,5,5,2,0,"D"
NA,1993,"Northwich Victoria","Runcorn","1-1",1,1,5,5,2,0,"D"
NA,1993,"Slough Town","Runcorn","3-0",3,0,5,5,3,3,"H"
NA,1993,"Southport","Runcorn","1-0",1,0,5,5,1,1,"H"
NA,1993,"Stafford Rangers","Runcorn","2-2",2,2,5,5,4,0,"D"
NA,1993,"Stalybridge Celtic","Runcorn","1-2",1,2,5,5,3,-1,"A"
NA,1993,"Telford United","Runcorn","1-1",1,1,5,5,2,0,"D"
NA,1993,"Welling United","Runcorn","1-1",1,1,5,5,2,0,"D"
NA,1993,"Witton Albion","Runcorn","1-1",1,1,5,5,2,0,"D"
NA,1993,"Woking","Runcorn","1-1",1,1,5,5,2,0,"D"
NA,1993,"Yeovil","Runcorn","4-2",4,2,5,5,6,2,"H"
NA,1993,"Altrincham","Slough Town","2-0",2,0,5,5,2,2,"H"
NA,1993,"Bath City","Slough Town","3-0",3,0,5,5,3,3,"H"
NA,1993,"Bromsgrove Rovers","Slough Town","0-1",0,1,5,5,1,-1,"A"
NA,1993,"Dagenham and Redbridge","Slough Town","1-0",1,0,5,5,1,1,"H"
NA,1993,"Dover Athletic","Slough Town","0-0",0,0,5,5,0,0,"D"
NA,1993,"Gateshead","Slough Town","0-0",0,0,5,5,0,0,"D"
NA,1993,"Halifax Town","Slough Town","1-0",1,0,5,5,1,1,"H"
NA,1993,"Kettering Town","Slough Town","2-0",2,0,5,5,2,2,"H"
NA,1993,"Kidderminster Harriers","Slough Town","0-0",0,0,5,5,0,0,"D"
NA,1993,"Macclesfield","Slough Town","2-2",2,2,5,5,4,0,"D"
NA,1993,"Merthyr Tydfil","Slough Town","5-1",5,1,5,5,6,4,"H"
NA,1993,"Northwich Victoria","Slough Town","1-1",1,1,5,5,2,0,"D"
NA,1993,"Runcorn","Slough Town","3-2",3,2,5,5,5,1,"H"
NA,1993,"Southport","Slough Town","1-0",1,0,5,5,1,1,"H"
NA,1993,"Stafford Rangers","Slough Town","0-0",0,0,5,5,0,0,"D"
NA,1993,"Stalybridge Celtic","Slough Town","0-1",0,1,5,5,1,-1,"A"
NA,1993,"Telford United","Slough Town","4-1",4,1,5,5,5,3,"H"
NA,1993,"Welling United","Slough Town","6-2",6,2,5,5,8,4,"H"
NA,1993,"Witton Albion","Slough Town","1-0",1,0,5,5,1,1,"H"
NA,1993,"Woking","Slough Town","2-1",2,1,5,5,3,1,"H"
NA,1993,"Yeovil","Slough Town","0-2",0,2,5,5,2,-2,"A"
NA,1993,"Altrincham","Southport","1-2",1,2,5,5,3,-1,"A"
NA,1993,"Bath City","Southport","2-1",2,1,5,5,3,1,"H"
NA,1993,"Bromsgrove Rovers","Southport","2-2",2,2,5,5,4,0,"D"
NA,1993,"Dagenham and Redbridge","Southport","3-3",3,3,5,5,6,0,"D"
NA,1993,"Dover Athletic","Southport","0-2",0,2,5,5,2,-2,"A"
NA,1993,"Gateshead","Southport","1-3",1,3,5,5,4,-2,"A"
NA,1993,"Halifax Town","Southport","2-2",2,2,5,5,4,0,"D"
NA,1993,"Kettering Town","Southport","2-0",2,0,5,5,2,2,"H"
NA,1993,"Kidderminster Harriers","Southport","2-0",2,0,5,5,2,2,"H"
NA,1993,"Macclesfield","Southport","0-1",0,1,5,5,1,-1,"A"
NA,1993,"Merthyr Tydfil","Southport","2-2",2,2,5,5,4,0,"D"
NA,1993,"Northwich Victoria","Southport","2-1",2,1,5,5,3,1,"H"
NA,1993,"Runcorn","Southport","3-0",3,0,5,5,3,3,"H"
NA,1993,"Slough Town","Southport","0-0",0,0,5,5,0,0,"D"
NA,1993,"Stafford Rangers","Southport","0-2",0,2,5,5,2,-2,"A"
NA,1993,"Stalybridge Celtic","Southport","3-1",3,1,5,5,4,2,"H"
NA,1993,"Telford United","Southport","1-3",1,3,5,5,4,-2,"A"
NA,1993,"Welling United","Southport","0-2",0,2,5,5,2,-2,"A"
NA,1993,"Witton Albion","Southport","0-2",0,2,5,5,2,-2,"A"
NA,1993,"Woking","Southport","1-0",1,0,5,5,1,1,"H"
NA,1993,"Yeovil","Southport","3-2",3,2,5,5,5,1,"H"
NA,1993,"Altrincham","Stafford Rangers","0-0",0,0,5,5,0,0,"D"
NA,1993,"Bath City","Stafford Rangers","2-3",2,3,5,5,5,-1,"A"
NA,1993,"Bromsgrove Rovers","Stafford Rangers","3-3",3,3,5,5,6,0,"D"
NA,1993,"Dagenham and Redbridge","Stafford Rangers","1-0",1,0,5,5,1,1,"H"
NA,1993,"Dover Athletic","Stafford Rangers","2-0",2,0,5,5,2,2,"H"
NA,1993,"Gateshead","Stafford Rangers","0-0",0,0,5,5,0,0,"D"
NA,1993,"Halifax Town","Stafford Rangers","1-1",1,1,5,5,2,0,"D"
NA,1993,"Kettering Town","Stafford Rangers","2-0",2,0,5,5,2,2,"H"
NA,1993,"Kidderminster Harriers","Stafford Rangers","2-0",2,0,5,5,2,2,"H"
NA,1993,"Macclesfield","Stafford Rangers","0-0",0,0,5,5,0,0,"D"
NA,1993,"Merthyr Tydfil","Stafford Rangers","2-0",2,0,5,5,2,2,"H"
NA,1993,"Northwich Victoria","Stafford Rangers","0-0",0,0,5,5,0,0,"D"
NA,1993,"Runcorn","Stafford Rangers","2-2",2,2,5,5,4,0,"D"
NA,1993,"Slough Town","Stafford Rangers","3-0",3,0,5,5,3,3,"H"
NA,1993,"Southport","Stafford Rangers","0-2",0,2,5,5,2,-2,"A"
NA,1993,"Stalybridge Celtic","Stafford Rangers","1-2",1,2,5,5,3,-1,"A"
NA,1993,"Telford United","Stafford Rangers","2-1",2,1,5,5,3,1,"H"
NA,1993,"Welling United","Stafford Rangers","2-1",2,1,5,5,3,1,"H"
NA,1993,"Witton Albion","Stafford Rangers","1-1",1,1,5,5,2,0,"D"
NA,1993,"Woking","Stafford Rangers","4-0",4,0,5,5,4,4,"H"
NA,1993,"Yeovil","Stafford Rangers","0-1",0,1,5,5,1,-1,"A"
NA,1993,"Altrincham","Stalybridge Celtic","0-0",0,0,5,5,0,0,"D"
NA,1993,"Bath City","Stalybridge Celtic","1-1",1,1,5,5,2,0,"D"
NA,1993,"Bromsgrove Rovers","Stalybridge Celtic","2-0",2,0,5,5,2,2,"H"
NA,1993,"Dagenham and Redbridge","Stalybridge Celtic","0-1",0,1,5,5,1,-1,"A"
NA,1993,"Dover Athletic","Stalybridge Celtic","1-1",1,1,5,5,2,0,"D"
NA,1993,"Gateshead","Stalybridge Celtic","2-1",2,1,5,5,3,1,"H"
NA,1993,"Halifax Town","Stalybridge Celtic","2-1",2,1,5,5,3,1,"H"
NA,1993,"Kettering Town","Stalybridge Celtic","3-2",3,2,5,5,5,1,"H"
NA,1993,"Kidderminster Harriers","Stalybridge Celtic","1-0",1,0,5,5,1,1,"H"
NA,1993,"Macclesfield","Stalybridge Celtic","1-3",1,3,5,5,4,-2,"A"
NA,1993,"Merthyr Tydfil","Stalybridge Celtic","1-2",1,2,5,5,3,-1,"A"
NA,1993,"Northwich Victoria","Stalybridge Celtic","2-0",2,0,5,5,2,2,"H"
NA,1993,"Runcorn","Stalybridge Celtic","1-1",1,1,5,5,2,0,"D"
NA,1993,"Slough Town","Stalybridge Celtic","2-3",2,3,5,5,5,-1,"A"
NA,1993,"Southport","Stalybridge Celtic","0-2",0,2,5,5,2,-2,"A"
NA,1993,"Stafford Rangers","Stalybridge Celtic","2-2",2,2,5,5,4,0,"D"
NA,1993,"Telford United","Stalybridge Celtic","0-2",0,2,5,5,2,-2,"A"
NA,1993,"Welling United","Stalybridge Celtic","1-2",1,2,5,5,3,-1,"A"
NA,1993,"Witton Albion","Stalybridge Celtic","0-3",0,3,5,5,3,-3,"A"
NA,1993,"Woking","Stalybridge Celtic","3-0",3,0,5,5,3,3,"H"
NA,1993,"Yeovil","Stalybridge Celtic","0-0",0,0,5,5,0,0,"D"
NA,1993,"Altrincham","Telford United","2-0",2,0,5,5,2,2,"H"
NA,1993,"Bath City","Telford United","3-0",3,0,5,5,3,3,"H"
NA,1993,"Bromsgrove Rovers","Telford United","0-5",0,5,5,5,5,-5,"A"
NA,1993,"Dagenham and Redbridge","Telford United","4-1",4,1,5,5,5,3,"H"
NA,1993,"Dover Athletic","Telford United","0-1",0,1,5,5,1,-1,"A"
NA,1993,"Gateshead","Telford United","0-2",0,2,5,5,2,-2,"A"
NA,1993,"Halifax Town","Telford United","6-0",6,0,5,5,6,6,"H"
NA,1993,"Kettering Town","Telford United","1-2",1,2,5,5,3,-1,"A"
NA,1993,"Kidderminster Harriers","Telford United","2-0",2,0,5,5,2,2,"H"
NA,1993,"Macclesfield","Telford United","1-0",1,0,5,5,1,1,"H"
NA,1993,"Merthyr Tydfil","Telford United","0-3",0,3,5,5,3,-3,"A"
NA,1993,"Northwich Victoria","Telford United","1-0",1,0,5,5,1,1,"H"
NA,1993,"Runcorn","Telford United","3-2",3,2,5,5,5,1,"H"
NA,1993,"Slough Town","Telford United","0-0",0,0,5,5,0,0,"D"
NA,1993,"Southport","Telford United","1-0",1,0,5,5,1,1,"H"
NA,1993,"Stafford Rangers","Telford United","1-1",1,1,5,5,2,0,"D"
NA,1993,"Stalybridge Celtic","Telford United","1-0",1,0,5,5,1,1,"H"
NA,1993,"Welling United","Telford United","0-0",0,0,5,5,0,0,"D"
NA,1993,"Witton Albion","Telford United","0-0",0,0,5,5,0,0,"D"
NA,1993,"Woking","Telford United","0-0",0,0,5,5,0,0,"D"
NA,1993,"Yeovil","Telford United","1-0",1,0,5,5,1,1,"H"
NA,1993,"Altrincham","Welling United","2-0",2,0,5,5,2,2,"H"
NA,1993,"Bath City","Welling United","0-0",0,0,5,5,0,0,"D"
NA,1993,"Bromsgrove Rovers","Welling United","1-1",1,1,5,5,2,0,"D"
NA,1993,"Dagenham and Redbridge","Welling United","2-0",2,0,5,5,2,2,"H"
NA,1993,"Dover Athletic","Welling United","0-1",0,1,5,5,1,-1,"A"
NA,1993,"Gateshead","Welling United","1-0",1,0,5,5,1,1,"H"
NA,1993,"Halifax Town","Welling United","1-1",1,1,5,5,2,0,"D"
NA,1993,"Kettering Town","Welling United","2-2",2,2,5,5,4,0,"D"
NA,1993,"Kidderminster Harriers","Welling United","1-0",1,0,5,5,1,1,"H"
NA,1993,"Macclesfield","Welling United","1-0",1,0,5,5,1,1,"H"
NA,1993,"Merthyr Tydfil","Welling United","0-1",0,1,5,5,1,-1,"A"
NA,1993,"Northwich Victoria","Welling United","3-1",3,1,5,5,4,2,"H"
NA,1993,"Runcorn","Welling United","2-4",2,4,5,5,6,-2,"A"
NA,1993,"Slough Town","Welling United","1-1",1,1,5,5,2,0,"D"
NA,1993,"Southport","Welling United","2-1",2,1,5,5,3,1,"H"
NA,1993,"Stafford Rangers","Welling United","3-0",3,0,5,5,3,3,"H"
NA,1993,"Stalybridge Celtic","Welling United","2-1",2,1,5,5,3,1,"H"
NA,1993,"Telford United","Welling United","2-0",2,0,5,5,2,2,"H"
NA,1993,"Witton Albion","Welling United","0-5",0,5,5,5,5,-5,"A"
NA,1993,"Woking","Welling United","0-2",0,2,5,5,2,-2,"A"
NA,1993,"Yeovil","Welling United","0-1",0,1,5,5,1,-1,"A"
NA,1993,"Altrincham","Witton Albion","1-3",1,3,5,5,4,-2,"A"
NA,1993,"Bath City","Witton Albion","1-1",1,1,5,5,2,0,"D"
NA,1993,"Bromsgrove Rovers","Witton Albion","3-3",3,3,5,5,6,0,"D"
NA,1993,"Dagenham and Redbridge","Witton Albion","2-1",2,1,5,5,3,1,"H"
NA,1993,"Dover Athletic","Witton Albion","1-0",1,0,5,5,1,1,"H"
NA,1993,"Gateshead","Witton Albion","3-0",3,0,5,5,3,3,"H"
NA,1993,"Halifax Town","Witton Albion","0-0",0,0,5,5,0,0,"D"
NA,1993,"Kettering Town","Witton Albion","1-0",1,0,5,5,1,1,"H"
NA,1993,"Kidderminster Harriers","Witton Albion","0-0",0,0,5,5,0,0,"D"
NA,1993,"Macclesfield","Witton Albion","2-0",2,0,5,5,2,2,"H"
NA,1993,"Merthyr Tydfil","Witton Albion","4-3",4,3,5,5,7,1,"H"
NA,1993,"Northwich Victoria","Witton Albion","0-1",0,1,5,5,1,-1,"A"
NA,1993,"Runcorn","Witton Albion","1-0",1,0,5,5,1,1,"H"
NA,1993,"Slough Town","Witton Albion","0-1",0,1,5,5,1,-1,"A"
NA,1993,"Southport","Witton Albion","2-1",2,1,5,5,3,1,"H"
NA,1993,"Stafford Rangers","Witton Albion","1-0",1,0,5,5,1,1,"H"
NA,1993,"Stalybridge Celtic","Witton Albion","2-1",2,1,5,5,3,1,"H"
NA,1993,"Telford United","Witton Albion","2-2",2,2,5,5,4,0,"D"
NA,1993,"Welling United","Witton Albion","2-1",2,1,5,5,3,1,"H"
NA,1993,"Woking","Witton Albion","3-1",3,1,5,5,4,2,"H"
NA,1993,"Yeovil","Witton Albion","2-0",2,0,5,5,2,2,"H"
NA,1993,"Altrincham","Woking","0-2",0,2,5,5,2,-2,"A"
NA,1993,"Bath City","Woking","0-1",0,1,5,5,1,-1,"A"
NA,1993,"Bromsgrove Rovers","Woking","0-0",0,0,5,5,0,0,"D"
NA,1993,"Dagenham and Redbridge","Woking","3-4",3,4,5,5,7,-1,"A"
NA,1993,"Dover Athletic","Woking","5-0",5,0,5,5,5,5,"H"
NA,1993,"Gateshead","Woking","1-1",1,1,5,5,2,0,"D"
NA,1993,"Halifax Town","Woking","2-3",2,3,5,5,5,-1,"A"
NA,1993,"Kettering Town","Woking","3-0",3,0,5,5,3,3,"H"
NA,1993,"Kidderminster Harriers","Woking","3-1",3,1,5,5,4,2,"H"
NA,1993,"Macclesfield","Woking","1-1",1,1,5,5,2,0,"D"
NA,1993,"Merthyr Tydfil","Woking","2-3",2,3,5,5,5,-1,"A"
NA,1993,"Northwich Victoria","Woking","0-0",0,0,5,5,0,0,"D"
NA,1993,"Runcorn","Woking","2-1",2,1,5,5,3,1,"H"
NA,1993,"Slough Town","Woking","0-0",0,0,5,5,0,0,"D"
NA,1993,"Southport","Woking","2-1",2,1,5,5,3,1,"H"
NA,1993,"Stafford Rangers","Woking","3-0",3,0,5,5,3,3,"H"
NA,1993,"Stalybridge Celtic","Woking","2-2",2,2,5,5,4,0,"D"
NA,1993,"Telford United","Woking","2-0",2,0,5,5,2,2,"H"
NA,1993,"Welling United","Woking","2-2",2,2,5,5,4,0,"D"
NA,1993,"Witton Albion","Woking","0-0",0,0,5,5,0,0,"D"
NA,1993,"Yeovil","Woking","0-1",0,1,5,5,1,-1,"A"
NA,1993,"Altrincham","Yeovil","1-0",1,0,5,5,1,1,"H"
NA,1993,"Bath City","Yeovil","3-0",3,0,5,5,3,3,"H"
NA,1993,"Bromsgrove Rovers","Yeovil","1-2",1,2,5,5,3,-1,"A"
NA,1993,"Dagenham and Redbridge","Yeovil","2-1",2,1,5,5,3,1,"H"
NA,1993,"Dover Athletic","Yeovil","0-2",0,2,5,5,2,-2,"A"
NA,1993,"Gateshead","Yeovil","2-1",2,1,5,5,3,1,"H"
NA,1993,"Halifax Town","Yeovil","1-1",1,1,5,5,2,0,"D"
NA,1993,"Kettering Town","Yeovil","1-0",1,0,5,5,1,1,"H"
NA,1993,"Kidderminster Harriers","Yeovil","2-3",2,3,5,5,5,-1,"A"
NA,1993,"Macclesfield","Yeovil","1-2",1,2,5,5,3,-1,"A"
NA,1993,"Merthyr Tydfil","Yeovil","1-1",1,1,5,5,2,0,"D"
NA,1993,"Northwich Victoria","Yeovil","1-1",1,1,5,5,2,0,"D"
NA,1993,"Runcorn","Yeovil","4-0",4,0,5,5,4,4,"H"
NA,1993,"Slough Town","Yeovil","5-2",5,2,5,5,7,3,"H"
NA,1993,"Southport","Yeovil","1-1",1,1,5,5,2,0,"D"
NA,1993,"Stafford Rangers","Yeovil","4-2",4,2,5,5,6,2,"H"
NA,1993,"Stalybridge Celtic","Yeovil","1-2",1,2,5,5,3,-1,"A"
NA,1993,"Telford United","Yeovil","1-1",1,1,5,5,2,0,"D"
NA,1993,"Welling United","Yeovil","2-0",2,0,5,5,2,2,"H"
NA,1993,"Witton Albion","Yeovil","1-2",1,2,5,5,3,-1,"A"
NA,1993,"Woking","Yeovil","1-2",1,2,5,5,3,-1,"A"
NA,1994,"Bath City","Altrincham","0-3",0,3,5,5,3,-3,"A"
NA,1994,"Bromsgrove Rovers","Altrincham","0-3",0,3,5,5,3,-3,"A"
NA,1994,"Dagenham and Redbridge","Altrincham","0-4",0,4,5,5,4,-4,"A"
NA,1994,"Dover Athletic","Altrincham","1-3",1,3,5,5,4,-2,"A"
NA,1994,"Farnborough Town","Altrincham","2-3",2,3,5,5,5,-1,"A"
NA,1994,"Gateshead","Altrincham","1-0",1,0,5,5,1,1,"H"
NA,1994,"Halifax Town","Altrincham","1-1",1,1,5,5,2,0,"D"
NA,1994,"Kettering Town","Altrincham","2-2",2,2,5,5,4,0,"D"
NA,1994,"Kidderminster Harriers","Altrincham","2-2",2,2,5,5,4,0,"D"
NA,1994,"Macclesfield","Altrincham","4-2",4,2,5,5,6,2,"H"
NA,1994,"Merthyr Tydfil","Altrincham","2-5",2,5,5,5,7,-3,"A"
NA,1994,"Northwich Victoria","Altrincham","1-1",1,1,5,5,2,0,"D"
NA,1994,"Runcorn","Altrincham","3-0",3,0,5,5,3,3,"H"
NA,1994,"Southport","Altrincham","1-4",1,4,5,5,5,-3,"A"
NA,1994,"Stafford Rangers","Altrincham","0-1",0,1,5,5,1,-1,"A"
NA,1994,"Stalybridge Celtic","Altrincham","2-1",2,1,5,5,3,1,"H"
NA,1994,"Stevenage Borough","Altrincham","4-2",4,2,5,5,6,2,"H"
NA,1994,"Telford United","Altrincham","2-3",2,3,5,5,5,-1,"A"
NA,1994,"Welling United","Altrincham","0-0",0,0,5,5,0,0,"D"
NA,1994,"Woking","Altrincham","4-0",4,0,5,5,4,4,"H"
NA,1994,"Yeovil","Altrincham","1-3",1,3,5,5,4,-2,"A"
NA,1994,"Altrincham","Bath City","1-0",1,0,5,5,1,1,"H"
NA,1994,"Bromsgrove Rovers","Bath City","1-1",1,1,5,5,2,0,"D"
NA,1994,"Dagenham and Redbridge","Bath City","1-0",1,0,5,5,1,1,"H"
NA,1994,"Dover Athletic","Bath City","3-0",3,0,5,5,3,3,"H"
NA,1994,"Farnborough Town","Bath City","0-0",0,0,5,5,0,0,"D"
NA,1994,"Gateshead","Bath City","0-1",0,1,5,5,1,-1,"A"
NA,1994,"Halifax Town","Bath City","4-2",4,2,5,5,6,2,"H"
NA,1994,"Kettering Town","Bath City","0-0",0,0,5,5,0,0,"D"
NA,1994,"Kidderminster Harriers","Bath City","2-1",2,1,5,5,3,1,"H"
NA,1994,"Macclesfield","Bath City","1-0",1,0,5,5,1,1,"H"
NA,1994,"Merthyr Tydfil","Bath City","2-0",2,0,5,5,2,2,"H"
NA,1994,"Northwich Victoria","Bath City","1-1",1,1,5,5,2,0,"D"
NA,1994,"Runcorn","Bath City","1-1",1,1,5,5,2,0,"D"
NA,1994,"Southport","Bath City","3-1",3,1,5,5,4,2,"H"
NA,1994,"Stafford Rangers","Bath City","0-2",0,2,5,5,2,-2,"A"
NA,1994,"Stalybridge Celtic","Bath City","0-1",0,1,5,5,1,-1,"A"
NA,1994,"Stevenage Borough","Bath City","3-0",3,0,5,5,3,3,"H"
NA,1994,"Telford United","Bath City","3-0",3,0,5,5,3,3,"H"
NA,1994,"Welling United","Bath City","1-5",1,5,5,5,6,-4,"A"
NA,1994,"Woking","Bath City","2-2",2,2,5,5,4,0,"D"
NA,1994,"Yeovil","Bath City","1-2",1,2,5,5,3,-1,"A"
NA,1994,"Altrincham","Bromsgrove Rovers","1-1",1,1,5,5,2,0,"D"
NA,1994,"Bath City","Bromsgrove Rovers","1-1",1,1,5,5,2,0,"D"
NA,1994,"Dagenham and Redbridge","Bromsgrove Rovers","2-0",2,0,5,5,2,2,"H"
NA,1994,"Dover Athletic","Bromsgrove Rovers","0-2",0,2,5,5,2,-2,"A"
NA,1994,"Farnborough Town","Bromsgrove Rovers","0-3",0,3,5,5,3,-3,"A"
NA,1994,"Gateshead","Bromsgrove Rovers","2-1",2,1,5,5,3,1,"H"
NA,1994,"Halifax Town","Bromsgrove Rovers","4-2",4,2,5,5,6,2,"H"
NA,1994,"Kettering Town","Bromsgrove Rovers","0-1",0,1,5,5,1,-1,"A"
NA,1994,"Kidderminster Harriers","Bromsgrove Rovers","0-1",0,1,5,5,1,-1,"A"
NA,1994,"Macclesfield","Bromsgrove Rovers","2-2",2,2,5,5,4,0,"D"
NA,1994,"Merthyr Tydfil","Bromsgrove Rovers","2-1",2,1,5,5,3,1,"H"
NA,1994,"Northwich Victoria","Bromsgrove Rovers","3-1",3,1,5,5,4,2,"H"
NA,1994,"Runcorn","Bromsgrove Rovers","3-1",3,1,5,5,4,2,"H"
NA,1994,"Southport","Bromsgrove Rovers","2-1",2,1,5,5,3,1,"H"
NA,1994,"Stafford Rangers","Bromsgrove Rovers","1-1",1,1,5,5,2,0,"D"
NA,1994,"Stalybridge Celtic","Bromsgrove Rovers","1-1",1,1,5,5,2,0,"D"
NA,1994,"Stevenage Borough","Bromsgrove Rovers","1-0",1,0,5,5,1,1,"H"
NA,1994,"Telford United","Bromsgrove Rovers","2-2",2,2,5,5,4,0,"D"
NA,1994,"Welling United","Bromsgrove Rovers","1-2",1,2,5,5,3,-1,"A"
NA,1994,"Woking","Bromsgrove Rovers","4-0",4,0,5,5,4,4,"H"
NA,1994,"Yeovil","Bromsgrove Rovers","2-0",2,0,5,5,2,2,"H"
NA,1994,"Altrincham","Dagenham and Redbridge","0-1",0,1,5,5,1,-1,"A"
NA,1994,"Bath City","Dagenham and Redbridge","3-0",3,0,5,5,3,3,"H"
NA,1994,"Bromsgrove Rovers","Dagenham and Redbridge","2-2",2,2,5,5,4,0,"D"
NA,1994,"Dover Athletic","Dagenham and Redbridge","1-1",1,1,5,5,2,0,"D"
NA,1994,"Farnborough Town","Dagenham and Redbridge","1-3",1,3,5,5,4,-2,"A"
NA,1994,"Gateshead","Dagenham and Redbridge","2-1",2,1,5,5,3,1,"H"
NA,1994,"Halifax Town","Dagenham and Redbridge","1-1",1,1,5,5,2,0,"D"
NA,1994,"Kettering Town","Dagenham and Redbridge","2-2",2,2,5,5,4,0,"D"
NA,1994,"Kidderminster Harriers","Dagenham and Redbridge","1-1",1,1,5,5,2,0,"D"
NA,1994,"Macclesfield","Dagenham and Redbridge","2-0",2,0,5,5,2,2,"H"
NA,1994,"Merthyr Tydfil","Dagenham and Redbridge","2-0",2,0,5,5,2,2,"H"
NA,1994,"Northwich Victoria","Dagenham and Redbridge","5-0",5,0,5,5,5,5,"H"
NA,1994,"Runcorn","Dagenham and Redbridge","0-0",0,0,5,5,0,0,"D"
NA,1994,"Southport","Dagenham and Redbridge","1-1",1,1,5,5,2,0,"D"
NA,1994,"Stafford Rangers","Dagenham and Redbridge","1-2",1,2,5,5,3,-1,"A"
NA,1994,"Stalybridge Celtic","Dagenham and Redbridge","1-0",1,0,5,5,1,1,"H"
NA,1994,"Stevenage Borough","Dagenham and Redbridge","3-1",3,1,5,5,4,2,"H"
NA,1994,"Telford United","Dagenham and Redbridge","0-4",0,4,5,5,4,-4,"A"
NA,1994,"Welling United","Dagenham and Redbridge","4-1",4,1,5,5,5,3,"H"
NA,1994,"Woking","Dagenham and Redbridge","3-5",3,5,5,5,8,-2,"A"
NA,1994,"Yeovil","Dagenham and Redbridge","2-2",2,2,5,5,4,0,"D"
NA,1994,"Altrincham","Dover Athletic","3-0",3,0,5,5,3,3,"H"
NA,1994,"Bath City","Dover Athletic","0-0",0,0,5,5,0,0,"D"
NA,1994,"Bromsgrove Rovers","Dover Athletic","2-0",2,0,5,5,2,2,"H"
NA,1994,"Dagenham and Redbridge","Dover Athletic","2-0",2,0,5,5,2,2,"H"
NA,1994,"Farnborough Town","Dover Athletic","1-0",1,0,5,5,1,1,"H"
NA,1994,"Gateshead","Dover Athletic","1-0",1,0,5,5,1,1,"H"
NA,1994,"Halifax Town","Dover Athletic","4-0",4,0,5,5,4,4,"H"
NA,1994,"Kettering Town","Dover Athletic","1-0",1,0,5,5,1,1,"H"
NA,1994,"Kidderminster Harriers","Dover Athletic","0-0",0,0,5,5,0,0,"D"
NA,1994,"Macclesfield","Dover Athletic","3-0",3,0,5,5,3,3,"H"
NA,1994,"Merthyr Tydfil","Dover Athletic","2-3",2,3,5,5,5,-1,"A"
NA,1994,"Northwich Victoria","Dover Athletic","1-3",1,3,5,5,4,-2,"A"
NA,1994,"Runcorn","Dover Athletic","3-3",3,3,5,5,6,0,"D"
NA,1994,"Southport","Dover Athletic","2-2",2,2,5,5,4,0,"D"
NA,1994,"Stafford Rangers","Dover Athletic","1-0",1,0,5,5,1,1,"H"
NA,1994,"Stalybridge Celtic","Dover Athletic","2-1",2,1,5,5,3,1,"H"
NA,1994,"Stevenage Borough","Dover Athletic","0-3",0,3,5,5,3,-3,"A"
NA,1994,"Telford United","Dover Athletic","1-1",1,1,5,5,2,0,"D"
NA,1994,"Welling United","Dover Athletic","0-1",0,1,5,5,1,-1,"A"
NA,1994,"Woking","Dover Athletic","0-0",0,0,5,5,0,0,"D"
NA,1994,"Yeovil","Dover Athletic","1-3",1,3,5,5,4,-2,"A"
NA,1994,"Altrincham","Farnborough Town","2-0",2,0,5,5,2,2,"H"
NA,1994,"Bath City","Farnborough Town","2-0",2,0,5,5,2,2,"H"
NA,1994,"Bromsgrove Rovers","Farnborough Town","2-2",2,2,5,5,4,0,"D"
NA,1994,"Dagenham and Redbridge","Farnborough Town","0-1",0,1,5,5,1,-1,"A"
NA,1994,"Dover Athletic","Farnborough Town","1-1",1,1,5,5,2,0,"D"
NA,1994,"Gateshead","Farnborough Town","2-0",2,0,5,5,2,2,"H"
NA,1994,"Halifax Town","Farnborough Town","0-1",0,1,5,5,1,-1,"A"
NA,1994,"Kettering Town","Farnborough Town","4-1",4,1,5,5,5,3,"H"
NA,1994,"Kidderminster Harriers","Farnborough Town","0-1",0,1,5,5,1,-1,"A"
NA,1994,"Macclesfield","Farnborough Town","4-1",4,1,5,5,5,3,"H"
NA,1994,"Merthyr Tydfil","Farnborough Town","1-1",1,1,5,5,2,0,"D"
NA,1994,"Northwich Victoria","Farnborough Town","1-2",1,2,5,5,3,-1,"A"
NA,1994,"Runcorn","Farnborough Town","1-0",1,0,5,5,1,1,"H"
NA,1994,"Southport","Farnborough Town","0-1",0,1,5,5,1,-1,"A"
NA,1994,"Stafford Rangers","Farnborough Town","1-1",1,1,5,5,2,0,"D"
NA,1994,"Stalybridge Celtic","Farnborough Town","4-1",4,1,5,5,5,3,"H"
NA,1994,"Stevenage Borough","Farnborough Town","3-1",3,1,5,5,4,2,"H"
NA,1994,"Telford United","Farnborough Town","1-1",1,1,5,5,2,0,"D"
NA,1994,"Welling United","Farnborough Town","1-3",1,3,5,5,4,-2,"A"
NA,1994,"Woking","Farnborough Town","3-2",3,2,5,5,5,1,"H"
NA,1994,"Yeovil","Farnborough Town","0-1",0,1,5,5,1,-1,"A"
NA,1994,"Altrincham","Gateshead","1-3",1,3,5,5,4,-2,"A"
NA,1994,"Bath City","Gateshead","0-2",0,2,5,5,2,-2,"A"
NA,1994,"Bromsgrove Rovers","Gateshead","2-2",2,2,5,5,4,0,"D"
NA,1994,"Dagenham and Redbridge","Gateshead","0-0",0,0,5,5,0,0,"D"
NA,1994,"Dover Athletic","Gateshead","2-2",2,2,5,5,4,0,"D"
NA,1994,"Farnborough Town","Gateshead","3-1",3,1,5,5,4,2,"H"
NA,1994,"Halifax Town","Gateshead","3-2",3,2,5,5,5,1,"H"
NA,1994,"Kettering Town","Gateshead","2-4",2,4,5,5,6,-2,"A"
NA,1994,"Kidderminster Harriers","Gateshead","2-3",2,3,5,5,5,-1,"A"
NA,1994,"Macclesfield","Gateshead","2-1",2,1,5,5,3,1,"H"
NA,1994,"Merthyr Tydfil","Gateshead","1-2",1,2,5,5,3,-1,"A"
NA,1994,"Northwich Victoria","Gateshead","1-1",1,1,5,5,2,0,"D"
NA,1994,"Runcorn","Gateshead","3-2",3,2,5,5,5,1,"H"
NA,1994,"Southport","Gateshead","5-0",5,0,5,5,5,5,"H"
NA,1994,"Stafford Rangers","Gateshead","3-1",3,1,5,5,4,2,"H"
NA,1994,"Stalybridge Celtic","Gateshead","0-1",0,1,5,5,1,-1,"A"
NA,1994,"Stevenage Borough","Gateshead","2-3",2,3,5,5,5,-1,"A"
NA,1994,"Telford United","Gateshead","3-1",3,1,5,5,4,2,"H"
NA,1994,"Welling United","Gateshead","3-0",3,0,5,5,3,3,"H"
NA,1994,"Woking","Gateshead","1-1",1,1,5,5,2,0,"D"
NA,1994,"Yeovil","Gateshead","1-1",1,1,5,5,2,0,"D"
NA,1994,"Altrincham","Halifax Town","3-1",3,1,5,5,4,2,"H"
NA,1994,"Bath City","Halifax Town","0-0",0,0,5,5,0,0,"D"
NA,1994,"Bromsgrove Rovers","Halifax Town","0-1",0,1,5,5,1,-1,"A"
NA,1994,"Dagenham and Redbridge","Halifax Town","1-4",1,4,5,5,5,-3,"A"
NA,1994,"Dover Athletic","Halifax Town","1-1",1,1,5,5,2,0,"D"
NA,1994,"Farnborough Town","Halifax Town","2-0",2,0,5,5,2,2,"H"
NA,1994,"Gateshead","Halifax Town","1-2",1,2,5,5,3,-1,"A"
NA,1994,"Kettering Town","Halifax Town","5-1",5,1,5,5,6,4,"H"
NA,1994,"Kidderminster Harriers","Halifax Town","3-0",3,0,5,5,3,3,"H"
NA,1994,"Macclesfield","Halifax Town","1-1",1,1,5,5,2,0,"D"
NA,1994,"Merthyr Tydfil","Halifax Town","2-0",2,0,5,5,2,2,"H"
NA,1994,"Northwich Victoria","Halifax Town","3-0",3,0,5,5,3,3,"H"
NA,1994,"Runcorn","Halifax Town","0-3",0,3,5,5,3,-3,"A"
NA,1994,"Southport","Halifax Town","4-0",4,0,5,5,4,4,"H"
NA,1994,"Stafford Rangers","Halifax Town","0-1",0,1,5,5,1,-1,"A"
NA,1994,"Stalybridge Celtic","Halifax Town","1-0",1,0,5,5,1,1,"H"
NA,1994,"Stevenage Borough","Halifax Town","1-0",1,0,5,5,1,1,"H"
NA,1994,"Telford United","Halifax Town","1-1",1,1,5,5,2,0,"D"
NA,1994,"Welling United","Halifax Town","1-1",1,1,5,5,2,0,"D"
NA,1994,"Woking","Halifax Town","1-3",1,3,5,5,4,-2,"A"
NA,1994,"Yeovil","Halifax Town","3-1",3,1,5,5,4,2,"H"
NA,1994,"Altrincham","Kettering Town","2-4",2,4,5,5,6,-2,"A"
NA,1994,"Bath City","Kettering Town","2-0",2,0,5,5,2,2,"H"
NA,1994,"Bromsgrove Rovers","Kettering Town","2-4",2,4,5,5,6,-2,"A"
NA,1994,"Dagenham and Redbridge","Kettering Town","2-1",2,1,5,5,3,1,"H"
NA,1994,"Dover Athletic","Kettering Town","0-2",0,2,5,5,2,-2,"A"
NA,1994,"Farnborough Town","Kettering Town","0-0",0,0,5,5,0,0,"D"
NA,1994,"Gateshead","Kettering Town","0-0",0,0,5,5,0,0,"D"
NA,1994,"Halifax Town","Kettering Town","2-1",2,1,5,5,3,1,"H"
NA,1994,"Kidderminster Harriers","Kettering Town","1-3",1,3,5,5,4,-2,"A"
NA,1994,"Macclesfield","Kettering Town","1-0",1,0,5,5,1,1,"H"
NA,1994,"Merthyr Tydfil","Kettering Town","2-1",2,1,5,5,3,1,"H"
NA,1994,"Northwich Victoria","Kettering Town","3-2",3,2,5,5,5,1,"H"
NA,1994,"Runcorn","Kettering Town","1-2",1,2,5,5,3,-1,"A"
NA,1994,"Southport","Kettering Town","1-1",1,1,5,5,2,0,"D"
NA,1994,"Stafford Rangers","Kettering Town","2-3",2,3,5,5,5,-1,"A"
NA,1994,"Stalybridge Celtic","Kettering Town","1-4",1,4,5,5,5,-3,"A"
NA,1994,"Stevenage Borough","Kettering Town","2-2",2,2,5,5,4,0,"D"
NA,1994,"Telford United","Kettering Town","1-0",1,0,5,5,1,1,"H"
NA,1994,"Welling United","Kettering Town","2-1",2,1,5,5,3,1,"H"
NA,1994,"Woking","Kettering Town","3-1",3,1,5,5,4,2,"H"
NA,1994,"Yeovil","Kettering Town","1-1",1,1,5,5,2,0,"D"
NA,1994,"Altrincham","Kidderminster Harriers","2-0",2,0,5,5,2,2,"H"
NA,1994,"Bath City","Kidderminster Harriers","3-5",3,5,5,5,8,-2,"A"
NA,1994,"Bromsgrove Rovers","Kidderminster Harriers","4-3",4,3,5,5,7,1,"H"
NA,1994,"Dagenham and Redbridge","Kidderminster Harriers","1-2",1,2,5,5,3,-1,"A"
NA,1994,"Dover Athletic","Kidderminster Harriers","1-0",1,0,5,5,1,1,"H"
NA,1994,"Farnborough Town","Kidderminster Harriers","1-0",1,0,5,5,1,1,"H"
NA,1994,"Gateshead","Kidderminster Harriers","1-0",1,0,5,5,1,1,"H"
NA,1994,"Halifax Town","Kidderminster Harriers","1-2",1,2,5,5,3,-1,"A"
NA,1994,"Kettering Town","Kidderminster Harriers","0-0",0,0,5,5,0,0,"D"
NA,1994,"Macclesfield","Kidderminster Harriers","1-3",1,3,5,5,4,-2,"A"
NA,1994,"Merthyr Tydfil","Kidderminster Harriers","0-1",0,1,5,5,1,-1,"A"
NA,1994,"Northwich Victoria","Kidderminster Harriers","3-4",3,4,5,5,7,-1,"A"
NA,1994,"Runcorn","Kidderminster Harriers","2-2",2,2,5,5,4,0,"D"
NA,1994,"Southport","Kidderminster Harriers","4-1",4,1,5,5,5,3,"H"
NA,1994,"Stafford Rangers","Kidderminster Harriers","1-2",1,2,5,5,3,-1,"A"
NA,1994,"Stalybridge Celtic","Kidderminster Harriers","1-3",1,3,5,5,4,-2,"A"
NA,1994,"Stevenage Borough","Kidderminster Harriers","2-3",2,3,5,5,5,-1,"A"
NA,1994,"Telford United","Kidderminster Harriers","3-1",3,1,5,5,4,2,"H"
NA,1994,"Welling United","Kidderminster Harriers","0-2",0,2,5,5,2,-2,"A"
NA,1994,"Woking","Kidderminster Harriers","0-0",0,0,5,5,0,0,"D"
NA,1994,"Yeovil","Kidderminster Harriers","1-1",1,1,5,5,2,0,"D"
NA,1994,"Altrincham","Macclesfield","1-2",1,2,5,5,3,-1,"A"
NA,1994,"Bath City","Macclesfield","1-0",1,0,5,5,1,1,"H"
NA,1994,"Bromsgrove Rovers","Macclesfield","2-2",2,2,5,5,4,0,"D"
NA,1994,"Dagenham and Redbridge","Macclesfield","0-4",0,4,5,5,4,-4,"A"
NA,1994,"Dover Athletic","Macclesfield","0-0",0,0,5,5,0,0,"D"
NA,1994,"Farnborough Town","Macclesfield","1-0",1,0,5,5,1,1,"H"
NA,1994,"Gateshead","Macclesfield","2-1",2,1,5,5,3,1,"H"
NA,1994,"Halifax Town","Macclesfield","0-1",0,1,5,5,1,-1,"A"
NA,1994,"Kettering Town","Macclesfield","1-0",1,0,5,5,1,1,"H"
NA,1994,"Kidderminster Harriers","Macclesfield","1-2",1,2,5,5,3,-1,"A"
NA,1994,"Merthyr Tydfil","Macclesfield","1-2",1,2,5,5,3,-1,"A"
NA,1994,"Northwich Victoria","Macclesfield","1-3",1,3,5,5,4,-2,"A"
NA,1994,"Runcorn","Macclesfield","2-2",2,2,5,5,4,0,"D"
NA,1994,"Southport","Macclesfield","2-3",2,3,5,5,5,-1,"A"
NA,1994,"Stafford Rangers","Macclesfield","0-3",0,3,5,5,3,-3,"A"
NA,1994,"Stalybridge Celtic","Macclesfield","2-2",2,2,5,5,4,0,"D"
NA,1994,"Stevenage Borough","Macclesfield","1-1",1,1,5,5,2,0,"D"
NA,1994,"Telford United","Macclesfield","2-0",2,0,5,5,2,2,"H"
NA,1994,"Welling United","Macclesfield","0-1",0,1,5,5,1,-1,"A"
NA,1994,"Woking","Macclesfield","1-0",1,0,5,5,1,1,"H"
NA,1994,"Yeovil","Macclesfield","1-2",1,2,5,5,3,-1,"A"
NA,1994,"Altrincham","Merthyr Tydfil","1-0",1,0,5,5,1,1,"H"
NA,1994,"Bath City","Merthyr Tydfil","1-0",1,0,5,5,1,1,"H"
NA,1994,"Bromsgrove Rovers","Merthyr Tydfil","2-0",2,0,5,5,2,2,"H"
NA,1994,"Dagenham and Redbridge","Merthyr Tydfil","2-1",2,1,5,5,3,1,"H"
NA,1994,"Dover Athletic","Merthyr Tydfil","2-2",2,2,5,5,4,0,"D"
NA,1994,"Farnborough Town","Merthyr Tydfil","2-1",2,1,5,5,3,1,"H"
NA,1994,"Gateshead","Merthyr Tydfil","2-0",2,0,5,5,2,2,"H"
NA,1994,"Halifax Town","Merthyr Tydfil","2-2",2,2,5,5,4,0,"D"
NA,1994,"Kettering Town","Merthyr Tydfil","4-1",4,1,5,5,5,3,"H"
NA,1994,"Kidderminster Harriers","Merthyr Tydfil","2-0",2,0,5,5,2,2,"H"
NA,1994,"Macclesfield","Merthyr Tydfil","0-0",0,0,5,5,0,0,"D"
NA,1994,"Northwich Victoria","Merthyr Tydfil","2-0",2,0,5,5,2,2,"H"
NA,1994,"Runcorn","Merthyr Tydfil","0-0",0,0,5,5,0,0,"D"
NA,1994,"Southport","Merthyr Tydfil","3-1",3,1,5,5,4,2,"H"
NA,1994,"Stafford Rangers","Merthyr Tydfil","2-1",2,1,5,5,3,1,"H"
NA,1994,"Stalybridge Celtic","Merthyr Tydfil","1-1",1,1,5,5,2,0,"D"
NA,1994,"Stevenage Borough","Merthyr Tydfil","0-0",0,0,5,5,0,0,"D"
NA,1994,"Telford United","Merthyr Tydfil","1-1",1,1,5,5,2,0,"D"
NA,1994,"Welling United","Merthyr Tydfil","2-1",2,1,5,5,3,1,"H"
NA,1994,"Woking","Merthyr Tydfil","4-1",4,1,5,5,5,3,"H"
NA,1994,"Yeovil","Merthyr Tydfil","1-3",1,3,5,5,4,-2,"A"
NA,1994,"Altrincham","Northwich Victoria","1-3",1,3,5,5,4,-2,"A"
NA,1994,"Bath City","Northwich Victoria","2-2",2,2,5,5,4,0,"D"
NA,1994,"Bromsgrove Rovers","Northwich Victoria","1-4",1,4,5,5,5,-3,"A"
NA,1994,"Dagenham and Redbridge","Northwich Victoria","1-2",1,2,5,5,3,-1,"A"
NA,1994,"Dover Athletic","Northwich Victoria","3-1",3,1,5,5,4,2,"H"
NA,1994,"Farnborough Town","Northwich Victoria","2-1",2,1,5,5,3,1,"H"
NA,1994,"Gateshead","Northwich Victoria","4-0",4,0,5,5,4,4,"H"
NA,1994,"Halifax Town","Northwich Victoria","0-0",0,0,5,5,0,0,"D"
NA,1994,"Kettering Town","Northwich Victoria","3-3",3,3,5,5,6,0,"D"
NA,1994,"Kidderminster Harriers","Northwich Victoria","1-2",1,2,5,5,3,-1,"A"
NA,1994,"Macclesfield","Northwich Victoria","3-1",3,1,5,5,4,2,"H"
NA,1994,"Merthyr Tydfil","Northwich Victoria","2-0",2,0,5,5,2,2,"H"
NA,1994,"Runcorn","Northwich Victoria","2-2",2,2,5,5,4,0,"D"
NA,1994,"Southport","Northwich Victoria","0-2",0,2,5,5,2,-2,"A"
NA,1994,"Stafford Rangers","Northwich Victoria","1-3",1,3,5,5,4,-2,"A"
NA,1994,"Stalybridge Celtic","Northwich Victoria","2-1",2,1,5,5,3,1,"H"
NA,1994,"Stevenage Borough","Northwich Victoria","1-1",1,1,5,5,2,0,"D"
NA,1994,"Telford United","Northwich Victoria","1-0",1,0,5,5,1,1,"H"
NA,1994,"Welling United","Northwich Victoria","1-5",1,5,5,5,6,-4,"A"
NA,1994,"Woking","Northwich Victoria","1-1",1,1,5,5,2,0,"D"
NA,1994,"Yeovil","Northwich Victoria","4-4",4,4,5,5,8,0,"D"
NA,1994,"Altrincham","Runcorn","3-2",3,2,5,5,5,1,"H"
NA,1994,"Bath City","Runcorn","4-3",4,3,5,5,7,1,"H"
NA,1994,"Bromsgrove Rovers","Runcorn","1-0",1,0,5,5,1,1,"H"
NA,1994,"Dagenham and Redbridge","Runcorn","3-2",3,2,5,5,5,1,"H"
NA,1994,"Dover Athletic","Runcorn","1-1",1,1,5,5,2,0,"D"
NA,1994,"Farnborough Town","Runcorn","0-4",0,4,5,5,4,-4,"A"
NA,1994,"Gateshead","Runcorn","4-0",4,0,5,5,4,4,"H"
NA,1994,"Halifax Town","Runcorn","4-0",4,0,5,5,4,4,"H"
NA,1994,"Kettering Town","Runcorn","3-0",3,0,5,5,3,3,"H"
NA,1994,"Kidderminster Harriers","Runcorn","1-1",1,1,5,5,2,0,"D"
NA,1994,"Macclesfield","Runcorn","0-1",0,1,5,5,1,-1,"A"
NA,1994,"Merthyr Tydfil","Runcorn","3-0",3,0,5,5,3,3,"H"
NA,1994,"Northwich Victoria","Runcorn","4-1",4,1,5,5,5,3,"H"
NA,1994,"Southport","Runcorn","5-0",5,0,5,5,5,5,"H"
NA,1994,"Stafford Rangers","Runcorn","1-2",1,2,5,5,3,-1,"A"
NA,1994,"Stalybridge Celtic","Runcorn","0-0",0,0,5,5,0,0,"D"
NA,1994,"Stevenage Borough","Runcorn","0-1",0,1,5,5,1,-1,"A"
NA,1994,"Telford United","Runcorn","2-0",2,0,5,5,2,2,"H"
NA,1994,"Welling United","Runcorn","1-2",1,2,5,5,3,-1,"A"
NA,1994,"Woking","Runcorn","2-0",2,0,5,5,2,2,"H"
NA,1994,"Yeovil","Runcorn","1-0",1,0,5,5,1,1,"H"
NA,1994,"Altrincham","Southport","0-0",0,0,5,5,0,0,"D"
NA,1994,"Bath City","Southport","1-2",1,2,5,5,3,-1,"A"
NA,1994,"Bromsgrove Rovers","Southport","1-1",1,1,5,5,2,0,"D"
NA,1994,"Dagenham and Redbridge","Southport","5-1",5,1,5,5,6,4,"H"
NA,1994,"Dover Athletic","Southport","1-2",1,2,5,5,3,-1,"A"
NA,1994,"Farnborough Town","Southport","1-4",1,4,5,5,5,-3,"A"
NA,1994,"Gateshead","Southport","0-1",0,1,5,5,1,-1,"A"
NA,1994,"Halifax Town","Southport","2-0",2,0,5,5,2,2,"H"
NA,1994,"Kettering Town","Southport","1-0",1,0,5,5,1,1,"H"
NA,1994,"Kidderminster Harriers","Southport","0-1",0,1,5,5,1,-1,"A"
NA,1994,"Macclesfield","Southport","3-0",3,0,5,5,3,3,"H"
NA,1994,"Merthyr Tydfil","Southport","1-2",1,2,5,5,3,-1,"A"
NA,1994,"Northwich Victoria","Southport","2-1",2,1,5,5,3,1,"H"
NA,1994,"Runcorn","Southport","2-1",2,1,5,5,3,1,"H"
NA,1994,"Stafford Rangers","Southport","1-1",1,1,5,5,2,0,"D"
NA,1994,"Stalybridge Celtic","Southport","1-1",1,1,5,5,2,0,"D"
NA,1994,"Stevenage Borough","Southport","1-2",1,2,5,5,3,-1,"A"
NA,1994,"Telford United","Southport","0-0",0,0,5,5,0,0,"D"
NA,1994,"Welling United","Southport","3-1",3,1,5,5,4,2,"H"
NA,1994,"Woking","Southport","3-0",3,0,5,5,3,3,"H"
NA,1994,"Yeovil","Southport","0-1",0,1,5,5,1,-1,"A"
NA,1994,"Altrincham","Stafford Rangers","5-1",5,1,5,5,6,4,"H"
NA,1994,"Bath City","Stafford Rangers","3-3",3,3,5,5,6,0,"D"
NA,1994,"Bromsgrove Rovers","Stafford Rangers","2-1",2,1,5,5,3,1,"H"
NA,1994,"Dagenham and Redbridge","Stafford Rangers","3-3",3,3,5,5,6,0,"D"
NA,1994,"Dover Athletic","Stafford Rangers","3-2",3,2,5,5,5,1,"H"
NA,1994,"Farnborough Town","Stafford Rangers","0-0",0,0,5,5,0,0,"D"
NA,1994,"Gateshead","Stafford Rangers","1-1",1,1,5,5,2,0,"D"
NA,1994,"Halifax Town","Stafford Rangers","6-0",6,0,5,5,6,6,"H"
NA,1994,"Kettering Town","Stafford Rangers","1-0",1,0,5,5,1,1,"H"
NA,1994,"Kidderminster Harriers","Stafford Rangers","1-2",1,2,5,5,3,-1,"A"
NA,1994,"Macclesfield","Stafford Rangers","1-2",1,2,5,5,3,-1,"A"
NA,1994,"Merthyr Tydfil","Stafford Rangers","4-1",4,1,5,5,5,3,"H"
NA,1994,"Northwich Victoria","Stafford Rangers","0-1",0,1,5,5,1,-1,"A"
NA,1994,"Runcorn","Stafford Rangers","3-1",3,1,5,5,4,2,"H"
NA,1994,"Southport","Stafford Rangers","3-0",3,0,5,5,3,3,"H"
NA,1994,"Stalybridge Celtic","Stafford Rangers","2-3",2,3,5,5,5,-1,"A"
NA,1994,"Stevenage Borough","Stafford Rangers","1-0",1,0,5,5,1,1,"H"
NA,1994,"Telford United","Stafford Rangers","0-0",0,0,5,5,0,0,"D"
NA,1994,"Welling United","Stafford Rangers","3-1",3,1,5,5,4,2,"H"
NA,1994,"Woking","Stafford Rangers","2-2",2,2,5,5,4,0,"D"
NA,1994,"Yeovil","Stafford Rangers","1-0",1,0,5,5,1,1,"H"
NA,1994,"Altrincham","Stalybridge Celtic","1-0",1,0,5,5,1,1,"H"
NA,1994,"Bath City","Stalybridge Celtic","2-3",2,3,5,5,5,-1,"A"
NA,1994,"Bromsgrove Rovers","Stalybridge Celtic","2-1",2,1,5,5,3,1,"H"
NA,1994,"Dagenham and Redbridge","Stalybridge Celtic","2-2",2,2,5,5,4,0,"D"
NA,1994,"Dover Athletic","Stalybridge Celtic","0-0",0,0,5,5,0,0,"D"
NA,1994,"Farnborough Town","Stalybridge Celtic","0-0",0,0,5,5,0,0,"D"
NA,1994,"Gateshead","Stalybridge Celtic","0-0",0,0,5,5,0,0,"D"
NA,1994,"Halifax Town","Stalybridge Celtic","1-1",1,1,5,5,2,0,"D"
NA,1994,"Kettering Town","Stalybridge Celtic","1-0",1,0,5,5,1,1,"H"
NA,1994,"Kidderminster Harriers","Stalybridge Celtic","3-2",3,2,5,5,5,1,"H"
NA,1994,"Macclesfield","Stalybridge Celtic","3-0",3,0,5,5,3,3,"H"
NA,1994,"Merthyr Tydfil","Stalybridge Celtic","4-2",4,2,5,5,6,2,"H"
NA,1994,"Northwich Victoria","Stalybridge Celtic","2-2",2,2,5,5,4,0,"D"
NA,1994,"Runcorn","Stalybridge Celtic","0-3",0,3,5,5,3,-3,"A"
NA,1994,"Southport","Stalybridge Celtic","3-1",3,1,5,5,4,2,"H"
NA,1994,"Stafford Rangers","Stalybridge Celtic","5-0",5,0,5,5,5,5,"H"
NA,1994,"Stevenage Borough","Stalybridge Celtic","5-1",5,1,5,5,6,4,"H"
NA,1994,"Telford United","Stalybridge Celtic","1-1",1,1,5,5,2,0,"D"
NA,1994,"Welling United","Stalybridge Celtic","3-3",3,3,5,5,6,0,"D"
NA,1994,"Woking","Stalybridge Celtic","4-1",4,1,5,5,5,3,"H"
NA,1994,"Yeovil","Stalybridge Celtic","3-0",3,0,5,5,3,3,"H"
NA,1994,"Altrincham","Stevenage Borough","1-2",1,2,5,5,3,-1,"A"
NA,1994,"Bath City","Stevenage Borough","2-1",2,1,5,5,3,1,"H"
NA,1994,"Bromsgrove Rovers","Stevenage Borough","2-1",2,1,5,5,3,1,"H"
NA,1994,"Dagenham and Redbridge","Stevenage Borough","0-1",0,1,5,5,1,-1,"A"
NA,1994,"Dover Athletic","Stevenage Borough","2-0",2,0,5,5,2,2,"H"
NA,1994,"Farnborough Town","Stevenage Borough","1-1",1,1,5,5,2,0,"D"
NA,1994,"Gateshead","Stevenage Borough","1-2",1,2,5,5,3,-1,"A"
NA,1994,"Halifax Town","Stevenage Borough","0-2",0,2,5,5,2,-2,"A"
NA,1994,"Kettering Town","Stevenage Borough","0-2",0,2,5,5,2,-2,"A"
NA,1994,"Kidderminster Harriers","Stevenage Borough","0-3",0,3,5,5,3,-3,"A"
NA,1994,"Macclesfield","Stevenage Borough","0-3",0,3,5,5,3,-3,"A"
NA,1994,"Merthyr Tydfil","Stevenage Borough","2-2",2,2,5,5,4,0,"D"
NA,1994,"Northwich Victoria","Stevenage Borough","0-1",0,1,5,5,1,-1,"A"
NA,1994,"Runcorn","Stevenage Borough","3-1",3,1,5,5,4,2,"H"
NA,1994,"Southport","Stevenage Borough","2-1",2,1,5,5,3,1,"H"
NA,1994,"Stafford Rangers","Stevenage Borough","0-3",0,3,5,5,3,-3,"A"
NA,1994,"Stalybridge Celtic","Stevenage Borough","1-0",1,0,5,5,1,1,"H"
NA,1994,"Telford United","Stevenage Borough","1-2",1,2,5,5,3,-1,"A"
NA,1994,"Welling United","Stevenage Borough","1-0",1,0,5,5,1,1,"H"
NA,1994,"Woking","Stevenage Borough","3-0",3,0,5,5,3,3,"H"
NA,1994,"Yeovil","Stevenage Borough","0-0",0,0,5,5,0,0,"D"
NA,1994,"Altrincham","Telford United","3-1",3,1,5,5,4,2,"H"
NA,1994,"Bath City","Telford United","1-1",1,1,5,5,2,0,"D"
NA,1994,"Bromsgrove Rovers","Telford United","0-1",0,1,5,5,1,-1,"A"
NA,1994,"Dagenham and Redbridge","Telford United","3-2",3,2,5,5,5,1,"H"
NA,1994,"Dover Athletic","Telford United","2-0",2,0,5,5,2,2,"H"
NA,1994,"Farnborough Town","Telford United","5-3",5,3,5,5,8,2,"H"
NA,1994,"Gateshead","Telford United","0-0",0,0,5,5,0,0,"D"
NA,1994,"Halifax Town","Telford United","1-1",1,1,5,5,2,0,"D"
NA,1994,"Kettering Town","Telford United","3-2",3,2,5,5,5,1,"H"
NA,1994,"Kidderminster Harriers","Telford United","1-1",1,1,5,5,2,0,"D"
NA,1994,"Macclesfield","Telford United","2-0",2,0,5,5,2,2,"H"
NA,1994,"Merthyr Tydfil","Telford United","3-1",3,1,5,5,4,2,"H"
NA,1994,"Northwich Victoria","Telford United","1-1",1,1,5,5,2,0,"D"
NA,1994,"Runcorn","Telford United","4-1",4,1,5,5,5,3,"H"
NA,1994,"Southport","Telford United","2-1",2,1,5,5,3,1,"H"
NA,1994,"Stafford Rangers","Telford United","2-2",2,2,5,5,4,0,"D"
NA,1994,"Stalybridge Celtic","Telford United","1-0",1,0,5,5,1,1,"H"
NA,1994,"Stevenage Borough","Telford United","4-3",4,3,5,5,7,1,"H"
NA,1994,"Welling United","Telford United","1-0",1,0,5,5,1,1,"H"
NA,1994,"Woking","Telford United","2-1",2,1,5,5,3,1,"H"
NA,1994,"Yeovil","Telford United","1-1",1,1,5,5,2,0,"D"
NA,1994,"Altrincham","Welling United","1-1",1,1,5,5,2,0,"D"
NA,1994,"Bath City","Welling United","2-0",2,0,5,5,2,2,"H"
NA,1994,"Bromsgrove Rovers","Welling United","4-1",4,1,5,5,5,3,"H"
NA,1994,"Dagenham and Redbridge","Welling United","0-0",0,0,5,5,0,0,"D"
NA,1994,"Dover Athletic","Welling United","1-1",1,1,5,5,2,0,"D"
NA,1994,"Farnborough Town","Welling United","1-2",1,2,5,5,3,-1,"A"
NA,1994,"Gateshead","Welling United","2-0",2,0,5,5,2,2,"H"
NA,1994,"Halifax Town","Welling United","4-0",4,0,5,5,4,4,"H"
NA,1994,"Kettering Town","Welling United","4-3",4,3,5,5,7,1,"H"
NA,1994,"Kidderminster Harriers","Welling United","3-0",3,0,5,5,3,3,"H"
NA,1994,"Macclesfield","Welling United","3-1",3,1,5,5,4,2,"H"
NA,1994,"Merthyr Tydfil","Welling United","0-2",0,2,5,5,2,-2,"A"
NA,1994,"Northwich Victoria","Welling United","1-1",1,1,5,5,2,0,"D"
NA,1994,"Runcorn","Welling United","3-2",3,2,5,5,5,1,"H"
NA,1994,"Southport","Welling United","1-0",1,0,5,5,1,1,"H"
NA,1994,"Stafford Rangers","Welling United","1-1",1,1,5,5,2,0,"D"
NA,1994,"Stalybridge Celtic","Welling United","1-3",1,3,5,5,4,-2,"A"
NA,1994,"Stevenage Borough","Welling United","1-2",1,2,5,5,3,-1,"A"
NA,1994,"Telford United","Welling United","4-2",4,2,5,5,6,2,"H"
NA,1994,"Woking","Welling United","1-1",1,1,5,5,2,0,"D"
NA,1994,"Yeovil","Welling United","3-3",3,3,5,5,6,0,"D"
NA,1994,"Altrincham","Woking","1-2",1,2,5,5,3,-1,"A"
NA,1994,"Bath City","Woking","2-0",2,0,5,5,2,2,"H"
NA,1994,"Bromsgrove Rovers","Woking","5-5",5,5,5,5,10,0,"D"
NA,1994,"Dagenham and Redbridge","Woking","0-2",0,2,5,5,2,-2,"A"
NA,1994,"Dover Athletic","Woking","2-3",2,3,5,5,5,-1,"A"
NA,1994,"Farnborough Town","Woking","0-2",0,2,5,5,2,-2,"A"
NA,1994,"Gateshead","Woking","2-0",2,0,5,5,2,2,"H"
NA,1994,"Halifax Town","Woking","4-0",4,0,5,5,4,4,"H"
NA,1994,"Kettering Town","Woking","0-1",0,1,5,5,1,-1,"A"
NA,1994,"Kidderminster Harriers","Woking","1-3",1,3,5,5,4,-2,"A"
NA,1994,"Macclesfield","Woking","2-0",2,0,5,5,2,2,"H"
NA,1994,"Merthyr Tydfil","Woking","1-1",1,1,5,5,2,0,"D"
NA,1994,"Northwich Victoria","Woking","2-2",2,2,5,5,4,0,"D"
NA,1994,"Runcorn","Woking","1-0",1,0,5,5,1,1,"H"
NA,1994,"Southport","Woking","2-0",2,0,5,5,2,2,"H"
NA,1994,"Stafford Rangers","Woking","2-3",2,3,5,5,5,-1,"A"
NA,1994,"Stalybridge Celtic","Woking","2-1",2,1,5,5,3,1,"H"
NA,1994,"Stevenage Borough","Woking","0-1",0,1,5,5,1,-1,"A"
NA,1994,"Telford United","Woking","0-0",0,0,5,5,0,0,"D"
NA,1994,"Welling United","Woking","1-2",1,2,5,5,3,-1,"A"
NA,1994,"Yeovil","Woking","1-2",1,2,5,5,3,-1,"A"
NA,1994,"Altrincham","Yeovil","1-3",1,3,5,5,4,-2,"A"
NA,1994,"Bath City","Yeovil","3-0",3,0,5,5,3,3,"H"
NA,1994,"Bromsgrove Rovers","Yeovil","5-0",5,0,5,5,5,5,"H"
NA,1994,"Dagenham and Redbridge","Yeovil","0-0",0,0,5,5,0,0,"D"
NA,1994,"Dover Athletic","Yeovil","1-1",1,1,5,5,2,0,"D"
NA,1994,"Farnborough Town","Yeovil","0-3",0,3,5,5,3,-3,"A"
NA,1994,"Gateshead","Yeovil","0-3",0,3,5,5,3,-3,"A"
NA,1994,"Halifax Town","Yeovil","2-1",2,1,5,5,3,1,"H"
NA,1994,"Kettering Town","Yeovil","3-2",3,2,5,5,5,1,"H"
NA,1994,"Kidderminster Harriers","Yeovil","3-0",3,0,5,5,3,3,"H"
NA,1994,"Macclesfield","Yeovil","1-0",1,0,5,5,1,1,"H"
NA,1994,"Merthyr Tydfil","Yeovil","0-0",0,0,5,5,0,0,"D"
NA,1994,"Northwich Victoria","Yeovil","2-2",2,2,5,5,4,0,"D"
NA,1994,"Runcorn","Yeovil","2-1",2,1,5,5,3,1,"H"
NA,1994,"Southport","Yeovil","0-0",0,0,5,5,0,0,"D"
NA,1994,"Stafford Rangers","Yeovil","4-1",4,1,5,5,5,3,"H"
NA,1994,"Stalybridge Celtic","Yeovil","3-1",3,1,5,5,4,2,"H"
NA,1994,"Stevenage Borough","Yeovil","5-0",5,0,5,5,5,5,"H"
NA,1994,"Telford United","Yeovil","1-0",1,0,5,5,1,1,"H"
NA,1994,"Welling United","Yeovil","2-1",2,1,5,5,3,1,"H"
NA,1994,"Woking","Yeovil","2-2",2,2,5,5,4,0,"D"
NA,1995,"Bath City","Altrincham","2-2",2,2,5,5,4,0,"D"
NA,1995,"Bromsgrove Rovers","Altrincham","0-0",0,0,5,5,0,0,"D"
NA,1995,"Dagenham and Redbridge","Altrincham","1-0",1,0,5,5,1,1,"H"
NA,1995,"Dover Athletic","Altrincham","1-4",1,4,5,5,5,-3,"A"
NA,1995,"Farnborough Town","Altrincham","1-1",1,1,5,5,2,0,"D"
NA,1995,"Gateshead","Altrincham","2-3",2,3,5,5,5,-1,"A"
NA,1995,"Halifax Town","Altrincham","1-1",1,1,5,5,2,0,"D"
NA,1995,"Hednesford Town","Altrincham","2-1",2,1,5,5,3,1,"H"
NA,1995,"Kettering Town","Altrincham","4-2",4,2,5,5,6,2,"H"
NA,1995,"Kidderminster Harriers","Altrincham","1-1",1,1,5,5,2,0,"D"
NA,1995,"Macclesfield","Altrincham","2-3",2,3,5,5,5,-1,"A"
NA,1995,"Morecambe","Altrincham","7-0",7,0,5,5,7,7,"H"
NA,1995,"Northwich Victoria","Altrincham","2-1",2,1,5,5,3,1,"H"
NA,1995,"Runcorn","Altrincham","0-1",0,1,5,5,1,-1,"A"
NA,1995,"Slough Town","Altrincham","1-2",1,2,5,5,3,-1,"A"
NA,1995,"Southport","Altrincham","1-2",1,2,5,5,3,-1,"A"
NA,1995,"Stalybridge Celtic","Altrincham","1-0",1,0,5,5,1,1,"H"
NA,1995,"Stevenage Borough","Altrincham","1-1",1,1,5,5,2,0,"D"
NA,1995,"Telford United","Altrincham","2-0",2,0,5,5,2,2,"H"
NA,1995,"Welling United","Altrincham","1-1",1,1,5,5,2,0,"D"
NA,1995,"Woking","Altrincham","2-0",2,0,5,5,2,2,"H"
NA,1995,"Altrincham","Bath City","1-2",1,2,5,5,3,-1,"A"
NA,1995,"Bromsgrove Rovers","Bath City","4-1",4,1,5,5,5,3,"H"
NA,1995,"Dagenham and Redbridge","Bath City","0-1",0,1,5,5,1,-1,"A"
NA,1995,"Dover Athletic","Bath City","1-0",1,0,5,5,1,1,"H"
NA,1995,"Farnborough Town","Bath City","0-0",0,0,5,5,0,0,"D"
NA,1995,"Gateshead","Bath City","3-1",3,1,5,5,4,2,"H"
NA,1995,"Halifax Town","Bath City","3-1",3,1,5,5,4,2,"H"
NA,1995,"Hednesford Town","Bath City","2-1",2,1,5,5,3,1,"H"
NA,1995,"Kettering Town","Bath City","3-0",3,0,5,5,3,3,"H"
NA,1995,"Kidderminster Harriers","Bath City","1-2",1,2,5,5,3,-1,"A"
NA,1995,"Macclesfield","Bath City","0-1",0,1,5,5,1,-1,"A"
NA,1995,"Morecambe","Bath City","1-0",1,0,5,5,1,1,"H"
NA,1995,"Northwich Victoria","Bath City","2-2",2,2,5,5,4,0,"D"
NA,1995,"Runcorn","Bath City","1-0",1,0,5,5,1,1,"H"
NA,1995,"Slough Town","Bath City","1-1",1,1,5,5,2,0,"D"
NA,1995,"Southport","Bath City","2-1",2,1,5,5,3,1,"H"
NA,1995,"Stalybridge Celtic","Bath City","1-0",1,0,5,5,1,1,"H"
NA,1995,"Stevenage Borough","Bath City","2-0",2,0,5,5,2,2,"H"
NA,1995,"Telford United","Bath City","3-1",3,1,5,5,4,2,"H"
NA,1995,"Welling United","Bath City","2-1",2,1,5,5,3,1,"H"
NA,1995,"Woking","Bath City","2-0",2,0,5,5,2,2,"H"
NA,1995,"Altrincham","Bromsgrove Rovers","3-0",3,0,5,5,3,3,"H"
NA,1995,"Bath City","Bromsgrove Rovers","0-1",0,1,5,5,1,-1,"A"
NA,1995,"Dagenham and Redbridge","Bromsgrove Rovers","2-2",2,2,5,5,4,0,"D"
NA,1995,"Dover Athletic","Bromsgrove Rovers","0-2",0,2,5,5,2,-2,"A"
NA,1995,"Farnborough Town","Bromsgrove Rovers","1-0",1,0,5,5,1,1,"H"
NA,1995,"Gateshead","Bromsgrove Rovers","1-0",1,0,5,5,1,1,"H"
NA,1995,"Halifax Town","Bromsgrove Rovers","1-1",1,1,5,5,2,0,"D"
NA,1995,"Hednesford Town","Bromsgrove Rovers","4-2",4,2,5,5,6,2,"H"
NA,1995,"Kettering Town","Bromsgrove Rovers","2-2",2,2,5,5,4,0,"D"
NA,1995,"Kidderminster Harriers","Bromsgrove Rovers","1-0",1,0,5,5,1,1,"H"
NA,1995,"Macclesfield","Bromsgrove Rovers","2-1",2,1,5,5,3,1,"H"
NA,1995,"Morecambe","Bromsgrove Rovers","4-1",4,1,5,5,5,3,"H"
NA,1995,"Northwich Victoria","Bromsgrove Rovers","2-2",2,2,5,5,4,0,"D"
NA,1995,"Runcorn","Bromsgrove Rovers","0-0",0,0,5,5,0,0,"D"
NA,1995,"Slough Town","Bromsgrove Rovers","2-3",2,3,5,5,5,-1,"A"
NA,1995,"Southport","Bromsgrove Rovers","1-2",1,2,5,5,3,-1,"A"
NA,1995,"Stalybridge Celtic","Bromsgrove Rovers","2-1",2,1,5,5,3,1,"H"
NA,1995,"Stevenage Borough","Bromsgrove Rovers","3-3",3,3,5,5,6,0,"D"
NA,1995,"Telford United","Bromsgrove Rovers","0-0",0,0,5,5,0,0,"D"
NA,1995,"Welling United","Bromsgrove Rovers","5-2",5,2,5,5,7,3,"H"
NA,1995,"Woking","Bromsgrove Rovers","1-1",1,1,5,5,2,0,"D"
NA,1995,"Altrincham","Dagenham and Redbridge","3-1",3,1,5,5,4,2,"H"
NA,1995,"Bath City","Dagenham and Redbridge","0-2",0,2,5,5,2,-2,"A"
NA,1995,"Bromsgrove Rovers","Dagenham and Redbridge","2-0",2,0,5,5,2,2,"H"
NA,1995,"Dover Athletic","Dagenham and Redbridge","0-1",0,1,5,5,1,-1,"A"
NA,1995,"Farnborough Town","Dagenham and Redbridge","2-0",2,0,5,5,2,2,"H"
NA,1995,"Gateshead","Dagenham and Redbridge","2-0",2,0,5,5,2,2,"H"
NA,1995,"Halifax Town","Dagenham and Redbridge","3-0",3,0,5,5,3,3,"H"
NA,1995,"Hednesford Town","Dagenham and Redbridge","0-0",0,0,5,5,0,0,"D"
NA,1995,"Kettering Town","Dagenham and Redbridge","2-0",2,0,5,5,2,2,"H"
NA,1995,"Kidderminster Harriers","Dagenham and Redbridge","5-1",5,1,5,5,6,4,"H"
NA,1995,"Macclesfield","Dagenham and Redbridge","3-1",3,1,5,5,4,2,"H"
NA,1995,"Morecambe","Dagenham and Redbridge","2-2",2,2,5,5,4,0,"D"
NA,1995,"Northwich Victoria","Dagenham and Redbridge","1-0",1,0,5,5,1,1,"H"
NA,1995,"Runcorn","Dagenham and Redbridge","2-0",2,0,5,5,2,2,"H"
NA,1995,"Slough Town","Dagenham and Redbridge","5-0",5,0,5,5,5,5,"H"
NA,1995,"Southport","Dagenham and Redbridge","2-1",2,1,5,5,3,1,"H"
NA,1995,"Stalybridge Celtic","Dagenham and Redbridge","2-1",2,1,5,5,3,1,"H"
NA,1995,"Stevenage Borough","Dagenham and Redbridge","1-0",1,0,5,5,1,1,"H"
NA,1995,"Telford United","Dagenham and Redbridge","0-0",0,0,5,5,0,0,"D"
NA,1995,"Welling United","Dagenham and Redbridge","0-0",0,0,5,5,0,0,"D"
NA,1995,"Woking","Dagenham and Redbridge","2-2",2,2,5,5,4,0,"D"
NA,1995,"Altrincham","Dover Athletic","2-2",2,2,5,5,4,0,"D"
NA,1995,"Bath City","Dover Athletic","2-1",2,1,5,5,3,1,"H"
NA,1995,"Bromsgrove Rovers","Dover Athletic","3-0",3,0,5,5,3,3,"H"
NA,1995,"Dagenham and Redbridge","Dover Athletic","3-0",3,0,5,5,3,3,"H"
NA,1995,"Farnborough Town","Dover Athletic","3-2",3,2,5,5,5,1,"H"
NA,1995,"Gateshead","Dover Athletic","1-1",1,1,5,5,2,0,"D"
NA,1995,"Halifax Town","Dover Athletic","1-0",1,0,5,5,1,1,"H"
NA,1995,"Hednesford Town","Dover Athletic","2-2",2,2,5,5,4,0,"D"
NA,1995,"Kettering Town","Dover Athletic","2-2",2,2,5,5,4,0,"D"
NA,1995,"Kidderminster Harriers","Dover Athletic","1-1",1,1,5,5,2,0,"D"
NA,1995,"Macclesfield","Dover Athletic","0-1",0,1,5,5,1,-1,"A"
NA,1995,"Morecambe","Dover Athletic","3-1",3,1,5,5,4,2,"H"
NA,1995,"Northwich Victoria","Dover Athletic","1-2",1,2,5,5,3,-1,"A"
NA,1995,"Runcorn","Dover Athletic","1-3",1,3,5,5,4,-2,"A"
NA,1995,"Slough Town","Dover Athletic","3-2",3,2,5,5,5,1,"H"
NA,1995,"Southport","Dover Athletic","0-0",0,0,5,5,0,0,"D"
NA,1995,"Stalybridge Celtic","Dover Athletic","2-0",2,0,5,5,2,2,"H"
NA,1995,"Stevenage Borough","Dover Athletic","3-2",3,2,5,5,5,1,"H"
NA,1995,"Telford United","Dover Athletic","1-0",1,0,5,5,1,1,"H"
NA,1995,"Welling United","Dover Athletic","1-0",1,0,5,5,1,1,"H"
NA,1995,"Woking","Dover Athletic","1-0",1,0,5,5,1,1,"H"
NA,1995,"Altrincham","Farnborough Town","2-2",2,2,5,5,4,0,"D"
NA,1995,"Bath City","Farnborough Town","2-1",2,1,5,5,3,1,"H"
NA,1995,"Bromsgrove Rovers","Farnborough Town","1-2",1,2,5,5,3,-1,"A"
NA,1995,"Dagenham and Redbridge","Farnborough Town","2-2",2,2,5,5,4,0,"D"
NA,1995,"Dover Athletic","Farnborough Town","1-3",1,3,5,5,4,-2,"A"
NA,1995,"Gateshead","Farnborough Town","1-1",1,1,5,5,2,0,"D"
NA,1995,"Halifax Town","Farnborough Town","0-0",0,0,5,5,0,0,"D"
NA,1995,"Hednesford Town","Farnborough Town","4-1",4,1,5,5,5,3,"H"
NA,1995,"Kettering Town","Farnborough Town","0-2",0,2,5,5,2,-2,"A"
NA,1995,"Kidderminster Harriers","Farnborough Town","3-3",3,3,5,5,6,0,"D"
NA,1995,"Macclesfield","Farnborough Town","1-0",1,0,5,5,1,1,"H"
NA,1995,"Morecambe","Farnborough Town","2-3",2,3,5,5,5,-1,"A"
NA,1995,"Northwich Victoria","Farnborough Town","1-3",1,3,5,5,4,-2,"A"
NA,1995,"Runcorn","Farnborough Town","0-3",0,3,5,5,3,-3,"A"
NA,1995,"Slough Town","Farnborough Town","1-1",1,1,5,5,2,0,"D"
NA,1995,"Southport","Farnborough Town","7-1",7,1,5,5,8,6,"H"
NA,1995,"Stalybridge Celtic","Farnborough Town","2-2",2,2,5,5,4,0,"D"
NA,1995,"Stevenage Borough","Farnborough Town","0-0",0,0,5,5,0,0,"D"
NA,1995,"Telford United","Farnborough Town","3-2",3,2,5,5,5,1,"H"
NA,1995,"Welling United","Farnborough Town","0-1",0,1,5,5,1,-1,"A"
NA,1995,"Woking","Farnborough Town","2-1",2,1,5,5,3,1,"H"
NA,1995,"Altrincham","Gateshead","1-1",1,1,5,5,2,0,"D"
NA,1995,"Bath City","Gateshead","0-1",0,1,5,5,1,-1,"A"
NA,1995,"Bromsgrove Rovers","Gateshead","3-1",3,1,5,5,4,2,"H"
NA,1995,"Dagenham and Redbridge","Gateshead","0-4",0,4,5,5,4,-4,"A"
NA,1995,"Dover Athletic","Gateshead","1-1",1,1,5,5,2,0,"D"
NA,1995,"Farnborough Town","Gateshead","2-3",2,3,5,5,5,-1,"A"
NA,1995,"Halifax Town","Gateshead","2-0",2,0,5,5,2,2,"H"
NA,1995,"Hednesford Town","Gateshead","0-1",0,1,5,5,1,-1,"A"
NA,1995,"Kettering Town","Gateshead","1-0",1,0,5,5,1,1,"H"
NA,1995,"Kidderminster Harriers","Gateshead","1-1",1,1,5,5,2,0,"D"
NA,1995,"Macclesfield","Gateshead","1-0",1,0,5,5,1,1,"H"
NA,1995,"Morecambe","Gateshead","2-3",2,3,5,5,5,-1,"A"
NA,1995,"Northwich Victoria","Gateshead","1-2",1,2,5,5,3,-1,"A"
NA,1995,"Runcorn","Gateshead","1-1",1,1,5,5,2,0,"D"
NA,1995,"Slough Town","Gateshead","1-2",1,2,5,5,3,-1,"A"
NA,1995,"Southport","Gateshead","1-0",1,0,5,5,1,1,"H"
NA,1995,"Stalybridge Celtic","Gateshead","0-2",0,2,5,5,2,-2,"A"
NA,1995,"Stevenage Borough","Gateshead","1-1",1,1,5,5,2,0,"D"
NA,1995,"Telford United","Gateshead","0-0",0,0,5,5,0,0,"D"
NA,1995,"Welling United","Gateshead","1-2",1,2,5,5,3,-1,"A"
NA,1995,"Woking","Gateshead","2-0",2,0,5,5,2,2,"H"
NA,1995,"Altrincham","Halifax Town","3-2",3,2,5,5,5,1,"H"
NA,1995,"Bath City","Halifax Town","2-1",2,1,5,5,3,1,"H"
NA,1995,"Bromsgrove Rovers","Halifax Town","0-1",0,1,5,5,1,-1,"A"
NA,1995,"Dagenham and Redbridge","Halifax Town","1-1",1,1,5,5,2,0,"D"
NA,1995,"Dover Athletic","Halifax Town","3-2",3,2,5,5,5,1,"H"
NA,1995,"Farnborough Town","Halifax Town","0-0",0,0,5,5,0,0,"D"
NA,1995,"Gateshead","Halifax Town","3-2",3,2,5,5,5,1,"H"
NA,1995,"Hednesford Town","Halifax Town","3-0",3,0,5,5,3,3,"H"
NA,1995,"Kettering Town","Halifax Town","1-2",1,2,5,5,3,-1,"A"
NA,1995,"Kidderminster Harriers","Halifax Town","6-1",6,1,5,5,7,5,"H"
NA,1995,"Macclesfield","Halifax Town","7-0",7,0,5,5,7,7,"H"
NA,1995,"Morecambe","Halifax Town","0-1",0,1,5,5,1,-1,"A"
NA,1995,"Northwich Victoria","Halifax Town","1-1",1,1,5,5,2,0,"D"
NA,1995,"Runcorn","Halifax Town","0-1",0,1,5,5,1,-1,"A"
NA,1995,"Slough Town","Halifax Town","2-3",2,3,5,5,5,-1,"A"
NA,1995,"Southport","Halifax Town","0-0",0,0,5,5,0,0,"D"
NA,1995,"Stalybridge Celtic","Halifax Town","1-0",1,0,5,5,1,1,"H"
NA,1995,"Stevenage Borough","Halifax Town","2-0",2,0,5,5,2,2,"H"
NA,1995,"Telford United","Halifax Town","1-1",1,1,5,5,2,0,"D"
NA,1995,"Welling United","Halifax Town","0-0",0,0,5,5,0,0,"D"
NA,1995,"Woking","Halifax Town","2-0",2,0,5,5,2,2,"H"
NA,1995,"Altrincham","Hednesford Town","2-1",2,1,5,5,3,1,"H"
NA,1995,"Bath City","Hednesford Town","1-0",1,0,5,5,1,1,"H"
NA,1995,"Bromsgrove Rovers","Hednesford Town","1-4",1,4,5,5,5,-3,"A"
NA,1995,"Dagenham and Redbridge","Hednesford Town","1-2",1,2,5,5,3,-1,"A"
NA,1995,"Dover Athletic","Hednesford Town","1-3",1,3,5,5,4,-2,"A"
NA,1995,"Farnborough Town","Hednesford Town","1-3",1,3,5,5,4,-2,"A"
NA,1995,"Gateshead","Hednesford Town","0-3",0,3,5,5,3,-3,"A"
NA,1995,"Halifax Town","Hednesford Town","1-3",1,3,5,5,4,-2,"A"
NA,1995,"Kettering Town","Hednesford Town","2-0",2,0,5,5,2,2,"H"
NA,1995,"Kidderminster Harriers","Hednesford Town","3-1",3,1,5,5,4,2,"H"
NA,1995,"Macclesfield","Hednesford Town","1-1",1,1,5,5,2,0,"D"
NA,1995,"Morecambe","Hednesford Town","0-1",0,1,5,5,1,-1,"A"
NA,1995,"Northwich Victoria","Hednesford Town","0-2",0,2,5,5,2,-2,"A"
NA,1995,"Runcorn","Hednesford Town","2-2",2,2,5,5,4,0,"D"
NA,1995,"Slough Town","Hednesford Town","0-2",0,2,5,5,2,-2,"A"
NA,1995,"Southport","Hednesford Town","2-2",2,2,5,5,4,0,"D"
NA,1995,"Stalybridge Celtic","Hednesford Town","0-1",0,1,5,5,1,-1,"A"
NA,1995,"Stevenage Borough","Hednesford Town","1-0",1,0,5,5,1,1,"H"
NA,1995,"Telford United","Hednesford Town","2-1",2,1,5,5,3,1,"H"
NA,1995,"Welling United","Hednesford Town","1-1",1,1,5,5,2,0,"D"
NA,1995,"Woking","Hednesford Town","3-0",3,0,5,5,3,3,"H"
NA,1995,"Altrincham","Kettering Town","1-3",1,3,5,5,4,-2,"A"
NA,1995,"Bath City","Kettering Town","3-1",3,1,5,5,4,2,"H"
NA,1995,"Bromsgrove Rovers","Kettering Town","3-2",3,2,5,5,5,1,"H"
NA,1995,"Dagenham and Redbridge","Kettering Town","1-2",1,2,5,5,3,-1,"A"
NA,1995,"Dover Athletic","Kettering Town","2-1",2,1,5,5,3,1,"H"
NA,1995,"Farnborough Town","Kettering Town","1-1",1,1,5,5,2,0,"D"
NA,1995,"Gateshead","Kettering Town","1-1",1,1,5,5,2,0,"D"
NA,1995,"Halifax Town","Kettering Town","2-0",2,0,5,5,2,2,"H"
NA,1995,"Hednesford Town","Kettering Town","1-0",1,0,5,5,1,1,"H"
NA,1995,"Kidderminster Harriers","Kettering Town","1-0",1,0,5,5,1,1,"H"
NA,1995,"Macclesfield","Kettering Town","1-1",1,1,5,5,2,0,"D"
NA,1995,"Morecambe","Kettering Town","5-3",5,3,5,5,8,2,"H"
NA,1995,"Northwich Victoria","Kettering Town","6-2",6,2,5,5,8,4,"H"
NA,1995,"Runcorn","Kettering Town","4-2",4,2,5,5,6,2,"H"
NA,1995,"Slough Town","Kettering Town","1-2",1,2,5,5,3,-1,"A"
NA,1995,"Southport","Kettering Town","6-1",6,1,5,5,7,5,"H"
NA,1995,"Stalybridge Celtic","Kettering Town","3-2",3,2,5,5,5,1,"H"
NA,1995,"Stevenage Borough","Kettering Town","5-1",5,1,5,5,6,4,"H"
NA,1995,"Telford United","Kettering Town","3-4",3,4,5,5,7,-1,"A"
NA,1995,"Welling United","Kettering Town","1-0",1,0,5,5,1,1,"H"
NA,1995,"Woking","Kettering Town","1-1",1,1,5,5,2,0,"D"
NA,1995,"Altrincham","Kidderminster Harriers","1-1",1,1,5,5,2,0,"D"
NA,1995,"Bath City","Kidderminster Harriers","1-1",1,1,5,5,2,0,"D"
NA,1995,"Bromsgrove Rovers","Kidderminster Harriers","2-1",2,1,5,5,3,1,"H"
NA,1995,"Dagenham and Redbridge","Kidderminster Harriers","4-2",4,2,5,5,6,2,"H"
NA,1995,"Dover Athletic","Kidderminster Harriers","2-1",2,1,5,5,3,1,"H"
NA,1995,"Farnborough Town","Kidderminster Harriers","3-1",3,1,5,5,4,2,"H"
NA,1995,"Gateshead","Kidderminster Harriers","4-1",4,1,5,5,5,3,"H"
NA,1995,"Halifax Town","Kidderminster Harriers","0-2",0,2,5,5,2,-2,"A"
NA,1995,"Hednesford Town","Kidderminster Harriers","1-3",1,3,5,5,4,-2,"A"
NA,1995,"Kettering Town","Kidderminster Harriers","2-0",2,0,5,5,2,2,"H"
NA,1995,"Macclesfield","Kidderminster Harriers","0-2",0,2,5,5,2,-2,"A"
NA,1995,"Morecambe","Kidderminster Harriers","3-1",3,1,5,5,4,2,"H"
NA,1995,"Northwich Victoria","Kidderminster Harriers","5-2",5,2,5,5,7,3,"H"
NA,1995,"Runcorn","Kidderminster Harriers","0-1",0,1,5,5,1,-1,"A"
NA,1995,"Slough Town","Kidderminster Harriers","5-4",5,4,5,5,9,1,"H"
NA,1995,"Southport","Kidderminster Harriers","0-2",0,2,5,5,2,-2,"A"
NA,1995,"Stalybridge Celtic","Kidderminster Harriers","2-2",2,2,5,5,4,0,"D"
NA,1995,"Stevenage Borough","Kidderminster Harriers","4-1",4,1,5,5,5,3,"H"
NA,1995,"Telford United","Kidderminster Harriers","1-1",1,1,5,5,2,0,"D"
NA,1995,"Welling United","Kidderminster Harriers","0-0",0,0,5,5,0,0,"D"
NA,1995,"Woking","Kidderminster Harriers","0-0",0,0,5,5,0,0,"D"
NA,1995,"Altrincham","Macclesfield","0-4",0,4,5,5,4,-4,"A"
NA,1995,"Bath City","Macclesfield","1-1",1,1,5,5,2,0,"D"
NA,1995,"Bromsgrove Rovers","Macclesfield","1-0",1,0,5,5,1,1,"H"
NA,1995,"Dagenham and Redbridge","Macclesfield","3-0",3,0,5,5,3,3,"H"
NA,1995,"Dover Athletic","Macclesfield","2-3",2,3,5,5,5,-1,"A"
NA,1995,"Farnborough Town","Macclesfield","6-1",6,1,5,5,7,5,"H"
NA,1995,"Gateshead","Macclesfield","0-1",0,1,5,5,1,-1,"A"
NA,1995,"Halifax Town","Macclesfield","1-0",1,0,5,5,1,1,"H"
NA,1995,"Hednesford Town","Macclesfield","0-1",0,1,5,5,1,-1,"A"
NA,1995,"Kettering Town","Macclesfield","2-2",2,2,5,5,4,0,"D"
NA,1995,"Kidderminster Harriers","Macclesfield","0-4",0,4,5,5,4,-4,"A"
NA,1995,"Morecambe","Macclesfield","2-4",2,4,5,5,6,-2,"A"
NA,1995,"Northwich Victoria","Macclesfield","1-2",1,2,5,5,3,-1,"A"
NA,1995,"Runcorn","Macclesfield","0-0",0,0,5,5,0,0,"D"
NA,1995,"Slough Town","Macclesfield","2-2",2,2,5,5,4,0,"D"
NA,1995,"Southport","Macclesfield","2-1",2,1,5,5,3,1,"H"
NA,1995,"Stalybridge Celtic","Macclesfield","1-2",1,2,5,5,3,-1,"A"
NA,1995,"Stevenage Borough","Macclesfield","4-0",4,0,5,5,4,4,"H"
NA,1995,"Telford United","Macclesfield","1-2",1,2,5,5,3,-1,"A"
NA,1995,"Welling United","Macclesfield","1-2",1,2,5,5,3,-1,"A"
NA,1995,"Woking","Macclesfield","3-2",3,2,5,5,5,1,"H"
NA,1995,"Altrincham","Morecambe","3-0",3,0,5,5,3,3,"H"
NA,1995,"Bath City","Morecambe","3-2",3,2,5,5,5,1,"H"
NA,1995,"Bromsgrove Rovers","Morecambe","1-0",1,0,5,5,1,1,"H"
NA,1995,"Dagenham and Redbridge","Morecambe","2-2",2,2,5,5,4,0,"D"
NA,1995,"Dover Athletic","Morecambe","2-3",2,3,5,5,5,-1,"A"
NA,1995,"Farnborough Town","Morecambe","3-1",3,1,5,5,4,2,"H"
NA,1995,"Gateshead","Morecambe","3-0",3,0,5,5,3,3,"H"
NA,1995,"Halifax Town","Morecambe","1-1",1,1,5,5,2,0,"D"
NA,1995,"Hednesford Town","Morecambe","1-2",1,2,5,5,3,-1,"A"
NA,1995,"Kettering Town","Morecambe","2-3",2,3,5,5,5,-1,"A"
NA,1995,"Kidderminster Harriers","Morecambe","4-2",4,2,5,5,6,2,"H"
NA,1995,"Macclesfield","Morecambe","2-0",2,0,5,5,2,2,"H"
NA,1995,"Northwich Victoria","Morecambe","2-1",2,1,5,5,3,1,"H"
NA,1995,"Runcorn","Morecambe","1-3",1,3,5,5,4,-2,"A"
NA,1995,"Slough Town","Morecambe","1-1",1,1,5,5,2,0,"D"
NA,1995,"Southport","Morecambe","1-1",1,1,5,5,2,0,"D"
NA,1995,"Stalybridge Celtic","Morecambe","0-2",0,2,5,5,2,-2,"A"
NA,1995,"Stevenage Borough","Morecambe","1-1",1,1,5,5,2,0,"D"
NA,1995,"Telford United","Morecambe","2-2",2,2,5,5,4,0,"D"
NA,1995,"Welling United","Morecambe","1-0",1,0,5,5,1,1,"H"
NA,1995,"Woking","Morecambe","3-0",3,0,5,5,3,3,"H"
NA,1995,"Altrincham","Northwich Victoria","3-4",3,4,5,5,7,-1,"A"
NA,1995,"Bath City","Northwich Victoria","0-3",0,3,5,5,3,-3,"A"
NA,1995,"Bromsgrove Rovers","Northwich Victoria","1-1",1,1,5,5,2,0,"D"
NA,1995,"Dagenham and Redbridge","Northwich Victoria","0-3",0,3,5,5,3,-3,"A"
NA,1995,"Dover Athletic","Northwich Victoria","0-1",0,1,5,5,1,-1,"A"
NA,1995,"Farnborough Town","Northwich Victoria","0-1",0,1,5,5,1,-1,"A"
NA,1995,"Gateshead","Northwich Victoria","1-1",1,1,5,5,2,0,"D"
NA,1995,"Halifax Town","Northwich Victoria","2-0",2,0,5,5,2,2,"H"
NA,1995,"Hednesford Town","Northwich Victoria","2-1",2,1,5,5,3,1,"H"
NA,1995,"Kettering Town","Northwich Victoria","2-2",2,2,5,5,4,0,"D"
NA,1995,"Kidderminster Harriers","Northwich Victoria","2-1",2,1,5,5,3,1,"H"
NA,1995,"Macclesfield","Northwich Victoria","0-0",0,0,5,5,0,0,"D"
NA,1995,"Morecambe","Northwich Victoria","2-2",2,2,5,5,4,0,"D"
NA,1995,"Runcorn","Northwich Victoria","3-4",3,4,5,5,7,-1,"A"
NA,1995,"Slough Town","Northwich Victoria","1-1",1,1,5,5,2,0,"D"
NA,1995,"Southport","Northwich Victoria","2-2",2,2,5,5,4,0,"D"
NA,1995,"Stalybridge Celtic","Northwich Victoria","1-5",1,5,5,5,6,-4,"A"
NA,1995,"Stevenage Borough","Northwich Victoria","5-1",5,1,5,5,6,4,"H"
NA,1995,"Telford United","Northwich Victoria","1-0",1,0,5,5,1,1,"H"
NA,1995,"Welling United","Northwich Victoria","1-1",1,1,5,5,2,0,"D"
NA,1995,"Woking","Northwich Victoria","0-0",0,0,5,5,0,0,"D"
NA,1995,"Altrincham","Runcorn","2-2",2,2,5,5,4,0,"D"
NA,1995,"Bath City","Runcorn","3-0",3,0,5,5,3,3,"H"
NA,1995,"Bromsgrove Rovers","Runcorn","2-0",2,0,5,5,2,2,"H"
NA,1995,"Dagenham and Redbridge","Runcorn","2-3",2,3,5,5,5,-1,"A"
NA,1995,"Dover Athletic","Runcorn","4-2",4,2,5,5,6,2,"H"
NA,1995,"Farnborough Town","Runcorn","0-1",0,1,5,5,1,-1,"A"
NA,1995,"Gateshead","Runcorn","1-0",1,0,5,5,1,1,"H"
NA,1995,"Halifax Town","Runcorn","1-3",1,3,5,5,4,-2,"A"
NA,1995,"Hednesford Town","Runcorn","2-0",2,0,5,5,2,2,"H"
NA,1995,"Kettering Town","Runcorn","4-0",4,0,5,5,4,4,"H"
NA,1995,"Kidderminster Harriers","Runcorn","4-1",4,1,5,5,5,3,"H"
NA,1995,"Macclesfield","Runcorn","1-0",1,0,5,5,1,1,"H"
NA,1995,"Morecambe","Runcorn","3-1",3,1,5,5,4,2,"H"
NA,1995,"Northwich Victoria","Runcorn","4-3",4,3,5,5,7,1,"H"
NA,1995,"Slough Town","Runcorn","0-1",0,1,5,5,1,-1,"A"
NA,1995,"Southport","Runcorn","1-1",1,1,5,5,2,0,"D"
NA,1995,"Stalybridge Celtic","Runcorn","2-0",2,0,5,5,2,2,"H"
NA,1995,"Stevenage Borough","Runcorn","4-1",4,1,5,5,5,3,"H"
NA,1995,"Telford United","Runcorn","1-2",1,2,5,5,3,-1,"A"
NA,1995,"Welling United","Runcorn","1-1",1,1,5,5,2,0,"D"
NA,1995,"Woking","Runcorn","2-1",2,1,5,5,3,1,"H"
NA,1995,"Altrincham","Slough Town","0-1",0,1,5,5,1,-1,"A"
NA,1995,"Bath City","Slough Town","3-1",3,1,5,5,4,2,"H"
NA,1995,"Bromsgrove Rovers","Slough Town","0-0",0,0,5,5,0,0,"D"
NA,1995,"Dagenham and Redbridge","Slough Town","1-3",1,3,5,5,4,-2,"A"
NA,1995,"Dover Athletic","Slough Town","0-1",0,1,5,5,1,-1,"A"
NA,1995,"Farnborough Town","Slough Town","0-1",0,1,5,5,1,-1,"A"
NA,1995,"Gateshead","Slough Town","2-1",2,1,5,5,3,1,"H"
NA,1995,"Halifax Town","Slough Town","1-2",1,2,5,5,3,-1,"A"
NA,1995,"Hednesford Town","Slough Town","3-1",3,1,5,5,4,2,"H"
NA,1995,"Kettering Town","Slough Town","2-0",2,0,5,5,2,2,"H"
NA,1995,"Kidderminster Harriers","Slough Town","4-3",4,3,5,5,7,1,"H"
NA,1995,"Macclesfield","Slough Town","1-1",1,1,5,5,2,0,"D"
NA,1995,"Morecambe","Slough Town","1-2",1,2,5,5,3,-1,"A"
NA,1995,"Northwich Victoria","Slough Town","0-3",0,3,5,5,3,-3,"A"
NA,1995,"Runcorn","Slough Town","4-3",4,3,5,5,7,1,"H"
NA,1995,"Southport","Slough Town","2-0",2,0,5,5,2,2,"H"
NA,1995,"Stalybridge Celtic","Slough Town","0-1",0,1,5,5,1,-1,"A"
NA,1995,"Stevenage Borough","Slough Town","3-1",3,1,5,5,4,2,"H"
NA,1995,"Telford United","Slough Town","2-0",2,0,5,5,2,2,"H"
NA,1995,"Welling United","Slough Town","0-3",0,3,5,5,3,-3,"A"
NA,1995,"Woking","Slough Town","3-0",3,0,5,5,3,3,"H"
NA,1995,"Altrincham","Southport","1-0",1,0,5,5,1,1,"H"
NA,1995,"Bath City","Southport","4-0",4,0,5,5,4,4,"H"
NA,1995,"Bromsgrove Rovers","Southport","4-1",4,1,5,5,5,3,"H"
NA,1995,"Dagenham and Redbridge","Southport","1-2",1,2,5,5,3,-1,"A"
NA,1995,"Dover Athletic","Southport","0-1",0,1,5,5,1,-1,"A"
NA,1995,"Farnborough Town","Southport","1-0",1,0,5,5,1,1,"H"
NA,1995,"Gateshead","Southport","2-2",2,2,5,5,4,0,"D"
NA,1995,"Halifax Town","Southport","2-2",2,2,5,5,4,0,"D"
NA,1995,"Hednesford Town","Southport","2-1",2,1,5,5,3,1,"H"
NA,1995,"Kettering Town","Southport","1-1",1,1,5,5,2,0,"D"
NA,1995,"Kidderminster Harriers","Southport","2-3",2,3,5,5,5,-1,"A"
NA,1995,"Macclesfield","Southport","3-1",3,1,5,5,4,2,"H"
NA,1995,"Morecambe","Southport","4-3",4,3,5,5,7,1,"H"
NA,1995,"Northwich Victoria","Southport","1-2",1,2,5,5,3,-1,"A"
NA,1995,"Runcorn","Southport","1-1",1,1,5,5,2,0,"D"
NA,1995,"Slough Town","Southport","2-5",2,5,5,5,7,-3,"A"
NA,1995,"Stalybridge Celtic","Southport","1-4",1,4,5,5,5,-3,"A"
NA,1995,"Stevenage Borough","Southport","1-3",1,3,5,5,4,-2,"A"
NA,1995,"Telford United","Southport","2-1",2,1,5,5,3,1,"H"
NA,1995,"Welling United","Southport","0-1",0,1,5,5,1,-1,"A"
NA,1995,"Woking","Southport","4-0",4,0,5,5,4,4,"H"
NA,1995,"Altrincham","Stalybridge Celtic","1-0",1,0,5,5,1,1,"H"
NA,1995,"Bath City","Stalybridge Celtic","0-4",0,4,5,5,4,-4,"A"
NA,1995,"Bromsgrove Rovers","Stalybridge Celtic","1-1",1,1,5,5,2,0,"D"
NA,1995,"Dagenham and Redbridge","Stalybridge Celtic","4-1",4,1,5,5,5,3,"H"
NA,1995,"Dover Athletic","Stalybridge Celtic","1-3",1,3,5,5,4,-2,"A"
NA,1995,"Farnborough Town","Stalybridge Celtic","1-1",1,1,5,5,2,0,"D"
NA,1995,"Gateshead","Stalybridge Celtic","1-0",1,0,5,5,1,1,"H"
NA,1995,"Halifax Town","Stalybridge Celtic","2-3",2,3,5,5,5,-1,"A"
NA,1995,"Hednesford Town","Stalybridge Celtic","0-1",0,1,5,5,1,-1,"A"
NA,1995,"Kettering Town","Stalybridge Celtic","1-6",1,6,5,5,7,-5,"A"
NA,1995,"Kidderminster Harriers","Stalybridge Celtic","3-0",3,0,5,5,3,3,"H"
NA,1995,"Macclesfield","Stalybridge Celtic","1-0",1,0,5,5,1,1,"H"
NA,1995,"Morecambe","Stalybridge Celtic","2-0",2,0,5,5,2,2,"H"
NA,1995,"Northwich Victoria","Stalybridge Celtic","1-0",1,0,5,5,1,1,"H"
NA,1995,"Runcorn","Stalybridge Celtic","0-1",0,1,5,5,1,-1,"A"
NA,1995,"Slough Town","Stalybridge Celtic","2-1",2,1,5,5,3,1,"H"
NA,1995,"Southport","Stalybridge Celtic","5-3",5,3,5,5,8,2,"H"
NA,1995,"Stevenage Borough","Stalybridge Celtic","2-2",2,2,5,5,4,0,"D"
NA,1995,"Telford United","Stalybridge Celtic","0-1",0,1,5,5,1,-1,"A"
NA,1995,"Welling United","Stalybridge Celtic","1-1",1,1,5,5,2,0,"D"
NA,1995,"Woking","Stalybridge Celtic","2-1",2,1,5,5,3,1,"H"
NA,1995,"Altrincham","Stevenage Borough","0-2",0,2,5,5,2,-2,"A"
NA,1995,"Bath City","Stevenage Borough","1-2",1,2,5,5,3,-1,"A"
NA,1995,"Bromsgrove Rovers","Stevenage Borough","1-1",1,1,5,5,2,0,"D"
NA,1995,"Dagenham and Redbridge","Stevenage Borough","1-2",1,2,5,5,3,-1,"A"
NA,1995,"Dover Athletic","Stevenage Borough","1-2",1,2,5,5,3,-1,"A"
NA,1995,"Farnborough Town","Stevenage Borough","2-2",2,2,5,5,4,0,"D"
NA,1995,"Gateshead","Stevenage Borough","2-2",2,2,5,5,4,0,"D"
NA,1995,"Halifax Town","Stevenage Borough","2-3",2,3,5,5,5,-1,"A"
NA,1995,"Hednesford Town","Stevenage Borough","2-1",2,1,5,5,3,1,"H"
NA,1995,"Kettering Town","Stevenage Borough","1-2",1,2,5,5,3,-1,"A"
NA,1995,"Kidderminster Harriers","Stevenage Borough","0-1",0,1,5,5,1,-1,"A"
NA,1995,"Macclesfield","Stevenage Borough","0-0",0,0,5,5,0,0,"D"
NA,1995,"Morecambe","Stevenage Borough","1-0",1,0,5,5,1,1,"H"
NA,1995,"Northwich Victoria","Stevenage Borough","1-3",1,3,5,5,4,-2,"A"
NA,1995,"Runcorn","Stevenage Borough","0-8",0,8,5,5,8,-8,"A"
NA,1995,"Slough Town","Stevenage Borough","2-6",2,6,5,5,8,-4,"A"
NA,1995,"Southport","Stevenage Borough","0-1",0,1,5,5,1,-1,"A"
NA,1995,"Stalybridge Celtic","Stevenage Borough","2-5",2,5,5,5,7,-3,"A"
NA,1995,"Telford United","Stevenage Borough","1-3",1,3,5,5,4,-2,"A"
NA,1995,"Welling United","Stevenage Borough","0-3",0,3,5,5,3,-3,"A"
NA,1995,"Woking","Stevenage Borough","4-1",4,1,5,5,5,3,"H"
NA,1995,"Altrincham","Telford United","1-0",1,0,5,5,1,1,"H"
NA,1995,"Bath City","Telford United","0-3",0,3,5,5,3,-3,"A"
NA,1995,"Bromsgrove Rovers","Telford United","0-2",0,2,5,5,2,-2,"A"
NA,1995,"Dagenham and Redbridge","Telford United","1-1",1,1,5,5,2,0,"D"
NA,1995,"Dover Athletic","Telford United","1-0",1,0,5,5,1,1,"H"
NA,1995,"Farnborough Town","Telford United","2-1",2,1,5,5,3,1,"H"
NA,1995,"Gateshead","Telford United","1-2",1,2,5,5,3,-1,"A"
NA,1995,"Halifax Town","Telford United","0-0",0,0,5,5,0,0,"D"
NA,1995,"Hednesford Town","Telford United","4-0",4,0,5,5,4,4,"H"
NA,1995,"Kettering Town","Telford United","0-3",0,3,5,5,3,-3,"A"
NA,1995,"Kidderminster Harriers","Telford United","2-0",2,0,5,5,2,2,"H"
NA,1995,"Macclesfield","Telford United","1-0",1,0,5,5,1,1,"H"
NA,1995,"Morecambe","Telford United","2-0",2,0,5,5,2,2,"H"
NA,1995,"Northwich Victoria","Telford United","2-0",2,0,5,5,2,2,"H"
NA,1995,"Runcorn","Telford United","2-3",2,3,5,5,5,-1,"A"
NA,1995,"Slough Town","Telford United","1-2",1,2,5,5,3,-1,"A"
NA,1995,"Southport","Telford United","3-2",3,2,5,5,5,1,"H"
NA,1995,"Stalybridge Celtic","Telford United","2-2",2,2,5,5,4,0,"D"
NA,1995,"Stevenage Borough","Telford United","0-1",0,1,5,5,1,-1,"A"
NA,1995,"Welling United","Telford United","3-1",3,1,5,5,4,2,"H"
NA,1995,"Woking","Telford United","5-1",5,1,5,5,6,4,"H"
NA,1995,"Altrincham","Welling United","1-0",1,0,5,5,1,1,"H"
NA,1995,"Bath City","Welling United","1-1",1,1,5,5,2,0,"D"
NA,1995,"Bromsgrove Rovers","Welling United","1-1",1,1,5,5,2,0,"D"
NA,1995,"Dagenham and Redbridge","Welling United","1-1",1,1,5,5,2,0,"D"
NA,1995,"Dover Athletic","Welling United","2-1",2,1,5,5,3,1,"H"
NA,1995,"Farnborough Town","Welling United","0-1",0,1,5,5,1,-1,"A"
NA,1995,"Gateshead","Welling United","1-1",1,1,5,5,2,0,"D"
NA,1995,"Halifax Town","Welling United","2-1",2,1,5,5,3,1,"H"
NA,1995,"Hednesford Town","Welling United","1-1",1,1,5,5,2,0,"D"
NA,1995,"Kettering Town","Welling United","1-3",1,3,5,5,4,-2,"A"
NA,1995,"Kidderminster Harriers","Welling United","3-0",3,0,5,5,3,3,"H"
NA,1995,"Macclesfield","Welling United","2-1",2,1,5,5,3,1,"H"
NA,1995,"Morecambe","Welling United","1-0",1,0,5,5,1,1,"H"
NA,1995,"Northwich Victoria","Welling United","1-2",1,2,5,5,3,-1,"A"
NA,1995,"Runcorn","Welling United","1-3",1,3,5,5,4,-2,"A"
NA,1995,"Slough Town","Welling United","0-0",0,0,5,5,0,0,"D"
NA,1995,"Southport","Welling United","2-0",2,0,5,5,2,2,"H"
NA,1995,"Stalybridge Celtic","Welling United","2-1",2,1,5,5,3,1,"H"
NA,1995,"Stevenage Borough","Welling United","4-1",4,1,5,5,5,3,"H"
NA,1995,"Telford United","Welling United","0-0",0,0,5,5,0,0,"D"
NA,1995,"Woking","Welling United","3-2",3,2,5,5,5,1,"H"
NA,1995,"Altrincham","Woking","2-0",2,0,5,5,2,2,"H"
NA,1995,"Bath City","Woking","0-3",0,3,5,5,3,-3,"A"
NA,1995,"Bromsgrove Rovers","Woking","2-1",2,1,5,5,3,1,"H"
NA,1995,"Dagenham and Redbridge","Woking","0-0",0,0,5,5,0,0,"D"
NA,1995,"Dover Athletic","Woking","4-3",4,3,5,5,7,1,"H"
NA,1995,"Farnborough Town","Woking","0-2",0,2,5,5,2,-2,"A"
NA,1995,"Gateshead","Woking","0-1",0,1,5,5,1,-1,"A"
NA,1995,"Halifax Town","Woking","2-2",2,2,5,5,4,0,"D"
NA,1995,"Hednesford Town","Woking","2-1",2,1,5,5,3,1,"H"
NA,1995,"Kettering Town","Woking","3-0",3,0,5,5,3,3,"H"
NA,1995,"Kidderminster Harriers","Woking","2-0",2,0,5,5,2,2,"H"
NA,1995,"Macclesfield","Woking","3-2",3,2,5,5,5,1,"H"
NA,1995,"Morecambe","Woking","4-5",4,5,5,5,9,-1,"A"
NA,1995,"Northwich Victoria","Woking","3-0",3,0,5,5,3,3,"H"
NA,1995,"Runcorn","Woking","2-3",2,3,5,5,5,-1,"A"
NA,1995,"Slough Town","Woking","2-3",2,3,5,5,5,-1,"A"
NA,1995,"Southport","Woking","2-2",2,2,5,5,4,0,"D"
NA,1995,"Stalybridge Celtic","Woking","2-4",2,4,5,5,6,-2,"A"
NA,1995,"Stevenage Borough","Woking","4-0",4,0,5,5,4,4,"H"
NA,1995,"Telford United","Woking","1-2",1,2,5,5,3,-1,"A"
NA,1995,"Welling United","Woking","1-2",1,2,5,5,3,-1,"A"
NA,1996,"Bath City","Altrincham","1-2",1,2,5,5,3,-1,"A"
NA,1996,"Bromsgrove Rovers","Altrincham","4-0",4,0,5,5,4,4,"H"
NA,1996,"Dover Athletic","Altrincham","2-2",2,2,5,5,4,0,"D"
NA,1996,"Farnborough Town","Altrincham","1-1",1,1,5,5,2,0,"D"
NA,1996,"Gateshead","Altrincham","1-1",1,1,5,5,2,0,"D"
NA,1996,"Halifax Town","Altrincham","1-1",1,1,5,5,2,0,"D"
NA,1996,"Hayes & Yeading","Altrincham","3-1",3,1,5,5,4,2,"H"
NA,1996,"Hednesford Town","Altrincham","2-2",2,2,5,5,4,0,"D"
NA,1996,"Kettering Town","Altrincham","3-1",3,1,5,5,4,2,"H"
NA,1996,"Kidderminster Harriers","Altrincham","1-1",1,1,5,5,2,0,"D"
NA,1996,"Macclesfield","Altrincham","1-1",1,1,5,5,2,0,"D"
NA,1996,"Morecambe","Altrincham","2-1",2,1,5,5,3,1,"H"
NA,1996,"Northwich Victoria","Altrincham","2-2",2,2,5,5,4,0,"D"
NA,1996,"Rushden & Diamonds","Altrincham","3-2",3,2,5,5,5,1,"H"
NA,1996,"Slough Town","Altrincham","0-1",0,1,5,5,1,-1,"A"
NA,1996,"Southport","Altrincham","1-3",1,3,5,5,4,-2,"A"
NA,1996,"Stalybridge Celtic","Altrincham","1-0",1,0,5,5,1,1,"H"
NA,1996,"Stevenage Borough","Altrincham","2-1",2,1,5,5,3,1,"H"
NA,1996,"Telford United","Altrincham","0-0",0,0,5,5,0,0,"D"
NA,1996,"Welling United","Altrincham","1-0",1,0,5,5,1,1,"H"
NA,1996,"Woking","Altrincham","7-1",7,1,5,5,8,6,"H"
NA,1996,"Altrincham","Bath City","1-3",1,3,5,5,4,-2,"A"
NA,1996,"Bromsgrove Rovers","Bath City","2-1",2,1,5,5,3,1,"H"
NA,1996,"Dover Athletic","Bath City","2-2",2,2,5,5,4,0,"D"
NA,1996,"Farnborough Town","Bath City","4-1",4,1,5,5,5,3,"H"
NA,1996,"Gateshead","Bath City","5-0",5,0,5,5,5,5,"H"
NA,1996,"Halifax Town","Bath City","4-5",4,5,5,5,9,-1,"A"
NA,1996,"Hayes & Yeading","Bath City","0-1",0,1,5,5,1,-1,"A"
NA,1996,"Hednesford Town","Bath City","2-0",2,0,5,5,2,2,"H"
NA,1996,"Kettering Town","Bath City","1-0",1,0,5,5,1,1,"H"
NA,1996,"Kidderminster Harriers","Bath City","6-0",6,0,5,5,6,6,"H"
NA,1996,"Macclesfield","Bath City","2-2",2,2,5,5,4,0,"D"
NA,1996,"Morecambe","Bath City","1-1",1,1,5,5,2,0,"D"
NA,1996,"Northwich Victoria","Bath City","1-0",1,0,5,5,1,1,"H"
NA,1996,"Rushden & Diamonds","Bath City","4-1",4,1,5,5,5,3,"H"
NA,1996,"Slough Town","Bath City","5-2",5,2,5,5,7,3,"H"
NA,1996,"Southport","Bath City","3-1",3,1,5,5,4,2,"H"
NA,1996,"Stalybridge Celtic","Bath City","2-2",2,2,5,5,4,0,"D"
NA,1996,"Stevenage Borough","Bath City","2-1",2,1,5,5,3,1,"H"
NA,1996,"Telford United","Bath City","1-1",1,1,5,5,2,0,"D"
NA,1996,"Welling United","Bath City","2-0",2,0,5,5,2,2,"H"
NA,1996,"Woking","Bath City","2-2",2,2,5,5,4,0,"D"
NA,1996,"Altrincham","Bromsgrove Rovers","3-1",3,1,5,5,4,2,"H"
NA,1996,"Bath City","Bromsgrove Rovers","1-0",1,0,5,5,1,1,"H"
NA,1996,"Dover Athletic","Bromsgrove Rovers","2-0",2,0,5,5,2,2,"H"
NA,1996,"Farnborough Town","Bromsgrove Rovers","2-1",2,1,5,5,3,1,"H"
NA,1996,"Gateshead","Bromsgrove Rovers","1-0",1,0,5,5,1,1,"H"
NA,1996,"Halifax Town","Bromsgrove Rovers","1-0",1,0,5,5,1,1,"H"
NA,1996,"Hayes & Yeading","Bromsgrove Rovers","1-0",1,0,5,5,1,1,"H"
NA,1996,"Hednesford Town","Bromsgrove Rovers","3-0",3,0,5,5,3,3,"H"
NA,1996,"Kettering Town","Bromsgrove Rovers","2-0",2,0,5,5,2,2,"H"
NA,1996,"Kidderminster Harriers","Bromsgrove Rovers","1-2",1,2,5,5,3,-1,"A"
NA,1996,"Macclesfield","Bromsgrove Rovers","4-0",4,0,5,5,4,4,"H"
NA,1996,"Morecambe","Bromsgrove Rovers","1-0",1,0,5,5,1,1,"H"
NA,1996,"Northwich Victoria","Bromsgrove Rovers","1-0",1,0,5,5,1,1,"H"
NA,1996,"Rushden & Diamonds","Bromsgrove Rovers","1-2",1,2,5,5,3,-1,"A"
NA,1996,"Slough Town","Bromsgrove Rovers","2-0",2,0,5,5,2,2,"H"
NA,1996,"Southport","Bromsgrove Rovers","0-0",0,0,5,5,0,0,"D"
NA,1996,"Stalybridge Celtic","Bromsgrove Rovers","3-0",3,0,5,5,3,3,"H"
NA,1996,"Stevenage Borough","Bromsgrove Rovers","3-0",3,0,5,5,3,3,"H"
NA,1996,"Telford United","Bromsgrove Rovers","3-1",3,1,5,5,4,2,"H"
NA,1996,"Welling United","Bromsgrove Rovers","1-2",1,2,5,5,3,-1,"A"
NA,1996,"Woking","Bromsgrove Rovers","1-3",1,3,5,5,4,-2,"A"
NA,1996,"Altrincham","Dover Athletic","1-2",1,2,5,5,3,-1,"A"
NA,1996,"Bath City","Dover Athletic","2-1",2,1,5,5,3,1,"H"
NA,1996,"Bromsgrove Rovers","Dover Athletic","3-1",3,1,5,5,4,2,"H"
NA,1996,"Farnborough Town","Dover Athletic","2-3",2,3,5,5,5,-1,"A"
NA,1996,"Gateshead","Dover Athletic","1-3",1,3,5,5,4,-2,"A"
NA,1996,"Halifax Town","Dover Athletic","1-3",1,3,5,5,4,-2,"A"
NA,1996,"Hayes & Yeading","Dover Athletic","2-0",2,0,5,5,2,2,"H"
NA,1996,"Hednesford Town","Dover Athletic","1-1",1,1,5,5,2,0,"D"
NA,1996,"Kettering Town","Dover Athletic","1-1",1,1,5,5,2,0,"D"
NA,1996,"Kidderminster Harriers","Dover Athletic","4-1",4,1,5,5,5,3,"H"
NA,1996,"Macclesfield","Dover Athletic","1-0",1,0,5,5,1,1,"H"
NA,1996,"Morecambe","Dover Athletic","3-1",3,1,5,5,4,2,"H"
NA,1996,"Northwich Victoria","Dover Athletic","2-0",2,0,5,5,2,2,"H"
NA,1996,"Rushden & Diamonds","Dover Athletic","1-1",1,1,5,5,2,0,"D"
NA,1996,"Slough Town","Dover Athletic","2-2",2,2,5,5,4,0,"D"
NA,1996,"Southport","Dover Athletic","0-1",0,1,5,5,1,-1,"A"
NA,1996,"Stalybridge Celtic","Dover Athletic","4-2",4,2,5,5,6,2,"H"
NA,1996,"Stevenage Borough","Dover Athletic","4-1",4,1,5,5,5,3,"H"
NA,1996,"Telford United","Dover Athletic","1-0",1,0,5,5,1,1,"H"
NA,1996,"Welling United","Dover Athletic","1-0",1,0,5,5,1,1,"H"
NA,1996,"Woking","Dover Athletic","1-1",1,1,5,5,2,0,"D"
NA,1996,"Altrincham","Farnborough Town","0-3",0,3,5,5,3,-3,"A"
NA,1996,"Bath City","Farnborough Town","1-1",1,1,5,5,2,0,"D"
NA,1996,"Bromsgrove Rovers","Farnborough Town","1-1",1,1,5,5,2,0,"D"
NA,1996,"Dover Athletic","Farnborough Town","0-0",0,0,5,5,0,0,"D"
NA,1996,"Gateshead","Farnborough Town","1-0",1,0,5,5,1,1,"H"
NA,1996,"Halifax Town","Farnborough Town","3-0",3,0,5,5,3,3,"H"
NA,1996,"Hayes & Yeading","Farnborough Town","0-0",0,0,5,5,0,0,"D"
NA,1996,"Hednesford Town","Farnborough Town","0-1",0,1,5,5,1,-1,"A"
NA,1996,"Kettering Town","Farnborough Town","3-1",3,1,5,5,4,2,"H"
NA,1996,"Kidderminster Harriers","Farnborough Town","2-3",2,3,5,5,5,-1,"A"
NA,1996,"Macclesfield","Farnborough Town","3-0",3,0,5,5,3,3,"H"
NA,1996,"Morecambe","Farnborough Town","1-1",1,1,5,5,2,0,"D"
NA,1996,"Northwich Victoria","Farnborough Town","1-1",1,1,5,5,2,0,"D"
NA,1996,"Rushden & Diamonds","Farnborough Town","0-2",0,2,5,5,2,-2,"A"
NA,1996,"Slough Town","Farnborough Town","1-1",1,1,5,5,2,0,"D"
NA,1996,"Southport","Farnborough Town","0-3",0,3,5,5,3,-3,"A"
NA,1996,"Stalybridge Celtic","Farnborough Town","2-0",2,0,5,5,2,2,"H"
NA,1996,"Stevenage Borough","Farnborough Town","3-1",3,1,5,5,4,2,"H"
NA,1996,"Telford United","Farnborough Town","2-0",2,0,5,5,2,2,"H"
NA,1996,"Welling United","Farnborough Town","0-2",0,2,5,5,2,-2,"A"
NA,1996,"Woking","Farnborough Town","0-2",0,2,5,5,2,-2,"A"
NA,1996,"Altrincham","Gateshead","0-1",0,1,5,5,1,-1,"A"
NA,1996,"Bath City","Gateshead","3-0",3,0,5,5,3,3,"H"
NA,1996,"Bromsgrove Rovers","Gateshead","2-2",2,2,5,5,4,0,"D"
NA,1996,"Dover Athletic","Gateshead","0-1",0,1,5,5,1,-1,"A"
NA,1996,"Farnborough Town","Gateshead","1-2",1,2,5,5,3,-1,"A"
NA,1996,"Halifax Town","Gateshead","2-0",2,0,5,5,2,2,"H"
NA,1996,"Hayes & Yeading","Gateshead","0-0",0,0,5,5,0,0,"D"
NA,1996,"Hednesford Town","Gateshead","0-0",0,0,5,5,0,0,"D"
NA,1996,"Kettering Town","Gateshead","4-1",4,1,5,5,5,3,"H"
NA,1996,"Kidderminster Harriers","Gateshead","3-2",3,2,5,5,5,1,"H"
NA,1996,"Macclesfield","Gateshead","3-0",3,0,5,5,3,3,"H"
NA,1996,"Morecambe","Gateshead","4-0",4,0,5,5,4,4,"H"
NA,1996,"Northwich Victoria","Gateshead","4-2",4,2,5,5,6,2,"H"
NA,1996,"Rushden & Diamonds","Gateshead","0-4",0,4,5,5,4,-4,"A"
NA,1996,"Slough Town","Gateshead","0-1",0,1,5,5,1,-1,"A"
NA,1996,"Southport","Gateshead","1-1",1,1,5,5,2,0,"D"
NA,1996,"Stalybridge Celtic","Gateshead","2-5",2,5,5,5,7,-3,"A"
NA,1996,"Stevenage Borough","Gateshead","4-1",4,1,5,5,5,3,"H"
NA,1996,"Telford United","Gateshead","0-3",0,3,5,5,3,-3,"A"
NA,1996,"Welling United","Gateshead","2-0",2,0,5,5,2,2,"H"
NA,1996,"Woking","Gateshead","1-1",1,1,5,5,2,0,"D"
NA,1996,"Altrincham","Halifax Town","2-1",2,1,5,5,3,1,"H"
NA,1996,"Bath City","Halifax Town","0-0",0,0,5,5,0,0,"D"
NA,1996,"Bromsgrove Rovers","Halifax Town","3-0",3,0,5,5,3,3,"H"
NA,1996,"Dover Athletic","Halifax Town","2-2",2,2,5,5,4,0,"D"
NA,1996,"Farnborough Town","Halifax Town","3-0",3,0,5,5,3,3,"H"
NA,1996,"Gateshead","Halifax Town","0-1",0,1,5,5,1,-1,"A"
NA,1996,"Hayes & Yeading","Halifax Town","0-0",0,0,5,5,0,0,"D"
NA,1996,"Hednesford Town","Halifax Town","1-1",1,1,5,5,2,0,"D"
NA,1996,"Kettering Town","Halifax Town","4-1",4,1,5,5,5,3,"H"
NA,1996,"Kidderminster Harriers","Halifax Town","3-0",3,0,5,5,3,3,"H"
NA,1996,"Macclesfield","Halifax Town","1-0",1,0,5,5,1,1,"H"
NA,1996,"Morecambe","Halifax Town","1-0",1,0,5,5,1,1,"H"
NA,1996,"Northwich Victoria","Halifax Town","2-2",2,2,5,5,4,0,"D"
NA,1996,"Rushden & Diamonds","Halifax Town","1-0",1,0,5,5,1,1,"H"
NA,1996,"Slough Town","Halifax Town","1-0",1,0,5,5,1,1,"H"
NA,1996,"Southport","Halifax Town","2-1",2,1,5,5,3,1,"H"
NA,1996,"Stalybridge Celtic","Halifax Town","2-3",2,3,5,5,5,-1,"A"
NA,1996,"Stevenage Borough","Halifax Town","6-0",6,0,5,5,6,6,"H"
NA,1996,"Telford United","Halifax Town","1-1",1,1,5,5,2,0,"D"
NA,1996,"Welling United","Halifax Town","0-1",0,1,5,5,1,-1,"A"
NA,1996,"Woking","Halifax Town","2-2",2,2,5,5,4,0,"D"
NA,1996,"Altrincham","Hayes & Yeading","0-2",0,2,5,5,2,-2,"A"
NA,1996,"Bath City","Hayes & Yeading","3-1",3,1,5,5,4,2,"H"
NA,1996,"Bromsgrove Rovers","Hayes & Yeading","2-2",2,2,5,5,4,0,"D"
NA,1996,"Dover Athletic","Hayes & Yeading","1-0",1,0,5,5,1,1,"H"
NA,1996,"Farnborough Town","Hayes & Yeading","1-1",1,1,5,5,2,0,"D"
NA,1996,"Gateshead","Hayes & Yeading","1-1",1,1,5,5,2,0,"D"
NA,1996,"Halifax Town","Hayes & Yeading","2-2",2,2,5,5,4,0,"D"
NA,1996,"Hednesford Town","Hayes & Yeading","2-0",2,0,5,5,2,2,"H"
NA,1996,"Kettering Town","Hayes & Yeading","2-2",2,2,5,5,4,0,"D"
NA,1996,"Kidderminster Harriers","Hayes & Yeading","5-1",5,1,5,5,6,4,"H"
NA,1996,"Macclesfield","Hayes & Yeading","1-0",1,0,5,5,1,1,"H"
NA,1996,"Morecambe","Hayes & Yeading","2-4",2,4,5,5,6,-2,"A"
NA,1996,"Northwich Victoria","Hayes & Yeading","2-1",2,1,5,5,3,1,"H"
NA,1996,"Rushden & Diamonds","Hayes & Yeading","2-2",2,2,5,5,4,0,"D"
NA,1996,"Slough Town","Hayes & Yeading","1-3",1,3,5,5,4,-2,"A"
NA,1996,"Southport","Hayes & Yeading","0-2",0,2,5,5,2,-2,"A"
NA,1996,"Stalybridge Celtic","Hayes & Yeading","3-1",3,1,5,5,4,2,"H"
NA,1996,"Stevenage Borough","Hayes & Yeading","2-0",2,0,5,5,2,2,"H"
NA,1996,"Telford United","Hayes & Yeading","0-0",0,0,5,5,0,0,"D"
NA,1996,"Welling United","Hayes & Yeading","1-0",1,0,5,5,1,1,"H"
NA,1996,"Woking","Hayes & Yeading","1-2",1,2,5,5,3,-1,"A"
NA,1996,"Altrincham","Hednesford Town","1-1",1,1,5,5,2,0,"D"
NA,1996,"Bath City","Hednesford Town","2-1",2,1,5,5,3,1,"H"
NA,1996,"Bromsgrove Rovers","Hednesford Town","1-0",1,0,5,5,1,1,"H"
NA,1996,"Dover Athletic","Hednesford Town","2-2",2,2,5,5,4,0,"D"
NA,1996,"Farnborough Town","Hednesford Town","1-0",1,0,5,5,1,1,"H"
NA,1996,"Gateshead","Hednesford Town","0-1",0,1,5,5,1,-1,"A"
NA,1996,"Halifax Town","Hednesford Town","1-0",1,0,5,5,1,1,"H"
NA,1996,"Hayes & Yeading","Hednesford Town","4-0",4,0,5,5,4,4,"H"
NA,1996,"Kettering Town","Hednesford Town","0-2",0,2,5,5,2,-2,"A"
NA,1996,"Kidderminster Harriers","Hednesford Town","2-1",2,1,5,5,3,1,"H"
NA,1996,"Macclesfield","Hednesford Town","4-0",4,0,5,5,4,4,"H"
NA,1996,"Morecambe","Hednesford Town","2-2",2,2,5,5,4,0,"D"
NA,1996,"Northwich Victoria","Hednesford Town","2-1",2,1,5,5,3,1,"H"
NA,1996,"Rushden & Diamonds","Hednesford Town","0-2",0,2,5,5,2,-2,"A"
NA,1996,"Slough Town","Hednesford Town","2-2",2,2,5,5,4,0,"D"
NA,1996,"Southport","Hednesford Town","1-2",1,2,5,5,3,-1,"A"
NA,1996,"Stalybridge Celtic","Hednesford Town","1-2",1,2,5,5,3,-1,"A"
NA,1996,"Stevenage Borough","Hednesford Town","3-2",3,2,5,5,5,1,"H"
NA,1996,"Telford United","Hednesford Town","1-1",1,1,5,5,2,0,"D"
NA,1996,"Welling United","Hednesford Town","1-2",1,2,5,5,3,-1,"A"
NA,1996,"Woking","Hednesford Town","2-0",2,0,5,5,2,2,"H"
NA,1996,"Altrincham","Kettering Town","4-3",4,3,5,5,7,1,"H"
NA,1996,"Bath City","Kettering Town","0-2",0,2,5,5,2,-2,"A"
NA,1996,"Bromsgrove Rovers","Kettering Town","1-2",1,2,5,5,3,-1,"A"
NA,1996,"Dover Athletic","Kettering Town","0-1",0,1,5,5,1,-1,"A"
NA,1996,"Farnborough Town","Kettering Town","0-2",0,2,5,5,2,-2,"A"
NA,1996,"Gateshead","Kettering Town","1-1",1,1,5,5,2,0,"D"
NA,1996,"Halifax Town","Kettering Town","2-1",2,1,5,5,3,1,"H"
NA,1996,"Hayes & Yeading","Kettering Town","2-1",2,1,5,5,3,1,"H"
NA,1996,"Hednesford Town","Kettering Town","0-0",0,0,5,5,0,0,"D"
NA,1996,"Kidderminster Harriers","Kettering Town","4-0",4,0,5,5,4,4,"H"
NA,1996,"Macclesfield","Kettering Town","2-0",2,0,5,5,2,2,"H"
NA,1996,"Morecambe","Kettering Town","5-2",5,2,5,5,7,3,"H"
NA,1996,"Northwich Victoria","Kettering Town","2-1",2,1,5,5,3,1,"H"
NA,1996,"Rushden & Diamonds","Kettering Town","1-0",1,0,5,5,1,1,"H"
NA,1996,"Slough Town","Kettering Town","1-1",1,1,5,5,2,0,"D"
NA,1996,"Southport","Kettering Town","2-2",2,2,5,5,4,0,"D"
NA,1996,"Stalybridge Celtic","Kettering Town","3-1",3,1,5,5,4,2,"H"
NA,1996,"Stevenage Borough","Kettering Town","0-0",0,0,5,5,0,0,"D"
NA,1996,"Telford United","Kettering Town","1-0",1,0,5,5,1,1,"H"
NA,1996,"Welling United","Kettering Town","1-2",1,2,5,5,3,-1,"A"
NA,1996,"Woking","Kettering Town","2-1",2,1,5,5,3,1,"H"
NA,1996,"Altrincham","Kidderminster Harriers","0-1",0,1,5,5,1,-1,"A"
NA,1996,"Bath City","Kidderminster Harriers","0-3",0,3,5,5,3,-3,"A"
NA,1996,"Bromsgrove Rovers","Kidderminster Harriers","0-1",0,1,5,5,1,-1,"A"
NA,1996,"Dover Athletic","Kidderminster Harriers","0-5",0,5,5,5,5,-5,"A"
NA,1996,"Farnborough Town","Kidderminster Harriers","2-1",2,1,5,5,3,1,"H"
NA,1996,"Gateshead","Kidderminster Harriers","3-1",3,1,5,5,4,2,"H"
NA,1996,"Halifax Town","Kidderminster Harriers","2-3",2,3,5,5,5,-1,"A"
NA,1996,"Hayes & Yeading","Kidderminster Harriers","0-1",0,1,5,5,1,-1,"A"
NA,1996,"Hednesford Town","Kidderminster Harriers","1-4",1,4,5,5,5,-3,"A"
NA,1996,"Kettering Town","Kidderminster Harriers","3-1",3,1,5,5,4,2,"H"
NA,1996,"Macclesfield","Kidderminster Harriers","0-1",0,1,5,5,1,-1,"A"
NA,1996,"Morecambe","Kidderminster Harriers","2-3",2,3,5,5,5,-1,"A"
NA,1996,"Northwich Victoria","Kidderminster Harriers","1-1",1,1,5,5,2,0,"D"
NA,1996,"Rushden & Diamonds","Kidderminster Harriers","1-1",1,1,5,5,2,0,"D"
NA,1996,"Slough Town","Kidderminster Harriers","0-2",0,2,5,5,2,-2,"A"
NA,1996,"Southport","Kidderminster Harriers","1-0",1,0,5,5,1,1,"H"
NA,1996,"Stalybridge Celtic","Kidderminster Harriers","4-1",4,1,5,5,5,3,"H"
NA,1996,"Stevenage Borough","Kidderminster Harriers","2-2",2,2,5,5,4,0,"D"
NA,1996,"Telford United","Kidderminster Harriers","0-2",0,2,5,5,2,-2,"A"
NA,1996,"Welling United","Kidderminster Harriers","0-1",0,1,5,5,1,-1,"A"
NA,1996,"Woking","Kidderminster Harriers","2-1",2,1,5,5,3,1,"H"
NA,1996,"Altrincham","Macclesfield","0-1",0,1,5,5,1,-1,"A"
NA,1996,"Bath City","Macclesfield","0-3",0,3,5,5,3,-3,"A"
NA,1996,"Bromsgrove Rovers","Macclesfield","0-3",0,3,5,5,3,-3,"A"
NA,1996,"Dover Athletic","Macclesfield","2-1",2,1,5,5,3,1,"H"
NA,1996,"Farnborough Town","Macclesfield","0-1",0,1,5,5,1,-1,"A"
NA,1996,"Gateshead","Macclesfield","0-0",0,0,5,5,0,0,"D"
NA,1996,"Halifax Town","Macclesfield","3-3",3,3,5,5,6,0,"D"
NA,1996,"Hayes & Yeading","Macclesfield","0-2",0,2,5,5,2,-2,"A"
NA,1996,"Hednesford Town","Macclesfield","4-1",4,1,5,5,5,3,"H"
NA,1996,"Kettering Town","Macclesfield","1-4",1,4,5,5,5,-3,"A"
NA,1996,"Kidderminster Harriers","Macclesfield","0-0",0,0,5,5,0,0,"D"
NA,1996,"Morecambe","Macclesfield","1-0",1,0,5,5,1,1,"H"
NA,1996,"Northwich Victoria","Macclesfield","2-1",2,1,5,5,3,1,"H"
NA,1996,"Rushden & Diamonds","Macclesfield","1-1",1,1,5,5,2,0,"D"
NA,1996,"Slough Town","Macclesfield","0-0",0,0,5,5,0,0,"D"
NA,1996,"Southport","Macclesfield","1-5",1,5,5,5,6,-4,"A"
NA,1996,"Stalybridge Celtic","Macclesfield","0-1",0,1,5,5,1,-1,"A"
NA,1996,"Stevenage Borough","Macclesfield","2-3",2,3,5,5,5,-1,"A"
NA,1996,"Telford United","Macclesfield","0-3",0,3,5,5,3,-3,"A"
NA,1996,"Welling United","Macclesfield","0-3",0,3,5,5,3,-3,"A"
NA,1996,"Woking","Macclesfield","2-3",2,3,5,5,5,-1,"A"
NA,1996,"Altrincham","Morecambe","0-1",0,1,5,5,1,-1,"A"
NA,1996,"Bath City","Morecambe","2-1",2,1,5,5,3,1,"H"
NA,1996,"Bromsgrove Rovers","Morecambe","2-3",2,3,5,5,5,-1,"A"
NA,1996,"Dover Athletic","Morecambe","3-0",3,0,5,5,3,3,"H"
NA,1996,"Farnborough Town","Morecambe","2-2",2,2,5,5,4,0,"D"
NA,1996,"Gateshead","Morecambe","0-3",0,3,5,5,3,-3,"A"
NA,1996,"Halifax Town","Morecambe","1-1",1,1,5,5,2,0,"D"
NA,1996,"Hayes & Yeading","Morecambe","2-3",2,3,5,5,5,-1,"A"
NA,1996,"Hednesford Town","Morecambe","2-1",2,1,5,5,3,1,"H"
NA,1996,"Kettering Town","Morecambe","0-2",0,2,5,5,2,-2,"A"
NA,1996,"Kidderminster Harriers","Morecambe","2-2",2,2,5,5,4,0,"D"
NA,1996,"Macclesfield","Morecambe","0-0",0,0,5,5,0,0,"D"
NA,1996,"Northwich Victoria","Morecambe","1-0",1,0,5,5,1,1,"H"
NA,1996,"Rushden & Diamonds","Morecambe","2-1",2,1,5,5,3,1,"H"
NA,1996,"Slough Town","Morecambe","1-2",1,2,5,5,3,-1,"A"
NA,1996,"Southport","Morecambe","3-1",3,1,5,5,4,2,"H"
NA,1996,"Stalybridge Celtic","Morecambe","2-1",2,1,5,5,3,1,"H"
NA,1996,"Stevenage Borough","Morecambe","4-2",4,2,5,5,6,2,"H"
NA,1996,"Telford United","Morecambe","2-3",2,3,5,5,5,-1,"A"
NA,1996,"Welling United","Morecambe","1-4",1,4,5,5,5,-3,"A"
NA,1996,"Woking","Morecambe","1-2",1,2,5,5,3,-1,"A"
NA,1996,"Altrincham","Northwich Victoria","2-3",2,3,5,5,5,-1,"A"
NA,1996,"Bath City","Northwich Victoria","3-2",3,2,5,5,5,1,"H"
NA,1996,"Bromsgrove Rovers","Northwich Victoria","0-5",0,5,5,5,5,-5,"A"
NA,1996,"Dover Athletic","Northwich Victoria","2-2",2,2,5,5,4,0,"D"
NA,1996,"Farnborough Town","Northwich Victoria","2-2",2,2,5,5,4,0,"D"
NA,1996,"Gateshead","Northwich Victoria","5-1",5,1,5,5,6,4,"H"
NA,1996,"Halifax Town","Northwich Victoria","0-3",0,3,5,5,3,-3,"A"
NA,1996,"Hayes & Yeading","Northwich Victoria","1-1",1,1,5,5,2,0,"D"
NA,1996,"Hednesford Town","Northwich Victoria","3-0",3,0,5,5,3,3,"H"
NA,1996,"Kettering Town","Northwich Victoria","1-0",1,0,5,5,1,1,"H"
NA,1996,"Kidderminster Harriers","Northwich Victoria","1-0",1,0,5,5,1,1,"H"
NA,1996,"Macclesfield","Northwich Victoria","0-1",0,1,5,5,1,-1,"A"
NA,1996,"Morecambe","Northwich Victoria","2-0",2,0,5,5,2,2,"H"
NA,1996,"Rushden & Diamonds","Northwich Victoria","1-1",1,1,5,5,2,0,"D"
NA,1996,"Slough Town","Northwich Victoria","3-4",3,4,5,5,7,-1,"A"
NA,1996,"Southport","Northwich Victoria","0-0",0,0,5,5,0,0,"D"
NA,1996,"Stalybridge Celtic","Northwich Victoria","0-1",0,1,5,5,1,-1,"A"
NA,1996,"Stevenage Borough","Northwich Victoria","2-0",2,0,5,5,2,2,"H"
NA,1996,"Telford United","Northwich Victoria","2-2",2,2,5,5,4,0,"D"
NA,1996,"Welling United","Northwich Victoria","1-1",1,1,5,5,2,0,"D"
NA,1996,"Woking","Northwich Victoria","3-1",3,1,5,5,4,2,"H"
NA,1996,"Altrincham","Rushden & Diamonds","4-3",4,3,5,5,7,1,"H"
NA,1996,"Bath City","Rushden & Diamonds","3-2",3,2,5,5,5,1,"H"
NA,1996,"Bromsgrove Rovers","Rushden & Diamonds","0-1",0,1,5,5,1,-1,"A"
NA,1996,"Dover Athletic","Rushden & Diamonds","1-1",1,1,5,5,2,0,"D"
NA,1996,"Farnborough Town","Rushden & Diamonds","2-2",2,2,5,5,4,0,"D"
NA,1996,"Gateshead","Rushden & Diamonds","1-0",1,0,5,5,1,1,"H"
NA,1996,"Halifax Town","Rushden & Diamonds","1-3",1,3,5,5,4,-2,"A"
NA,1996,"Hayes & Yeading","Rushden & Diamonds","1-1",1,1,5,5,2,0,"D"
NA,1996,"Hednesford Town","Rushden & Diamonds","1-0",1,0,5,5,1,1,"H"
NA,1996,"Kettering Town","Rushden & Diamonds","1-5",1,5,5,5,6,-4,"A"
NA,1996,"Kidderminster Harriers","Rushden & Diamonds","1-0",1,0,5,5,1,1,"H"
NA,1996,"Macclesfield","Rushden & Diamonds","2-1",2,1,5,5,3,1,"H"
NA,1996,"Morecambe","Rushden & Diamonds","2-0",2,0,5,5,2,2,"H"
NA,1996,"Northwich Victoria","Rushden & Diamonds","1-2",1,2,5,5,3,-1,"A"
NA,1996,"Slough Town","Rushden & Diamonds","5-0",5,0,5,5,5,5,"H"
NA,1996,"Southport","Rushden & Diamonds","2-1",2,1,5,5,3,1,"H"
NA,1996,"Stalybridge Celtic","Rushden & Diamonds","2-0",2,0,5,5,2,2,"H"
NA,1996,"Stevenage Borough","Rushden & Diamonds","4-1",4,1,5,5,5,3,"H"
NA,1996,"Telford United","Rushden & Diamonds","0-5",0,5,5,5,5,-5,"A"
NA,1996,"Welling United","Rushden & Diamonds","0-1",0,1,5,5,1,-1,"A"
NA,1996,"Woking","Rushden & Diamonds","4-2",4,2,5,5,6,2,"H"
NA,1996,"Altrincham","Slough Town","0-1",0,1,5,5,1,-1,"A"
NA,1996,"Bath City","Slough Town","0-0",0,0,5,5,0,0,"D"
NA,1996,"Bromsgrove Rovers","Slough Town","4-1",4,1,5,5,5,3,"H"
NA,1996,"Dover Athletic","Slough Town","0-0",0,0,5,5,0,0,"D"
NA,1996,"Farnborough Town","Slough Town","2-1",2,1,5,5,3,1,"H"
NA,1996,"Gateshead","Slough Town","2-1",2,1,5,5,3,1,"H"
NA,1996,"Halifax Town","Slough Town","4-1",4,1,5,5,5,3,"H"
NA,1996,"Hayes & Yeading","Slough Town","5-0",5,0,5,5,5,5,"H"
NA,1996,"Hednesford Town","Slough Town","2-1",2,1,5,5,3,1,"H"
NA,1996,"Kettering Town","Slough Town","0-0",0,0,5,5,0,0,"D"
NA,1996,"Kidderminster Harriers","Slough Town","1-2",1,2,5,5,3,-1,"A"
NA,1996,"Macclesfield","Slough Town","2-0",2,0,5,5,2,2,"H"
NA,1996,"Morecambe","Slough Town","0-0",0,0,5,5,0,0,"D"
NA,1996,"Northwich Victoria","Slough Town","0-1",0,1,5,5,1,-1,"A"
NA,1996,"Rushden & Diamonds","Slough Town","2-2",2,2,5,5,4,0,"D"
NA,1996,"Southport","Slough Town","0-1",0,1,5,5,1,-1,"A"
NA,1996,"Stalybridge Celtic","Slough Town","2-2",2,2,5,5,4,0,"D"
NA,1996,"Stevenage Borough","Slough Town","2-2",2,2,5,5,4,0,"D"
NA,1996,"Telford United","Slough Town","0-2",0,2,5,5,2,-2,"A"
NA,1996,"Welling United","Slough Town","3-2",3,2,5,5,5,1,"H"
NA,1996,"Woking","Slough Town","2-0",2,0,5,5,2,2,"H"
NA,1996,"Altrincham","Southport","1-0",1,0,5,5,1,1,"H"
NA,1996,"Bath City","Southport","0-2",0,2,5,5,2,-2,"A"
NA,1996,"Bromsgrove Rovers","Southport","0-1",0,1,5,5,1,-1,"A"
NA,1996,"Dover Athletic","Southport","0-1",0,1,5,5,1,-1,"A"
NA,1996,"Farnborough Town","Southport","3-3",3,3,5,5,6,0,"D"
NA,1996,"Gateshead","Southport","2-2",2,2,5,5,4,0,"D"
NA,1996,"Halifax Town","Southport","2-0",2,0,5,5,2,2,"H"
NA,1996,"Hayes & Yeading","Southport","1-1",1,1,5,5,2,0,"D"
NA,1996,"Hednesford Town","Southport","0-1",0,1,5,5,1,-1,"A"
NA,1996,"Kettering Town","Southport","0-1",0,1,5,5,1,-1,"A"
NA,1996,"Kidderminster Harriers","Southport","3-0",3,0,5,5,3,3,"H"
NA,1996,"Macclesfield","Southport","3-2",3,2,5,5,5,1,"H"
NA,1996,"Morecambe","Southport","2-1",2,1,5,5,3,1,"H"
NA,1996,"Northwich Victoria","Southport","5-1",5,1,5,5,6,4,"H"
NA,1996,"Rushden & Diamonds","Southport","3-0",3,0,5,5,3,3,"H"
NA,1996,"Slough Town","Southport","1-1",1,1,5,5,2,0,"D"
NA,1996,"Stalybridge Celtic","Southport","2-2",2,2,5,5,4,0,"D"
NA,1996,"Stevenage Borough","Southport","2-1",2,1,5,5,3,1,"H"
NA,1996,"Telford United","Southport","1-0",1,0,5,5,1,1,"H"
NA,1996,"Welling United","Southport","2-3",2,3,5,5,5,-1,"A"
NA,1996,"Woking","Southport","0-1",0,1,5,5,1,-1,"A"
NA,1996,"Altrincham","Stalybridge Celtic","1-0",1,0,5,5,1,1,"H"
NA,1996,"Bath City","Stalybridge Celtic","0-2",0,2,5,5,2,-2,"A"
NA,1996,"Bromsgrove Rovers","Stalybridge Celtic","0-1",0,1,5,5,1,-1,"A"
NA,1996,"Dover Athletic","Stalybridge Celtic","2-1",2,1,5,5,3,1,"H"
NA,1996,"Farnborough Town","Stalybridge Celtic","1-0",1,0,5,5,1,1,"H"
NA,1996,"Gateshead","Stalybridge Celtic","0-2",0,2,5,5,2,-2,"A"
NA,1996,"Halifax Town","Stalybridge Celtic","4-1",4,1,5,5,5,3,"H"
NA,1996,"Hayes & Yeading","Stalybridge Celtic","0-2",0,2,5,5,2,-2,"A"
NA,1996,"Hednesford Town","Stalybridge Celtic","2-1",2,1,5,5,3,1,"H"
NA,1996,"Kettering Town","Stalybridge Celtic","1-0",1,0,5,5,1,1,"H"
NA,1996,"Kidderminster Harriers","Stalybridge Celtic","1-1",1,1,5,5,2,0,"D"
NA,1996,"Macclesfield","Stalybridge Celtic","2-0",2,0,5,5,2,2,"H"
NA,1996,"Morecambe","Stalybridge Celtic","0-0",0,0,5,5,0,0,"D"
NA,1996,"Northwich Victoria","Stalybridge Celtic","0-1",0,1,5,5,1,-1,"A"
NA,1996,"Rushden & Diamonds","Stalybridge Celtic","1-1",1,1,5,5,2,0,"D"
NA,1996,"Slough Town","Stalybridge Celtic","4-1",4,1,5,5,5,3,"H"
NA,1996,"Southport","Stalybridge Celtic","3-0",3,0,5,5,3,3,"H"
NA,1996,"Stevenage Borough","Stalybridge Celtic","1-1",1,1,5,5,2,0,"D"
NA,1996,"Telford United","Stalybridge Celtic","1-1",1,1,5,5,2,0,"D"
NA,1996,"Welling United","Stalybridge Celtic","2-0",2,0,5,5,2,2,"H"
NA,1996,"Woking","Stalybridge Celtic","3-2",3,2,5,5,5,1,"H"
NA,1996,"Altrincham","Stevenage Borough","1-2",1,2,5,5,3,-1,"A"
NA,1996,"Bath City","Stevenage Borough","0-0",0,0,5,5,0,0,"D"
NA,1996,"Bromsgrove Rovers","Stevenage Borough","1-1",1,1,5,5,2,0,"D"
NA,1996,"Dover Athletic","Stevenage Borough","3-3",3,3,5,5,6,0,"D"
NA,1996,"Farnborough Town","Stevenage Borough","3-1",3,1,5,5,4,2,"H"
NA,1996,"Gateshead","Stevenage Borough","2-2",2,2,5,5,4,0,"D"
NA,1996,"Halifax Town","Stevenage Borough","4-2",4,2,5,5,6,2,"H"
NA,1996,"Hayes & Yeading","Stevenage Borough","1-3",1,3,5,5,4,-2,"A"
NA,1996,"Hednesford Town","Stevenage Borough","0-0",0,0,5,5,0,0,"D"
NA,1996,"Kettering Town","Stevenage Borough","1-2",1,2,5,5,3,-1,"A"
NA,1996,"Kidderminster Harriers","Stevenage Borough","3-0",3,0,5,5,3,3,"H"
NA,1996,"Macclesfield","Stevenage Borough","2-1",2,1,5,5,3,1,"H"
NA,1996,"Morecambe","Stevenage Borough","1-2",1,2,5,5,3,-1,"A"
NA,1996,"Northwich Victoria","Stevenage Borough","0-1",0,1,5,5,1,-1,"A"
NA,1996,"Rushden & Diamonds","Stevenage Borough","0-1",0,1,5,5,1,-1,"A"
NA,1996,"Slough Town","Stevenage Borough","1-6",1,6,5,5,7,-5,"A"
NA,1996,"Southport","Stevenage Borough","0-0",0,0,5,5,0,0,"D"
NA,1996,"Stalybridge Celtic","Stevenage Borough","0-3",0,3,5,5,3,-3,"A"
NA,1996,"Telford United","Stevenage Borough","2-3",2,3,5,5,5,-1,"A"
NA,1996,"Welling United","Stevenage Borough","2-0",2,0,5,5,2,2,"H"
NA,1996,"Woking","Stevenage Borough","3-1",3,1,5,5,4,2,"H"
NA,1996,"Altrincham","Telford United","2-3",2,3,5,5,5,-1,"A"
NA,1996,"Bath City","Telford United","2-3",2,3,5,5,5,-1,"A"
NA,1996,"Bromsgrove Rovers","Telford United","2-1",2,1,5,5,3,1,"H"
NA,1996,"Dover Athletic","Telford United","1-4",1,4,5,5,5,-3,"A"
NA,1996,"Farnborough Town","Telford United","0-2",0,2,5,5,2,-2,"A"
NA,1996,"Gateshead","Telford United","2-3",2,3,5,5,5,-1,"A"
NA,1996,"Halifax Town","Telford United","0-3",0,3,5,5,3,-3,"A"
NA,1996,"Hayes & Yeading","Telford United","0-1",0,1,5,5,1,-1,"A"
NA,1996,"Hednesford Town","Telford United","0-0",0,0,5,5,0,0,"D"
NA,1996,"Kettering Town","Telford United","0-1",0,1,5,5,1,-1,"A"
NA,1996,"Kidderminster Harriers","Telford United","1-0",1,0,5,5,1,1,"H"
NA,1996,"Macclesfield","Telford United","2-1",2,1,5,5,3,1,"H"
NA,1996,"Morecambe","Telford United","0-1",0,1,5,5,1,-1,"A"
NA,1996,"Northwich Victoria","Telford United","1-0",1,0,5,5,1,1,"H"
NA,1996,"Rushden & Diamonds","Telford United","2-0",2,0,5,5,2,2,"H"
NA,1996,"Slough Town","Telford United","6-0",6,0,5,5,6,6,"H"
NA,1996,"Southport","Telford United","0-1",0,1,5,5,1,-1,"A"
NA,1996,"Stalybridge Celtic","Telford United","0-0",0,0,5,5,0,0,"D"
NA,1996,"Stevenage Borough","Telford United","3-0",3,0,5,5,3,3,"H"
NA,1996,"Welling United","Telford United","2-1",2,1,5,5,3,1,"H"
NA,1996,"Woking","Telford United","0-0",0,0,5,5,0,0,"D"
NA,1996,"Altrincham","Welling United","1-1",1,1,5,5,2,0,"D"
NA,1996,"Bath City","Welling United","3-1",3,1,5,5,4,2,"H"
NA,1996,"Bromsgrove Rovers","Welling United","1-0",1,0,5,5,1,1,"H"
NA,1996,"Dover Athletic","Welling United","2-1",2,1,5,5,3,1,"H"
NA,1996,"Farnborough Town","Welling United","2-1",2,1,5,5,3,1,"H"
NA,1996,"Gateshead","Welling United","1-2",1,2,5,5,3,-1,"A"
NA,1996,"Halifax Town","Welling United","1-1",1,1,5,5,2,0,"D"
NA,1996,"Hayes & Yeading","Welling United","1-1",1,1,5,5,2,0,"D"
NA,1996,"Hednesford Town","Welling United","0-3",0,3,5,5,3,-3,"A"
NA,1996,"Kettering Town","Welling United","2-3",2,3,5,5,5,-1,"A"
NA,1996,"Kidderminster Harriers","Welling United","3-2",3,2,5,5,5,1,"H"
NA,1996,"Macclesfield","Welling United","1-1",1,1,5,5,2,0,"D"
NA,1996,"Morecambe","Welling United","1-2",1,2,5,5,3,-1,"A"
NA,1996,"Northwich Victoria","Welling United","0-0",0,0,5,5,0,0,"D"
NA,1996,"Rushden & Diamonds","Welling United","3-0",3,0,5,5,3,3,"H"
NA,1996,"Slough Town","Welling United","3-3",3,3,5,5,6,0,"D"
NA,1996,"Southport","Welling United","3-2",3,2,5,5,5,1,"H"
NA,1996,"Stalybridge Celtic","Welling United","0-0",0,0,5,5,0,0,"D"
NA,1996,"Stevenage Borough","Welling United","2-1",2,1,5,5,3,1,"H"
NA,1996,"Telford United","Welling United","2-0",2,0,5,5,2,2,"H"
NA,1996,"Woking","Welling United","2-1",2,1,5,5,3,1,"H"
NA,1996,"Altrincham","Woking","1-1",1,1,5,5,2,0,"D"
NA,1996,"Bath City","Woking","3-1",3,1,5,5,4,2,"H"
NA,1996,"Bromsgrove Rovers","Woking","0-3",0,3,5,5,3,-3,"A"
NA,1996,"Dover Athletic","Woking","5-1",5,1,5,5,6,4,"H"
NA,1996,"Farnborough Town","Woking","1-2",1,2,5,5,3,-1,"A"
NA,1996,"Gateshead","Woking","3-2",3,2,5,5,5,1,"H"
NA,1996,"Halifax Town","Woking","0-4",0,4,5,5,4,-4,"A"
NA,1996,"Hayes & Yeading","Woking","3-2",3,2,5,5,5,1,"H"
NA,1996,"Hednesford Town","Woking","2-0",2,0,5,5,2,2,"H"
NA,1996,"Kettering Town","Woking","0-0",0,0,5,5,0,0,"D"
NA,1996,"Kidderminster Harriers","Woking","1-0",1,0,5,5,1,1,"H"
NA,1996,"Macclesfield","Woking","5-0",5,0,5,5,5,5,"H"
NA,1996,"Morecambe","Woking","1-2",1,2,5,5,3,-1,"A"
NA,1996,"Northwich Victoria","Woking","1-2",1,2,5,5,3,-1,"A"
NA,1996,"Rushden & Diamonds","Woking","1-1",1,1,5,5,2,0,"D"
NA,1996,"Slough Town","Woking","3-0",3,0,5,5,3,3,"H"
NA,1996,"Southport","Woking","4-1",4,1,5,5,5,3,"H"
NA,1996,"Stalybridge Celtic","Woking","0-2",0,2,5,5,2,-2,"A"
NA,1996,"Stevenage Borough","Woking","0-3",0,3,5,5,3,-3,"A"
NA,1996,"Telford United","Woking","1-2",1,2,5,5,3,-1,"A"
NA,1996,"Welling United","Woking","1-1",1,1,5,5,2,0,"D"
NA,1997,"Dover Athletic","Cheltenham","3-0",3,0,5,5,3,3,"H"
NA,1997,"Farnborough Town","Cheltenham","1-2",1,2,5,5,3,-1,"A"
NA,1997,"Gateshead","Cheltenham","0-0",0,0,5,5,0,0,"D"
NA,1997,"Halifax Town","Cheltenham","1-1",1,1,5,5,2,0,"D"
NA,1997,"Hayes & Yeading","Cheltenham","1-1",1,1,5,5,2,0,"D"
NA,1997,"Hednesford Town","Cheltenham","0-1",0,1,5,5,1,-1,"A"
NA,1997,"Hereford United","Cheltenham","3-2",3,2,5,5,5,1,"H"
NA,1997,"Kettering Town","Cheltenham","0-1",0,1,5,5,1,-1,"A"
NA,1997,"Kidderminster Harriers","Cheltenham","1-2",1,2,5,5,3,-1,"A"
NA,1997,"Leek Town","Cheltenham","0-0",0,0,5,5,0,0,"D"
NA,1997,"Morecambe","Cheltenham","1-0",1,0,5,5,1,1,"H"
NA,1997,"Northwich Victoria","Cheltenham","2-1",2,1,5,5,3,1,"H"
NA,1997,"Rushden & Diamonds","Cheltenham","4-1",4,1,5,5,5,3,"H"
NA,1997,"Slough Town","Cheltenham","1-2",1,2,5,5,3,-1,"A"
NA,1997,"Southport","Cheltenham","1-2",1,2,5,5,3,-1,"A"
NA,1997,"Stalybridge Celtic","Cheltenham","1-4",1,4,5,5,5,-3,"A"
NA,1997,"Stevenage Borough","Cheltenham","1-2",1,2,5,5,3,-1,"A"
NA,1997,"Telford United","Cheltenham","0-0",0,0,5,5,0,0,"D"
NA,1997,"Welling United","Cheltenham","2-1",2,1,5,5,3,1,"H"
NA,1997,"Woking","Cheltenham","2-0",2,0,5,5,2,2,"H"
NA,1997,"Yeovil","Cheltenham","3-1",3,1,5,5,4,2,"H"
NA,1997,"Cheltenham","Dover Athletic","3-1",3,1,5,5,4,2,"H"
NA,1997,"Farnborough Town","Dover Athletic","1-0",1,0,5,5,1,1,"H"
NA,1997,"Gateshead","Dover Athletic","1-2",1,2,5,5,3,-1,"A"
NA,1997,"Halifax Town","Dover Athletic","1-1",1,1,5,5,2,0,"D"
NA,1997,"Hayes & Yeading","Dover Athletic","0-0",0,0,5,5,0,0,"D"
NA,1997,"Hednesford Town","Dover Athletic","1-0",1,0,5,5,1,1,"H"
NA,1997,"Hereford United","Dover Athletic","0-1",0,1,5,5,1,-1,"A"
NA,1997,"Kettering Town","Dover Athletic","2-1",2,1,5,5,3,1,"H"
NA,1997,"Kidderminster Harriers","Dover Athletic","3-3",3,3,5,5,6,0,"D"
NA,1997,"Leek Town","Dover Athletic","5-1",5,1,5,5,6,4,"H"
NA,1997,"Morecambe","Dover Athletic","3-3",3,3,5,5,6,0,"D"
NA,1997,"Northwich Victoria","Dover Athletic","2-1",2,1,5,5,3,1,"H"
NA,1997,"Rushden & Diamonds","Dover Athletic","4-1",4,1,5,5,5,3,"H"
NA,1997,"Slough Town","Dover Athletic","2-4",2,4,5,5,6,-2,"A"
NA,1997,"Southport","Dover Athletic","0-1",0,1,5,5,1,-1,"A"
NA,1997,"Stalybridge Celtic","Dover Athletic","1-0",1,0,5,5,1,1,"H"
NA,1997,"Stevenage Borough","Dover Athletic","2-2",2,2,5,5,4,0,"D"
NA,1997,"Telford United","Dover Athletic","0-1",0,1,5,5,1,-1,"A"
NA,1997,"Welling United","Dover Athletic","2-2",2,2,5,5,4,0,"D"
NA,1997,"Woking","Dover Athletic","4-0",4,0,5,5,4,4,"H"
NA,1997,"Yeovil","Dover Athletic","4-1",4,1,5,5,5,3,"H"
NA,1997,"Cheltenham","Farnborough Town","1-0",1,0,5,5,1,1,"H"
NA,1997,"Dover Athletic","Farnborough Town","2-2",2,2,5,5,4,0,"D"
NA,1997,"Gateshead","Farnborough Town","3-0",3,0,5,5,3,3,"H"
NA,1997,"Halifax Town","Farnborough Town","1-0",1,0,5,5,1,1,"H"
NA,1997,"Hayes & Yeading","Farnborough Town","3-1",3,1,5,5,4,2,"H"
NA,1997,"Hednesford Town","Farnborough Town","1-0",1,0,5,5,1,1,"H"
NA,1997,"Hereford United","Farnborough Town","2-1",2,1,5,5,3,1,"H"
NA,1997,"Kettering Town","Farnborough Town","2-1",2,1,5,5,3,1,"H"
NA,1997,"Kidderminster Harriers","Farnborough Town","2-0",2,0,5,5,2,2,"H"
NA,1997,"Leek Town","Farnborough Town","3-1",3,1,5,5,4,2,"H"
NA,1997,"Morecambe","Farnborough Town","1-1",1,1,5,5,2,0,"D"
NA,1997,"Northwich Victoria","Farnborough Town","3-3",3,3,5,5,6,0,"D"
NA,1997,"Rushden & Diamonds","Farnborough Town","5-5",5,5,5,5,10,0,"D"
NA,1997,"Slough Town","Farnborough Town","1-0",1,0,5,5,1,1,"H"
NA,1997,"Southport","Farnborough Town","3-1",3,1,5,5,4,2,"H"
NA,1997,"Stalybridge Celtic","Farnborough Town","1-1",1,1,5,5,2,0,"D"
NA,1997,"Stevenage Borough","Farnborough Town","5-0",5,0,5,5,5,5,"H"
NA,1997,"Telford United","Farnborough Town","0-1",0,1,5,5,1,-1,"A"
NA,1997,"Welling United","Farnborough Town","1-0",1,0,5,5,1,1,"H"
NA,1997,"Woking","Farnborough Town","3-0",3,0,5,5,3,3,"H"
NA,1997,"Yeovil","Farnborough Town","0-1",0,1,5,5,1,-1,"A"
NA,1997,"Cheltenham","Gateshead","2-0",2,0,5,5,2,2,"H"
NA,1997,"Dover Athletic","Gateshead","0-1",0,1,5,5,1,-1,"A"
NA,1997,"Farnborough Town","Gateshead","4-0",4,0,5,5,4,4,"H"
NA,1997,"Halifax Town","Gateshead","2-0",2,0,5,5,2,2,"H"
NA,1997,"Hayes & Yeading","Gateshead","1-0",1,0,5,5,1,1,"H"
NA,1997,"Hednesford Town","Gateshead","3-0",3,0,5,5,3,3,"H"
NA,1997,"Hereford United","Gateshead","1-0",1,0,5,5,1,1,"H"
NA,1997,"Kettering Town","Gateshead","3-0",3,0,5,5,3,3,"H"
NA,1997,"Kidderminster Harriers","Gateshead","1-1",1,1,5,5,2,0,"D"
NA,1997,"Leek Town","Gateshead","2-2",2,2,5,5,4,0,"D"
NA,1997,"Morecambe","Gateshead","2-0",2,0,5,5,2,2,"H"
NA,1997,"Northwich Victoria","Gateshead","1-1",1,1,5,5,2,0,"D"
NA,1997,"Rushden & Diamonds","Gateshead","3-2",3,2,5,5,5,1,"H"
NA,1997,"Slough Town","Gateshead","1-0",1,0,5,5,1,1,"H"
NA,1997,"Southport","Gateshead","3-1",3,1,5,5,4,2,"H"
NA,1997,"Stalybridge Celtic","Gateshead","2-2",2,2,5,5,4,0,"D"
NA,1997,"Stevenage Borough","Gateshead","6-1",6,1,5,5,7,5,"H"
NA,1997,"Telford United","Gateshead","4-4",4,4,5,5,8,0,"D"
NA,1997,"Welling United","Gateshead","2-0",2,0,5,5,2,2,"H"
NA,1997,"Woking","Gateshead","3-1",3,1,5,5,4,2,"H"
NA,1997,"Yeovil","Gateshead","6-3",6,3,5,5,9,3,"H"
NA,1997,"Cheltenham","Halifax Town","4-0",4,0,5,5,4,4,"H"
NA,1997,"Dover Athletic","Halifax Town","0-1",0,1,5,5,1,-1,"A"
NA,1997,"Farnborough Town","Halifax Town","1-2",1,2,5,5,3,-1,"A"
NA,1997,"Gateshead","Halifax Town","2-2",2,2,5,5,4,0,"D"
NA,1997,"Hayes & Yeading","Halifax Town","1-2",1,2,5,5,3,-1,"A"
NA,1997,"Hednesford Town","Halifax Town","0-0",0,0,5,5,0,0,"D"
NA,1997,"Hereford United","Halifax Town","0-0",0,0,5,5,0,0,"D"
NA,1997,"Kettering Town","Halifax Town","1-1",1,1,5,5,2,0,"D"
NA,1997,"Kidderminster Harriers","Halifax Town","0-2",0,2,5,5,2,-2,"A"
NA,1997,"Leek Town","Halifax Town","2-0",2,0,5,5,2,2,"H"
NA,1997,"Morecambe","Halifax Town","1-1",1,1,5,5,2,0,"D"
NA,1997,"Northwich Victoria","Halifax Town","2-0",2,0,5,5,2,2,"H"
NA,1997,"Rushden & Diamonds","Halifax Town","4-0",4,0,5,5,4,4,"H"
NA,1997,"Slough Town","Halifax Town","1-1",1,1,5,5,2,0,"D"
NA,1997,"Southport","Halifax Town","0-0",0,0,5,5,0,0,"D"
NA,1997,"Stalybridge Celtic","Halifax Town","0-1",0,1,5,5,1,-1,"A"
NA,1997,"Stevenage Borough","Halifax Town","1-2",1,2,5,5,3,-1,"A"
NA,1997,"Telford United","Halifax Town","0-3",0,3,5,5,3,-3,"A"
NA,1997,"Welling United","Halifax Town","6-2",6,2,5,5,8,4,"H"
NA,1997,"Woking","Halifax Town","2-2",2,2,5,5,4,0,"D"
NA,1997,"Yeovil","Halifax Town","0-1",0,1,5,5,1,-1,"A"
NA,1997,"Cheltenham","Hayes & Yeading","2-1",2,1,5,5,3,1,"H"
NA,1997,"Dover Athletic","Hayes & Yeading","1-0",1,0,5,5,1,1,"H"
NA,1997,"Farnborough Town","Hayes & Yeading","0-2",0,2,5,5,2,-2,"A"
NA,1997,"Gateshead","Hayes & Yeading","1-1",1,1,5,5,2,0,"D"
NA,1997,"Halifax Town","Hayes & Yeading","1-1",1,1,5,5,2,0,"D"
NA,1997,"Hednesford Town","Hayes & Yeading","2-1",2,1,5,5,3,1,"H"
NA,1997,"Hereford United","Hayes & Yeading","3-0",3,0,5,5,3,3,"H"
NA,1997,"Kettering Town","Hayes & Yeading","1-1",1,1,5,5,2,0,"D"
NA,1997,"Kidderminster Harriers","Hayes & Yeading","1-0",1,0,5,5,1,1,"H"
NA,1997,"Leek Town","Hayes & Yeading","1-2",1,2,5,5,3,-1,"A"
NA,1997,"Morecambe","Hayes & Yeading","0-2",0,2,5,5,2,-2,"A"
NA,1997,"Northwich Victoria","Hayes & Yeading","1-1",1,1,5,5,2,0,"D"
NA,1997,"Rushden & Diamonds","Hayes & Yeading","1-3",1,3,5,5,4,-2,"A"
NA,1997,"Slough Town","Hayes & Yeading","0-0",0,0,5,5,0,0,"D"
NA,1997,"Southport","Hayes & Yeading","0-2",0,2,5,5,2,-2,"A"
NA,1997,"Stalybridge Celtic","Hayes & Yeading","1-1",1,1,5,5,2,0,"D"
NA,1997,"Stevenage Borough","Hayes & Yeading","1-5",1,5,5,5,6,-4,"A"
NA,1997,"Telford United","Hayes & Yeading","1-0",1,0,5,5,1,1,"H"
NA,1997,"Welling United","Hayes & Yeading","2-0",2,0,5,5,2,2,"H"
NA,1997,"Woking","Hayes & Yeading","3-0",3,0,5,5,3,3,"H"
NA,1997,"Yeovil","Hayes & Yeading","4-3",4,3,5,5,7,1,"H"
NA,1997,"Cheltenham","Hednesford Town","1-0",1,0,5,5,1,1,"H"
NA,1997,"Dover Athletic","Hednesford Town","1-3",1,3,5,5,4,-2,"A"
NA,1997,"Farnborough Town","Hednesford Town","1-3",1,3,5,5,4,-2,"A"
NA,1997,"Gateshead","Hednesford Town","2-5",2,5,5,5,7,-3,"A"
NA,1997,"Halifax Town","Hednesford Town","1-1",1,1,5,5,2,0,"D"
NA,1997,"Hayes & Yeading","Hednesford Town","4-0",4,0,5,5,4,4,"H"
NA,1997,"Hereford United","Hednesford Town","2-1",2,1,5,5,3,1,"H"
NA,1997,"Kettering Town","Hednesford Town","2-1",2,1,5,5,3,1,"H"
NA,1997,"Kidderminster Harriers","Hednesford Town","1-1",1,1,5,5,2,0,"D"
NA,1997,"Leek Town","Hednesford Town","3-3",3,3,5,5,6,0,"D"
NA,1997,"Morecambe","Hednesford Town","1-3",1,3,5,5,4,-2,"A"
NA,1997,"Northwich Victoria","Hednesford Town","1-1",1,1,5,5,2,0,"D"
NA,1997,"Rushden & Diamonds","Hednesford Town","1-1",1,1,5,5,2,0,"D"
NA,1997,"Slough Town","Hednesford Town","2-0",2,0,5,5,2,2,"H"
NA,1997,"Southport","Hednesford Town","4-1",4,1,5,5,5,3,"H"
NA,1997,"Stalybridge Celtic","Hednesford Town","1-1",1,1,5,5,2,0,"D"
NA,1997,"Stevenage Borough","Hednesford Town","1-1",1,1,5,5,2,0,"D"
NA,1997,"Telford United","Hednesford Town","1-1",1,1,5,5,2,0,"D"
NA,1997,"Welling United","Hednesford Town","3-2",3,2,5,5,5,1,"H"
NA,1997,"Woking","Hednesford Town","4-2",4,2,5,5,6,2,"H"
NA,1997,"Yeovil","Hednesford Town","1-0",1,0,5,5,1,1,"H"
NA,1997,"Cheltenham","Hereford United","1-2",1,2,5,5,3,-1,"A"
NA,1997,"Dover Athletic","Hereford United","1-1",1,1,5,5,2,0,"D"
NA,1997,"Farnborough Town","Hereford United","0-2",0,2,5,5,2,-2,"A"
NA,1997,"Gateshead","Hereford United","1-1",1,1,5,5,2,0,"D"
NA,1997,"Halifax Town","Hereford United","3-0",3,0,5,5,3,3,"H"
NA,1997,"Hayes & Yeading","Hereford United","2-0",2,0,5,5,2,2,"H"
NA,1997,"Hednesford Town","Hereford United","1-1",1,1,5,5,2,0,"D"
NA,1997,"Kettering Town","Hereford United","1-2",1,2,5,5,3,-1,"A"
NA,1997,"Kidderminster Harriers","Hereford United","1-4",1,4,5,5,5,-3,"A"
NA,1997,"Leek Town","Hereford United","2-2",2,2,5,5,4,0,"D"
NA,1997,"Morecambe","Hereford United","1-5",1,5,5,5,6,-4,"A"
NA,1997,"Northwich Victoria","Hereford United","0-2",0,2,5,5,2,-2,"A"
NA,1997,"Rushden & Diamonds","Hereford United","1-0",1,0,5,5,1,1,"H"
NA,1997,"Slough Town","Hereford United","3-0",3,0,5,5,3,3,"H"
NA,1997,"Southport","Hereford United","0-0",0,0,5,5,0,0,"D"
NA,1997,"Stalybridge Celtic","Hereford United","2-3",2,3,5,5,5,-1,"A"
NA,1997,"Stevenage Borough","Hereford United","2-0",2,0,5,5,2,2,"H"
NA,1997,"Telford United","Hereford United","0-0",0,0,5,5,0,0,"D"
NA,1997,"Welling United","Hereford United","3-0",3,0,5,5,3,3,"H"
NA,1997,"Woking","Hereford United","3-1",3,1,5,5,4,2,"H"
NA,1997,"Yeovil","Hereford United","2-0",2,0,5,5,2,2,"H"
NA,1997,"Cheltenham","Kettering Town","2-0",2,0,5,5,2,2,"H"
NA,1997,"Dover Athletic","Kettering Town","0-0",0,0,5,5,0,0,"D"
NA,1997,"Farnborough Town","Kettering Town","3-2",3,2,5,5,5,1,"H"
NA,1997,"Gateshead","Kettering Town","2-0",2,0,5,5,2,2,"H"
NA,1997,"Halifax Town","Kettering Town","3-0",3,0,5,5,3,3,"H"
NA,1997,"Hayes & Yeading","Kettering Town","0-1",0,1,5,5,1,-1,"A"
NA,1997,"Hednesford Town","Kettering Town","1-1",1,1,5,5,2,0,"D"
NA,1997,"Hereford United","Kettering Town","3-2",3,2,5,5,5,1,"H"
NA,1997,"Kidderminster Harriers","Kettering Town","4-1",4,1,5,5,5,3,"H"
NA,1997,"Leek Town","Kettering Town","0-4",0,4,5,5,4,-4,"A"
NA,1997,"Morecambe","Kettering Town","1-3",1,3,5,5,4,-2,"A"
NA,1997,"Northwich Victoria","Kettering Town","0-0",0,0,5,5,0,0,"D"
NA,1997,"Rushden & Diamonds","Kettering Town","1-0",1,0,5,5,1,1,"H"
NA,1997,"Slough Town","Kettering Town","1-1",1,1,5,5,2,0,"D"
NA,1997,"Southport","Kettering Town","2-1",2,1,5,5,3,1,"H"
NA,1997,"Stalybridge Celtic","Kettering Town","3-4",3,4,5,5,7,-1,"A"
NA,1997,"Stevenage Borough","Kettering Town","0-0",0,0,5,5,0,0,"D"
NA,1997,"Telford United","Kettering Town","1-1",1,1,5,5,2,0,"D"
NA,1997,"Welling United","Kettering Town","2-2",2,2,5,5,4,0,"D"
NA,1997,"Woking","Kettering Town","0-1",0,1,5,5,1,-1,"A"
NA,1997,"Yeovil","Kettering Town","2-0",2,0,5,5,2,2,"H"
NA,1997,"Cheltenham","Kidderminster Harriers","0-1",0,1,5,5,1,-1,"A"
NA,1997,"Dover Athletic","Kidderminster Harriers","0-4",0,4,5,5,4,-4,"A"
NA,1997,"Farnborough Town","Kidderminster Harriers","3-3",3,3,5,5,6,0,"D"
NA,1997,"Gateshead","Kidderminster Harriers","2-0",2,0,5,5,2,2,"H"
NA,1997,"Halifax Town","Kidderminster Harriers","2-1",2,1,5,5,3,1,"H"
NA,1997,"Hayes & Yeading","Kidderminster Harriers","1-1",1,1,5,5,2,0,"D"
NA,1997,"Hednesford Town","Kidderminster Harriers","3-0",3,0,5,5,3,3,"H"
NA,1997,"Hereford United","Kidderminster Harriers","1-0",1,0,5,5,1,1,"H"
NA,1997,"Kettering Town","Kidderminster Harriers","2-2",2,2,5,5,4,0,"D"
NA,1997,"Leek Town","Kidderminster Harriers","0-0",0,0,5,5,0,0,"D"
NA,1997,"Morecambe","Kidderminster Harriers","3-1",3,1,5,5,4,2,"H"
NA,1997,"Northwich Victoria","Kidderminster Harriers","1-1",1,1,5,5,2,0,"D"
NA,1997,"Rushden & Diamonds","Kidderminster Harriers","4-1",4,1,5,5,5,3,"H"
NA,1997,"Slough Town","Kidderminster Harriers","2-0",2,0,5,5,2,2,"H"
NA,1997,"Southport","Kidderminster Harriers","1-2",1,2,5,5,3,-1,"A"
NA,1997,"Stalybridge Celtic","Kidderminster Harriers","2-1",2,1,5,5,3,1,"H"
NA,1997,"Stevenage Borough","Kidderminster Harriers","3-1",3,1,5,5,4,2,"H"
NA,1997,"Telford United","Kidderminster Harriers","1-1",1,1,5,5,2,0,"D"
NA,1997,"Welling United","Kidderminster Harriers","0-3",0,3,5,5,3,-3,"A"
NA,1997,"Woking","Kidderminster Harriers","0-1",0,1,5,5,1,-1,"A"
NA,1997,"Yeovil","Kidderminster Harriers","1-0",1,0,5,5,1,1,"H"
NA,1997,"Cheltenham","Leek Town","1-1",1,1,5,5,2,0,"D"
NA,1997,"Dover Athletic","Leek Town","2-1",2,1,5,5,3,1,"H"
NA,1997,"Farnborough Town","Leek Town","2-0",2,0,5,5,2,2,"H"
NA,1997,"Gateshead","Leek Town","0-2",0,2,5,5,2,-2,"A"
NA,1997,"Halifax Town","Leek Town","2-1",2,1,5,5,3,1,"H"
NA,1997,"Hayes & Yeading","Leek Town","3-1",3,1,5,5,4,2,"H"
NA,1997,"Hednesford Town","Leek Town","1-0",1,0,5,5,1,1,"H"
NA,1997,"Hereford United","Leek Town","1-0",1,0,5,5,1,1,"H"
NA,1997,"Kettering Town","Leek Town","1-0",1,0,5,5,1,1,"H"
NA,1997,"Kidderminster Harriers","Leek Town","1-1",1,1,5,5,2,0,"D"
NA,1997,"Morecambe","Leek Town","1-1",1,1,5,5,2,0,"D"
NA,1997,"Northwich Victoria","Leek Town","3-1",3,1,5,5,4,2,"H"
NA,1997,"Rushden & Diamonds","Leek Town","0-1",0,1,5,5,1,-1,"A"
NA,1997,"Slough Town","Leek Town","1-1",1,1,5,5,2,0,"D"
NA,1997,"Southport","Leek Town","2-2",2,2,5,5,4,0,"D"
NA,1997,"Stalybridge Celtic","Leek Town","6-1",6,1,5,5,7,5,"H"
NA,1997,"Stevenage Borough","Leek Town","1-1",1,1,5,5,2,0,"D"
NA,1997,"Telford United","Leek Town","3-0",3,0,5,5,3,3,"H"
NA,1997,"Welling United","Leek Town","2-0",2,0,5,5,2,2,"H"
NA,1997,"Woking","Leek Town","5-2",5,2,5,5,7,3,"H"
NA,1997,"Yeovil","Leek Town","3-1",3,1,5,5,4,2,"H"
NA,1997,"Cheltenham","Morecambe","2-1",2,1,5,5,3,1,"H"
NA,1997,"Dover Athletic","Morecambe","2-3",2,3,5,5,5,-1,"A"
NA,1997,"Farnborough Town","Morecambe","0-2",0,2,5,5,2,-2,"A"
NA,1997,"Gateshead","Morecambe","1-4",1,4,5,5,5,-3,"A"
NA,1997,"Halifax Town","Morecambe","5-1",5,1,5,5,6,4,"H"
NA,1997,"Hayes & Yeading","Morecambe","0-3",0,3,5,5,3,-3,"A"
NA,1997,"Hednesford Town","Morecambe","0-1",0,1,5,5,1,-1,"A"
NA,1997,"Hereford United","Morecambe","1-0",1,0,5,5,1,1,"H"
NA,1997,"Kettering Town","Morecambe","1-1",1,1,5,5,2,0,"D"
NA,1997,"Kidderminster Harriers","Morecambe","1-4",1,4,5,5,5,-3,"A"
NA,1997,"Leek Town","Morecambe","1-1",1,1,5,5,2,0,"D"
NA,1997,"Northwich Victoria","Morecambe","5-0",5,0,5,5,5,5,"H"
NA,1997,"Rushden & Diamonds","Morecambe","3-3",3,3,5,5,6,0,"D"
NA,1997,"Slough Town","Morecambe","3-3",3,3,5,5,6,0,"D"
NA,1997,"Southport","Morecambe","1-1",1,1,5,5,2,0,"D"
NA,1997,"Stalybridge Celtic","Morecambe","3-1",3,1,5,5,4,2,"H"
NA,1997,"Stevenage Borough","Morecambe","0-3",0,3,5,5,3,-3,"A"
NA,1997,"Telford United","Morecambe","1-3",1,3,5,5,4,-2,"A"
NA,1997,"Welling United","Morecambe","2-2",2,2,5,5,4,0,"D"
NA,1997,"Woking","Morecambe","0-2",0,2,5,5,2,-2,"A"
NA,1997,"Yeovil","Morecambe","2-3",2,3,5,5,5,-1,"A"
NA,1997,"Cheltenham","Northwich Victoria","3-2",3,2,5,5,5,1,"H"
NA,1997,"Dover Athletic","Northwich Victoria","4-0",4,0,5,5,4,4,"H"
NA,1997,"Farnborough Town","Northwich Victoria","2-3",2,3,5,5,5,-1,"A"
NA,1997,"Gateshead","Northwich Victoria","2-2",2,2,5,5,4,0,"D"
NA,1997,"Halifax Town","Northwich Victoria","4-2",4,2,5,5,6,2,"H"
NA,1997,"Hayes & Yeading","Northwich Victoria","1-1",1,1,5,5,2,0,"D"
NA,1997,"Hednesford Town","Northwich Victoria","2-0",2,0,5,5,2,2,"H"
NA,1997,"Hereford United","Northwich Victoria","2-2",2,2,5,5,4,0,"D"
NA,1997,"Kettering Town","Northwich Victoria","1-3",1,3,5,5,4,-2,"A"
NA,1997,"Kidderminster Harriers","Northwich Victoria","1-1",1,1,5,5,2,0,"D"
NA,1997,"Leek Town","Northwich Victoria","1-1",1,1,5,5,2,0,"D"
NA,1997,"Morecambe","Northwich Victoria","3-1",3,1,5,5,4,2,"H"
NA,1997,"Rushden & Diamonds","Northwich Victoria","0-1",0,1,5,5,1,-1,"A"
NA,1997,"Slough Town","Northwich Victoria","3-0",3,0,5,5,3,3,"H"
NA,1997,"Southport","Northwich Victoria","0-2",0,2,5,5,2,-2,"A"
NA,1997,"Stalybridge Celtic","Northwich Victoria","0-1",0,1,5,5,1,-1,"A"
NA,1997,"Stevenage Borough","Northwich Victoria","1-3",1,3,5,5,4,-2,"A"
NA,1997,"Telford United","Northwich Victoria","2-1",2,1,5,5,3,1,"H"
NA,1997,"Welling United","Northwich Victoria","0-1",0,1,5,5,1,-1,"A"
NA,1997,"Woking","Northwich Victoria","1-0",1,0,5,5,1,1,"H"
NA,1997,"Yeovil","Northwich Victoria","2-2",2,2,5,5,4,0,"D"
NA,1997,"Cheltenham","Rushden & Diamonds","2-0",2,0,5,5,2,2,"H"
NA,1997,"Dover Athletic","Rushden & Diamonds","0-3",0,3,5,5,3,-3,"A"
NA,1997,"Farnborough Town","Rushden & Diamonds","2-0",2,0,5,5,2,2,"H"
NA,1997,"Gateshead","Rushden & Diamonds","2-1",2,1,5,5,3,1,"H"
NA,1997,"Halifax Town","Rushden & Diamonds","2-0",2,0,5,5,2,2,"H"
NA,1997,"Hayes & Yeading","Rushden & Diamonds","1-2",1,2,5,5,3,-1,"A"
NA,1997,"Hednesford Town","Rushden & Diamonds","0-1",0,1,5,5,1,-1,"A"
NA,1997,"Hereford United","Rushden & Diamonds","1-1",1,1,5,5,2,0,"D"
NA,1997,"Kettering Town","Rushden & Diamonds","0-4",0,4,5,5,4,-4,"A"
NA,1997,"Kidderminster Harriers","Rushden & Diamonds","1-2",1,2,5,5,3,-1,"A"
NA,1997,"Leek Town","Rushden & Diamonds","2-0",2,0,5,5,2,2,"H"
NA,1997,"Morecambe","Rushden & Diamonds","3-1",3,1,5,5,4,2,"H"
NA,1997,"Northwich Victoria","Rushden & Diamonds","2-4",2,4,5,5,6,-2,"A"
NA,1997,"Slough Town","Rushden & Diamonds","1-2",1,2,5,5,3,-1,"A"
NA,1997,"Southport","Rushden & Diamonds","3-2",3,2,5,5,5,1,"H"
NA,1997,"Stalybridge Celtic","Rushden & Diamonds","2-4",2,4,5,5,6,-2,"A"
NA,1997,"Stevenage Borough","Rushden & Diamonds","2-1",2,1,5,5,3,1,"H"
NA,1997,"Telford United","Rushden & Diamonds","4-2",4,2,5,5,6,2,"H"
NA,1997,"Welling United","Rushden & Diamonds","0-1",0,1,5,5,1,-1,"A"
NA,1997,"Woking","Rushden & Diamonds","0-2",0,2,5,5,2,-2,"A"
NA,1997,"Yeovil","Rushden & Diamonds","1-2",1,2,5,5,3,-1,"A"
NA,1997,"Cheltenham","Slough Town","1-1",1,1,5,5,2,0,"D"
NA,1997,"Dover Athletic","Slough Town","2-1",2,1,5,5,3,1,"H"
NA,1997,"Farnborough Town","Slough Town","1-0",1,0,5,5,1,1,"H"
NA,1997,"Gateshead","Slough Town","5-1",5,1,5,5,6,4,"H"
NA,1997,"Halifax Town","Slough Town","1-0",1,0,5,5,1,1,"H"
NA,1997,"Hayes & Yeading","Slough Town","0-1",0,1,5,5,1,-1,"A"
NA,1997,"Hednesford Town","Slough Town","2-1",2,1,5,5,3,1,"H"
NA,1997,"Hereford United","Slough Town","1-1",1,1,5,5,2,0,"D"
NA,1997,"Kettering Town","Slough Town","3-3",3,3,5,5,6,0,"D"
NA,1997,"Kidderminster Harriers","Slough Town","0-1",0,1,5,5,1,-1,"A"
NA,1997,"Leek Town","Slough Town","0-2",0,2,5,5,2,-2,"A"
NA,1997,"Morecambe","Slough Town","2-1",2,1,5,5,3,1,"H"
NA,1997,"Northwich Victoria","Slough Town","0-1",0,1,5,5,1,-1,"A"
NA,1997,"Rushden & Diamonds","Slough Town","0-1",0,1,5,5,1,-1,"A"
NA,1997,"Southport","Slough Town","1-2",1,2,5,5,3,-1,"A"
NA,1997,"Stalybridge Celtic","Slough Town","0-1",0,1,5,5,1,-1,"A"
NA,1997,"Stevenage Borough","Slough Town","4-2",4,2,5,5,6,2,"H"
NA,1997,"Telford United","Slough Town","0-1",0,1,5,5,1,-1,"A"
NA,1997,"Welling United","Slough Town","1-1",1,1,5,5,2,0,"D"
NA,1997,"Woking","Slough Town","2-1",2,1,5,5,3,1,"H"
NA,1997,"Yeovil","Slough Town","2-1",2,1,5,5,3,1,"H"
NA,1997,"Cheltenham","Southport","2-0",2,0,5,5,2,2,"H"
NA,1997,"Dover Athletic","Southport","3-1",3,1,5,5,4,2,"H"
NA,1997,"Farnborough Town","Southport","3-2",3,2,5,5,5,1,"H"
NA,1997,"Gateshead","Southport","0-2",0,2,5,5,2,-2,"A"
NA,1997,"Halifax Town","Southport","4-3",4,3,5,5,7,1,"H"
NA,1997,"Hayes & Yeading","Southport","2-0",2,0,5,5,2,2,"H"
NA,1997,"Hednesford Town","Southport","2-1",2,1,5,5,3,1,"H"
NA,1997,"Hereford United","Southport","1-1",1,1,5,5,2,0,"D"
NA,1997,"Kettering Town","Southport","2-1",2,1,5,5,3,1,"H"
NA,1997,"Kidderminster Harriers","Southport","1-1",1,1,5,5,2,0,"D"
NA,1997,"Leek Town","Southport","0-1",0,1,5,5,1,-1,"A"
NA,1997,"Morecambe","Southport","2-0",2,0,5,5,2,2,"H"
NA,1997,"Northwich Victoria","Southport","0-0",0,0,5,5,0,0,"D"
NA,1997,"Rushden & Diamonds","Southport","1-0",1,0,5,5,1,1,"H"
NA,1997,"Slough Town","Southport","1-0",1,0,5,5,1,1,"H"
NA,1997,"Stalybridge Celtic","Southport","1-3",1,3,5,5,4,-2,"A"
NA,1997,"Stevenage Borough","Southport","1-0",1,0,5,5,1,1,"H"
NA,1997,"Telford United","Southport","2-2",2,2,5,5,4,0,"D"
NA,1997,"Welling United","Southport","3-5",3,5,5,5,8,-2,"A"
NA,1997,"Woking","Southport","1-1",1,1,5,5,2,0,"D"
NA,1997,"Yeovil","Southport","0-0",0,0,5,5,0,0,"D"
NA,1997,"Cheltenham","Stalybridge Celtic","2-0",2,0,5,5,2,2,"H"
NA,1997,"Dover Athletic","Stalybridge Celtic","3-1",3,1,5,5,4,2,"H"
NA,1997,"Farnborough Town","Stalybridge Celtic","6-0",6,0,5,5,6,6,"H"
NA,1997,"Gateshead","Stalybridge Celtic","3-3",3,3,5,5,6,0,"D"
NA,1997,"Halifax Town","Stalybridge Celtic","3-1",3,1,5,5,4,2,"H"
NA,1997,"Hayes & Yeading","Stalybridge Celtic","1-2",1,2,5,5,3,-1,"A"
NA,1997,"Hednesford Town","Stalybridge Celtic","1-0",1,0,5,5,1,1,"H"
NA,1997,"Hereford United","Stalybridge Celtic","3-0",3,0,5,5,3,3,"H"
NA,1997,"Kettering Town","Stalybridge Celtic","3-1",3,1,5,5,4,2,"H"
NA,1997,"Kidderminster Harriers","Stalybridge Celtic","5-0",5,0,5,5,5,5,"H"
NA,1997,"Leek Town","Stalybridge Celtic","2-2",2,2,5,5,4,0,"D"
NA,1997,"Morecambe","Stalybridge Celtic","3-1",3,1,5,5,4,2,"H"
NA,1997,"Northwich Victoria","Stalybridge Celtic","1-0",1,0,5,5,1,1,"H"
NA,1997,"Rushden & Diamonds","Stalybridge Celtic","3-0",3,0,5,5,3,3,"H"
NA,1997,"Slough Town","Stalybridge Celtic","4-0",4,0,5,5,4,4,"H"
NA,1997,"Southport","Stalybridge Celtic","4-2",4,2,5,5,6,2,"H"
NA,1997,"Stevenage Borough","Stalybridge Celtic","1-1",1,1,5,5,2,0,"D"
NA,1997,"Telford United","Stalybridge Celtic","1-0",1,0,5,5,1,1,"H"
NA,1997,"Welling United","Stalybridge Celtic","1-0",1,0,5,5,1,1,"H"
NA,1997,"Woking","Stalybridge Celtic","3-1",3,1,5,5,4,2,"H"
NA,1997,"Yeovil","Stalybridge Celtic","2-0",2,0,5,5,2,2,"H"
NA,1997,"Cheltenham","Stevenage Borough","1-1",1,1,5,5,2,0,"D"
NA,1997,"Dover Athletic","Stevenage Borough","1-1",1,1,5,5,2,0,"D"
NA,1997,"Farnborough Town","Stevenage Borough","1-2",1,2,5,5,3,-1,"A"
NA,1997,"Gateshead","Stevenage Borough","2-1",2,1,5,5,3,1,"H"
NA,1997,"Halifax Town","Stevenage Borough","4-0",4,0,5,5,4,4,"H"
NA,1997,"Hayes & Yeading","Stevenage Borough","1-3",1,3,5,5,4,-2,"A"
NA,1997,"Hednesford Town","Stevenage Borough","2-1",2,1,5,5,3,1,"H"
NA,1997,"Hereford United","Stevenage Borough","0-2",0,2,5,5,2,-2,"A"
NA,1997,"Kettering Town","Stevenage Borough","2-0",2,0,5,5,2,2,"H"
NA,1997,"Kidderminster Harriers","Stevenage Borough","1-3",1,3,5,5,4,-2,"A"
NA,1997,"Leek Town","Stevenage Borough","2-1",2,1,5,5,3,1,"H"
NA,1997,"Morecambe","Stevenage Borough","0-2",0,2,5,5,2,-2,"A"
NA,1997,"Northwich Victoria","Stevenage Borough","1-0",1,0,5,5,1,1,"H"
NA,1997,"Rushden & Diamonds","Stevenage Borough","2-0",2,0,5,5,2,2,"H"
NA,1997,"Slough Town","Stevenage Borough","3-1",3,1,5,5,4,2,"H"
NA,1997,"Southport","Stevenage Borough","1-0",1,0,5,5,1,1,"H"
NA,1997,"Stalybridge Celtic","Stevenage Borough","1-1",1,1,5,5,2,0,"D"
NA,1997,"Telford United","Stevenage Borough","3-0",3,0,5,5,3,3,"H"
NA,1997,"Welling United","Stevenage Borough","1-0",1,0,5,5,1,1,"H"
NA,1997,"Woking","Stevenage Borough","5-3",5,3,5,5,8,2,"H"
NA,1997,"Yeovil","Stevenage Borough","2-1",2,1,5,5,3,1,"H"
NA,1997,"Cheltenham","Telford United","3-1",3,1,5,5,4,2,"H"
NA,1997,"Dover Athletic","Telford United","6-3",6,3,5,5,9,3,"H"
NA,1997,"Farnborough Town","Telford United","1-0",1,0,5,5,1,1,"H"
NA,1997,"Gateshead","Telford United","0-2",0,2,5,5,2,-2,"A"
NA,1997,"Halifax Town","Telford United","6-1",6,1,5,5,7,5,"H"
NA,1997,"Hayes & Yeading","Telford United","2-1",2,1,5,5,3,1,"H"
NA,1997,"Hednesford Town","Telford United","1-0",1,0,5,5,1,1,"H"
NA,1997,"Hereford United","Telford United","1-1",1,1,5,5,2,0,"D"
NA,1997,"Kettering Town","Telford United","1-3",1,3,5,5,4,-2,"A"
NA,1997,"Kidderminster Harriers","Telford United","1-1",1,1,5,5,2,0,"D"
NA,1997,"Leek Town","Telford United","3-1",3,1,5,5,4,2,"H"
NA,1997,"Morecambe","Telford United","1-0",1,0,5,5,1,1,"H"
NA,1997,"Northwich Victoria","Telford United","2-2",2,2,5,5,4,0,"D"
NA,1997,"Rushden & Diamonds","Telford United","3-2",3,2,5,5,5,1,"H"
NA,1997,"Slough Town","Telford United","1-0",1,0,5,5,1,1,"H"
NA,1997,"Southport","Telford United","1-2",1,2,5,5,3,-1,"A"
NA,1997,"Stalybridge Celtic","Telford United","1-2",1,2,5,5,3,-1,"A"
NA,1997,"Stevenage Borough","Telford United","1-1",1,1,5,5,2,0,"D"
NA,1997,"Welling United","Telford United","4-1",4,1,5,5,5,3,"H"
NA,1997,"Woking","Telford United","1-1",1,1,5,5,2,0,"D"
NA,1997,"Yeovil","Telford United","5-3",5,3,5,5,8,2,"H"
NA,1997,"Cheltenham","Welling United","1-1",1,1,5,5,2,0,"D"
NA,1997,"Dover Athletic","Welling United","2-1",2,1,5,5,3,1,"H"
NA,1997,"Farnborough Town","Welling United","0-0",0,0,5,5,0,0,"D"
NA,1997,"Gateshead","Welling United","2-1",2,1,5,5,3,1,"H"
NA,1997,"Halifax Town","Welling United","1-0",1,0,5,5,1,1,"H"
NA,1997,"Hayes & Yeading","Welling United","3-1",3,1,5,5,4,2,"H"
NA,1997,"Hednesford Town","Welling United","3-2",3,2,5,5,5,1,"H"
NA,1997,"Hereford United","Welling United","1-2",1,2,5,5,3,-1,"A"
NA,1997,"Kettering Town","Welling United","0-1",0,1,5,5,1,-1,"A"
NA,1997,"Kidderminster Harriers","Welling United","2-1",2,1,5,5,3,1,"H"
NA,1997,"Leek Town","Welling United","1-2",1,2,5,5,3,-1,"A"
NA,1997,"Morecambe","Welling United","4-2",4,2,5,5,6,2,"H"
NA,1997,"Northwich Victoria","Welling United","5-1",5,1,5,5,6,4,"H"
NA,1997,"Rushden & Diamonds","Welling United","0-1",0,1,5,5,1,-1,"A"
NA,1997,"Slough Town","Welling United","1-2",1,2,5,5,3,-1,"A"
NA,1997,"Southport","Welling United","3-1",3,1,5,5,4,2,"H"
NA,1997,"Stalybridge Celtic","Welling United","2-1",2,1,5,5,3,1,"H"
NA,1997,"Stevenage Borough","Welling United","0-0",0,0,5,5,0,0,"D"
NA,1997,"Telford United","Welling United","0-3",0,3,5,5,3,-3,"A"
NA,1997,"Woking","Welling United","3-1",3,1,5,5,4,2,"H"
NA,1997,"Yeovil","Welling United","1-1",1,1,5,5,2,0,"D"
NA,1997,"Cheltenham","Woking","3-2",3,2,5,5,5,1,"H"
NA,1997,"Dover Athletic","Woking","0-2",0,2,5,5,2,-2,"A"
NA,1997,"Farnborough Town","Woking","3-0",3,0,5,5,3,3,"H"
NA,1997,"Gateshead","Woking","1-2",1,2,5,5,3,-1,"A"
NA,1997,"Halifax Town","Woking","1-0",1,0,5,5,1,1,"H"
NA,1997,"Hayes & Yeading","Woking","3-0",3,0,5,5,3,3,"H"
NA,1997,"Hednesford Town","Woking","1-1",1,1,5,5,2,0,"D"
NA,1997,"Hereford United","Woking","2-1",2,1,5,5,3,1,"H"
NA,1997,"Kettering Town","Woking","0-1",0,1,5,5,1,-1,"A"
NA,1997,"Kidderminster Harriers","Woking","1-1",1,1,5,5,2,0,"D"
NA,1997,"Leek Town","Woking","2-0",2,0,5,5,2,2,"H"
NA,1997,"Morecambe","Woking","1-2",1,2,5,5,3,-1,"A"
NA,1997,"Northwich Victoria","Woking","0-2",0,2,5,5,2,-2,"A"
NA,1997,"Rushden & Diamonds","Woking","2-1",2,1,5,5,3,1,"H"
NA,1997,"Slough Town","Woking","1-3",1,3,5,5,4,-2,"A"
NA,1997,"Southport","Woking","0-0",0,0,5,5,0,0,"D"
NA,1997,"Stalybridge Celtic","Woking","0-3",0,3,5,5,3,-3,"A"
NA,1997,"Stevenage Borough","Woking","0-0",0,0,5,5,0,0,"D"
NA,1997,"Telford United","Woking","0-3",0,3,5,5,3,-3,"A"
NA,1997,"Welling United","Woking","1-1",1,1,5,5,2,0,"D"
NA,1997,"Yeovil","Woking","2-0",2,0,5,5,2,2,"H"
NA,1997,"Cheltenham","Yeovil","2-0",2,0,5,5,2,2,"H"
NA,1997,"Dover Athletic","Yeovil","1-0",1,0,5,5,1,1,"H"
NA,1997,"Farnborough Town","Yeovil","2-2",2,2,5,5,4,0,"D"
NA,1997,"Gateshead","Yeovil","0-3",0,3,5,5,3,-3,"A"
NA,1997,"Halifax Town","Yeovil","3-1",3,1,5,5,4,2,"H"
NA,1997,"Hayes & Yeading","Yeovil","6-4",6,4,5,5,10,2,"H"
NA,1997,"Hednesford Town","Yeovil","1-0",1,0,5,5,1,1,"H"
NA,1997,"Hereford United","Yeovil","1-1",1,1,5,5,2,0,"D"
NA,1997,"Kettering Town","Yeovil","1-1",1,1,5,5,2,0,"D"
NA,1997,"Kidderminster Harriers","Yeovil","3-1",3,1,5,5,4,2,"H"
NA,1997,"Leek Town","Yeovil","2-0",2,0,5,5,2,2,"H"
NA,1997,"Morecambe","Yeovil","1-0",1,0,5,5,1,1,"H"
NA,1997,"Northwich Victoria","Yeovil","2-1",2,1,5,5,3,1,"H"
NA,1997,"Rushden & Diamonds","Yeovil","2-2",2,2,5,5,4,0,"D"
NA,1997,"Slough Town","Yeovil","1-1",1,1,5,5,2,0,"D"
NA,1997,"Southport","Yeovil","2-1",2,1,5,5,3,1,"H"
NA,1997,"Stalybridge Celtic","Yeovil","3-2",3,2,5,5,5,1,"H"
NA,1997,"Stevenage Borough","Yeovil","2-1",2,1,5,5,3,1,"H"
NA,1997,"Telford United","Yeovil","1-4",1,4,5,5,5,-3,"A"
NA,1997,"Welling United","Yeovil","1-3",1,3,5,5,4,-2,"A"
NA,1997,"Woking","Yeovil","2-0",2,0,5,5,2,2,"H"
NA,1998,"Cheltenham","Barrow","4-1",4,1,5,5,5,3,"H"
NA,1998,"Doncaster Rovers","Barrow","2-1",2,1,5,5,3,1,"H"
NA,1998,"Dover Athletic","Barrow","1-1",1,1,5,5,2,0,"D"
NA,1998,"Farnborough Town","Barrow","2-2",2,2,5,5,4,0,"D"
NA,1998,"Forest Green Rovers","Barrow","1-1",1,1,5,5,2,0,"D"
NA,1998,"Hayes & Yeading","Barrow","1-0",1,0,5,5,1,1,"H"
NA,1998,"Hednesford Town","Barrow","1-0",1,0,5,5,1,1,"H"
NA,1998,"Hereford United","Barrow","3-0",3,0,5,5,3,3,"H"
NA,1998,"Kettering Town","Barrow","2-0",2,0,5,5,2,2,"H"
NA,1998,"Kidderminster Harriers","Barrow","1-2",1,2,5,5,3,-1,"A"
NA,1998,"Kingstonian","Barrow","5-1",5,1,5,5,6,4,"H"
NA,1998,"Leek Town","Barrow","3-1",3,1,5,5,4,2,"H"
NA,1998,"Morecambe","Barrow","3-2",3,2,5,5,5,1,"H"
NA,1998,"Northwich Victoria","Barrow","1-0",1,0,5,5,1,1,"H"
NA,1998,"Rushden & Diamonds","Barrow","4-0",4,0,5,5,4,4,"H"
NA,1998,"Southport","Barrow","0-4",0,4,5,5,4,-4,"A"
NA,1998,"Stevenage Borough","Barrow","1-2",1,2,5,5,3,-1,"A"
NA,1998,"Telford United","Barrow","1-1",1,1,5,5,2,0,"D"
NA,1998,"Welling United","Barrow","1-1",1,1,5,5,2,0,"D"
NA,1998,"Woking","Barrow","2-3",2,3,5,5,5,-1,"A"
NA,1998,"Yeovil","Barrow","1-0",1,0,5,5,1,1,"H"
NA,1998,"Barrow","Cheltenham","1-1",1,1,5,5,2,0,"D"
NA,1998,"Doncaster Rovers","Cheltenham","2-2",2,2,5,5,4,0,"D"
NA,1998,"Dover Athletic","Cheltenham","0-0",0,0,5,5,0,0,"D"
NA,1998,"Farnborough Town","Cheltenham","2-4",2,4,5,5,6,-2,"A"
NA,1998,"Forest Green Rovers","Cheltenham","1-2",1,2,5,5,3,-1,"A"
NA,1998,"Hayes & Yeading","Cheltenham","3-2",3,2,5,5,5,1,"H"
NA,1998,"Hednesford Town","Cheltenham","3-2",3,2,5,5,5,1,"H"
NA,1998,"Hereford United","Cheltenham","0-2",0,2,5,5,2,-2,"A"
NA,1998,"Kettering Town","Cheltenham","0-2",0,2,5,5,2,-2,"A"
NA,1998,"Kidderminster Harriers","Cheltenham","0-1",0,1,5,5,1,-1,"A"
NA,1998,"Kingstonian","Cheltenham","1-2",1,2,5,5,3,-1,"A"
NA,1998,"Leek Town","Cheltenham","0-2",0,2,5,5,2,-2,"A"
NA,1998,"Morecambe","Cheltenham","0-2",0,2,5,5,2,-2,"A"
NA,1998,"Northwich Victoria","Cheltenham","1-0",1,0,5,5,1,1,"H"
NA,1998,"Rushden & Diamonds","Cheltenham","1-2",1,2,5,5,3,-1,"A"
NA,1998,"Southport","Cheltenham","0-2",0,2,5,5,2,-2,"A"
NA,1998,"Stevenage Borough","Cheltenham","2-2",2,2,5,5,4,0,"D"
NA,1998,"Telford United","Cheltenham","0-3",0,3,5,5,3,-3,"A"
NA,1998,"Welling United","Cheltenham","2-1",2,1,5,5,3,1,"H"
NA,1998,"Woking","Cheltenham","1-0",1,0,5,5,1,1,"H"
NA,1998,"Yeovil","Cheltenham","2-2",2,2,5,5,4,0,"D"
NA,1998,"Barrow","Doncaster Rovers","2-2",2,2,5,5,4,0,"D"
NA,1998,"Cheltenham","Doncaster Rovers","2-1",2,1,5,5,3,1,"H"
NA,1998,"Dover Athletic","Doncaster Rovers","1-0",1,0,5,5,1,1,"H"
NA,1998,"Farnborough Town","Doncaster Rovers","1-0",1,0,5,5,1,1,"H"
NA,1998,"Forest Green Rovers","Doncaster Rovers","0-0",0,0,5,5,0,0,"D"
NA,1998,"Hayes & Yeading","Doncaster Rovers","2-0",2,0,5,5,2,2,"H"
NA,1998,"Hednesford Town","Doncaster Rovers","1-1",1,1,5,5,2,0,"D"
NA,1998,"Hereford United","Doncaster Rovers","1-0",1,0,5,5,1,1,"H"
NA,1998,"Kettering Town","Doncaster Rovers","0-1",0,1,5,5,1,-1,"A"
NA,1998,"Kidderminster Harriers","Doncaster Rovers","3-3",3,3,5,5,6,0,"D"
NA,1998,"Kingstonian","Doncaster Rovers","2-1",2,1,5,5,3,1,"H"
NA,1998,"Leek Town","Doncaster Rovers","1-1",1,1,5,5,2,0,"D"
NA,1998,"Morecambe","Doncaster Rovers","1-2",1,2,5,5,3,-1,"A"
NA,1998,"Northwich Victoria","Doncaster Rovers","1-3",1,3,5,5,4,-2,"A"
NA,1998,"Rushden & Diamonds","Doncaster Rovers","1-3",1,3,5,5,4,-2,"A"
NA,1998,"Southport","Doncaster Rovers","3-2",3,2,5,5,5,1,"H"
NA,1998,"Stevenage Borough","Doncaster Rovers","2-0",2,0,5,5,2,2,"H"
NA,1998,"Telford United","Doncaster Rovers","0-2",0,2,5,5,2,-2,"A"
NA,1998,"Welling United","Doncaster Rovers","1-1",1,1,5,5,2,0,"D"
NA,1998,"Woking","Doncaster Rovers","2-0",2,0,5,5,2,2,"H"
NA,1998,"Yeovil","Doncaster Rovers","2-2",2,2,5,5,4,0,"D"
NA,1998,"Barrow","Dover Athletic","1-0",1,0,5,5,1,1,"H"
NA,1998,"Cheltenham","Dover Athletic","1-1",1,1,5,5,2,0,"D"
NA,1998,"Doncaster Rovers","Dover Athletic","5-4",5,4,5,5,9,1,"H"
NA,1998,"Farnborough Town","Dover Athletic","1-2",1,2,5,5,3,-1,"A"
NA,1998,"Forest Green Rovers","Dover Athletic","0-1",0,1,5,5,1,-1,"A"
NA,1998,"Hayes & Yeading","Dover Athletic","1-2",1,2,5,5,3,-1,"A"
NA,1998,"Hednesford Town","Dover Athletic","1-2",1,2,5,5,3,-1,"A"
NA,1998,"Hereford United","Dover Athletic","2-0",2,0,5,5,2,2,"H"
NA,1998,"Kettering Town","Dover Athletic","0-2",0,2,5,5,2,-2,"A"
NA,1998,"Kidderminster Harriers","Dover Athletic","1-0",1,0,5,5,1,1,"H"
NA,1998,"Kingstonian","Dover Athletic","1-0",1,0,5,5,1,1,"H"
NA,1998,"Leek Town","Dover Athletic","2-0",2,0,5,5,2,2,"H"
NA,1998,"Morecambe","Dover Athletic","0-4",0,4,5,5,4,-4,"A"
NA,1998,"Northwich Victoria","Dover Athletic","2-0",2,0,5,5,2,2,"H"
NA,1998,"Rushden & Diamonds","Dover Athletic","2-2",2,2,5,5,4,0,"D"
NA,1998,"Southport","Dover Athletic","3-0",3,0,5,5,3,3,"H"
NA,1998,"Stevenage Borough","Dover Athletic","1-0",1,0,5,5,1,1,"H"
NA,1998,"Telford United","Dover Athletic","1-1",1,1,5,5,2,0,"D"
NA,1998,"Welling United","Dover Athletic","0-3",0,3,5,5,3,-3,"A"
NA,1998,"Woking","Dover Athletic","1-2",1,2,5,5,3,-1,"A"
NA,1998,"Yeovil","Dover Athletic","1-1",1,1,5,5,2,0,"D"
NA,1998,"Barrow","Farnborough Town","1-0",1,0,5,5,1,1,"H"
NA,1998,"Cheltenham","Farnborough Town","0-0",0,0,5,5,0,0,"D"
NA,1998,"Doncaster Rovers","Farnborough Town","1-2",1,2,5,5,3,-1,"A"
NA,1998,"Dover Athletic","Farnborough Town","2-1",2,1,5,5,3,1,"H"
NA,1998,"Forest Green Rovers","Farnborough Town","0-0",0,0,5,5,0,0,"D"
NA,1998,"Hayes & Yeading","Farnborough Town","1-0",1,0,5,5,1,1,"H"
NA,1998,"Hednesford Town","Farnborough Town","0-0",0,0,5,5,0,0,"D"
NA,1998,"Hereford United","Farnborough Town","2-0",2,0,5,5,2,2,"H"
NA,1998,"Kettering Town","Farnborough Town","4-1",4,1,5,5,5,3,"H"
NA,1998,"Kidderminster Harriers","Farnborough Town","2-0",2,0,5,5,2,2,"H"
NA,1998,"Kingstonian","Farnborough Town","1-1",1,1,5,5,2,0,"D"
NA,1998,"Leek Town","Farnborough Town","4-0",4,0,5,5,4,4,"H"
NA,1998,"Morecambe","Farnborough Town","1-0",1,0,5,5,1,1,"H"
NA,1998,"Northwich Victoria","Farnborough Town","3-0",3,0,5,5,3,3,"H"
NA,1998,"Rushden & Diamonds","Farnborough Town","1-0",1,0,5,5,1,1,"H"
NA,1998,"Southport","Farnborough Town","2-2",2,2,5,5,4,0,"D"
NA,1998,"Stevenage Borough","Farnborough Town","3-1",3,1,5,5,4,2,"H"
NA,1998,"Telford United","Farnborough Town","3-1",3,1,5,5,4,2,"H"
NA,1998,"Welling United","Farnborough Town","0-0",0,0,5,5,0,0,"D"
NA,1998,"Woking","Farnborough Town","4-0",4,0,5,5,4,4,"H"
NA,1998,"Yeovil","Farnborough Town","6-3",6,3,5,5,9,3,"H"
NA,1998,"Barrow","Forest Green Rovers","2-1",2,1,5,5,3,1,"H"
NA,1998,"Cheltenham","Forest Green Rovers","1-1",1,1,5,5,2,0,"D"
NA,1998,"Doncaster Rovers","Forest Green Rovers","0-1",0,1,5,5,1,-1,"A"
NA,1998,"Dover Athletic","Forest Green Rovers","1-1",1,1,5,5,2,0,"D"
NA,1998,"Farnborough Town","Forest Green Rovers","2-2",2,2,5,5,4,0,"D"
NA,1998,"Hayes & Yeading","Forest Green Rovers","0-3",0,3,5,5,3,-3,"A"
NA,1998,"Hednesford Town","Forest Green Rovers","1-1",1,1,5,5,2,0,"D"
NA,1998,"Hereford United","Forest Green Rovers","4-0",4,0,5,5,4,4,"H"
NA,1998,"Kettering Town","Forest Green Rovers","2-1",2,1,5,5,3,1,"H"
NA,1998,"Kidderminster Harriers","Forest Green Rovers","2-2",2,2,5,5,4,0,"D"
NA,1998,"Kingstonian","Forest Green Rovers","0-1",0,1,5,5,1,-1,"A"
NA,1998,"Leek Town","Forest Green Rovers","0-2",0,2,5,5,2,-2,"A"
NA,1998,"Morecambe","Forest Green Rovers","3-1",3,1,5,5,4,2,"H"
NA,1998,"Northwich Victoria","Forest Green Rovers","1-0",1,0,5,5,1,1,"H"
NA,1998,"Rushden & Diamonds","Forest Green Rovers","4-0",4,0,5,5,4,4,"H"
NA,1998,"Southport","Forest Green Rovers","1-1",1,1,5,5,2,0,"D"
NA,1998,"Stevenage Borough","Forest Green Rovers","1-1",1,1,5,5,2,0,"D"
NA,1998,"Telford United","Forest Green Rovers","2-1",2,1,5,5,3,1,"H"
NA,1998,"Welling United","Forest Green Rovers","0-2",0,2,5,5,2,-2,"A"
NA,1998,"Woking","Forest Green Rovers","1-1",1,1,5,5,2,0,"D"
NA,1998,"Yeovil","Forest Green Rovers","0-4",0,4,5,5,4,-4,"A"
NA,1998,"Barrow","Hayes & Yeading","0-1",0,1,5,5,1,-1,"A"
NA,1998,"Cheltenham","Hayes & Yeading","3-3",3,3,5,5,6,0,"D"
NA,1998,"Doncaster Rovers","Hayes & Yeading","0-1",0,1,5,5,1,-1,"A"
NA,1998,"Dover Athletic","Hayes & Yeading","0-0",0,0,5,5,0,0,"D"
NA,1998,"Farnborough Town","Hayes & Yeading","1-5",1,5,5,5,6,-4,"A"
NA,1998,"Forest Green Rovers","Hayes & Yeading","1-2",1,2,5,5,3,-1,"A"
NA,1998,"Hednesford Town","Hayes & Yeading","0-0",0,0,5,5,0,0,"D"
NA,1998,"Hereford United","Hayes & Yeading","0-1",0,1,5,5,1,-1,"A"
NA,1998,"Kettering Town","Hayes & Yeading","1-0",1,0,5,5,1,1,"H"
NA,1998,"Kidderminster Harriers","Hayes & Yeading","0-1",0,1,5,5,1,-1,"A"
NA,1998,"Kingstonian","Hayes & Yeading","1-1",1,1,5,5,2,0,"D"
NA,1998,"Leek Town","Hayes & Yeading","1-4",1,4,5,5,5,-3,"A"
NA,1998,"Morecambe","Hayes & Yeading","2-3",2,3,5,5,5,-1,"A"
NA,1998,"Northwich Victoria","Hayes & Yeading","2-1",2,1,5,5,3,1,"H"
NA,1998,"Rushden & Diamonds","Hayes & Yeading","5-0",5,0,5,5,5,5,"H"
NA,1998,"Southport","Hayes & Yeading","1-2",1,2,5,5,3,-1,"A"
NA,1998,"Stevenage Borough","Hayes & Yeading","2-1",2,1,5,5,3,1,"H"
NA,1998,"Telford United","Hayes & Yeading","2-0",2,0,5,5,2,2,"H"
NA,1998,"Welling United","Hayes & Yeading","0-2",0,2,5,5,2,-2,"A"
NA,1998,"Woking","Hayes & Yeading","2-0",2,0,5,5,2,2,"H"
NA,1998,"Yeovil","Hayes & Yeading","1-1",1,1,5,5,2,0,"D"
NA,1998,"Barrow","Hednesford Town","0-2",0,2,5,5,2,-2,"A"
NA,1998,"Cheltenham","Hednesford Town","0-0",0,0,5,5,0,0,"D"
NA,1998,"Doncaster Rovers","Hednesford Town","0-1",0,1,5,5,1,-1,"A"
NA,1998,"Dover Athletic","Hednesford Town","0-0",0,0,5,5,0,0,"D"
NA,1998,"Farnborough Town","Hednesford Town","0-1",0,1,5,5,1,-1,"A"
NA,1998,"Forest Green Rovers","Hednesford Town","1-0",1,0,5,5,1,1,"H"
NA,1998,"Hayes & Yeading","Hednesford Town","1-0",1,0,5,5,1,1,"H"
NA,1998,"Hereford United","Hednesford Town","0-0",0,0,5,5,0,0,"D"
NA,1998,"Kettering Town","Hednesford Town","1-0",1,0,5,5,1,1,"H"
NA,1998,"Kidderminster Harriers","Hednesford Town","1-2",1,2,5,5,3,-1,"A"
NA,1998,"Kingstonian","Hednesford Town","1-1",1,1,5,5,2,0,"D"
NA,1998,"Leek Town","Hednesford Town","1-3",1,3,5,5,4,-2,"A"
NA,1998,"Morecambe","Hednesford Town","3-1",3,1,5,5,4,2,"H"
NA,1998,"Northwich Victoria","Hednesford Town","1-1",1,1,5,5,2,0,"D"
NA,1998,"Rushden & Diamonds","Hednesford Town","1-0",1,0,5,5,1,1,"H"
NA,1998,"Southport","Hednesford Town","1-1",1,1,5,5,2,0,"D"
NA,1998,"Stevenage Borough","Hednesford Town","3-1",3,1,5,5,4,2,"H"
NA,1998,"Telford United","Hednesford Town","1-1",1,1,5,5,2,0,"D"
NA,1998,"Welling United","Hednesford Town","1-1",1,1,5,5,2,0,"D"
NA,1998,"Woking","Hednesford Town","2-1",2,1,5,5,3,1,"H"
NA,1998,"Yeovil","Hednesford Town","1-2",1,2,5,5,3,-1,"A"
NA,1998,"Barrow","Hereford United","0-1",0,1,5,5,1,-1,"A"
NA,1998,"Cheltenham","Hereford United","2-2",2,2,5,5,4,0,"D"
NA,1998,"Doncaster Rovers","Hereford United","3-1",3,1,5,5,4,2,"H"
NA,1998,"Dover Athletic","Hereford United","3-1",3,1,5,5,4,2,"H"
NA,1998,"Farnborough Town","Hereford United","0-4",0,4,5,5,4,-4,"A"
NA,1998,"Forest Green Rovers","Hereford United","2-1",2,1,5,5,3,1,"H"
NA,1998,"Hayes & Yeading","Hereford United","1-2",1,2,5,5,3,-1,"A"
NA,1998,"Hednesford Town","Hereford United","3-1",3,1,5,5,4,2,"H"
NA,1998,"Kettering Town","Hereford United","1-1",1,1,5,5,2,0,"D"
NA,1998,"Kidderminster Harriers","Hereford United","1-0",1,0,5,5,1,1,"H"
NA,1998,"Kingstonian","Hereford United","2-0",2,0,5,5,2,2,"H"
NA,1998,"Leek Town","Hereford United","3-2",3,2,5,5,5,1,"H"
NA,1998,"Morecambe","Hereford United","1-0",1,0,5,5,1,1,"H"
NA,1998,"Northwich Victoria","Hereford United","1-0",1,0,5,5,1,1,"H"
NA,1998,"Rushden & Diamonds","Hereford United","1-1",1,1,5,5,2,0,"D"
NA,1998,"Southport","Hereford United","0-0",0,0,5,5,0,0,"D"
NA,1998,"Stevenage Borough","Hereford United","0-3",0,3,5,5,3,-3,"A"
NA,1998,"Telford United","Hereford United","0-1",0,1,5,5,1,-1,"A"
NA,1998,"Welling United","Hereford United","2-2",2,2,5,5,4,0,"D"
NA,1998,"Woking","Hereford United","0-1",0,1,5,5,1,-1,"A"
NA,1998,"Yeovil","Hereford United","3-0",3,0,5,5,3,3,"H"
NA,1998,"Barrow","Kettering Town","0-0",0,0,5,5,0,0,"D"
NA,1998,"Cheltenham","Kettering Town","3-0",3,0,5,5,3,3,"H"
NA,1998,"Doncaster Rovers","Kettering Town","1-1",1,1,5,5,2,0,"D"
NA,1998,"Dover Athletic","Kettering Town","0-1",0,1,5,5,1,-1,"A"
NA,1998,"Farnborough Town","Kettering Town","1-3",1,3,5,5,4,-2,"A"
NA,1998,"Forest Green Rovers","Kettering Town","1-0",1,0,5,5,1,1,"H"
NA,1998,"Hayes & Yeading","Kettering Town","0-2",0,2,5,5,2,-2,"A"
NA,1998,"Hednesford Town","Kettering Town","0-2",0,2,5,5,2,-2,"A"
NA,1998,"Hereford United","Kettering Town","0-2",0,2,5,5,2,-2,"A"
NA,1998,"Kidderminster Harriers","Kettering Town","1-1",1,1,5,5,2,0,"D"
NA,1998,"Kingstonian","Kettering Town","1-2",1,2,5,5,3,-1,"A"
NA,1998,"Leek Town","Kettering Town","1-2",1,2,5,5,3,-1,"A"
NA,1998,"Morecambe","Kettering Town","3-1",3,1,5,5,4,2,"H"
NA,1998,"Northwich Victoria","Kettering Town","4-0",4,0,5,5,4,4,"H"
NA,1998,"Rushden & Diamonds","Kettering Town","1-2",1,2,5,5,3,-1,"A"
NA,1998,"Southport","Kettering Town","0-1",0,1,5,5,1,-1,"A"
NA,1998,"Stevenage Borough","Kettering Town","2-2",2,2,5,5,4,0,"D"
NA,1998,"Telford United","Kettering Town","0-2",0,2,5,5,2,-2,"A"
NA,1998,"Welling United","Kettering Town","0-2",0,2,5,5,2,-2,"A"
NA,1998,"Woking","Kettering Town","0-0",0,0,5,5,0,0,"D"
NA,1998,"Yeovil","Kettering Town","2-1",2,1,5,5,3,1,"H"
NA,1998,"Barrow","Kidderminster Harriers","0-4",0,4,5,5,4,-4,"A"
NA,1998,"Cheltenham","Kidderminster Harriers","1-0",1,0,5,5,1,1,"H"
NA,1998,"Doncaster Rovers","Kidderminster Harriers","1-0",1,0,5,5,1,1,"H"
NA,1998,"Dover Athletic","Kidderminster Harriers","0-1",0,1,5,5,1,-1,"A"
NA,1998,"Farnborough Town","Kidderminster Harriers","2-4",2,4,5,5,6,-2,"A"
NA,1998,"Forest Green Rovers","Kidderminster Harriers","5-0",5,0,5,5,5,5,"H"
NA,1998,"Hayes & Yeading","Kidderminster Harriers","2-1",2,1,5,5,3,1,"H"
NA,1998,"Hednesford Town","Kidderminster Harriers","2-1",2,1,5,5,3,1,"H"
NA,1998,"Hereford United","Kidderminster Harriers","1-3",1,3,5,5,4,-2,"A"
NA,1998,"Kettering Town","Kidderminster Harriers","1-1",1,1,5,5,2,0,"D"
NA,1998,"Kingstonian","Kidderminster Harriers","1-0",1,0,5,5,1,1,"H"
NA,1998,"Leek Town","Kidderminster Harriers","1-4",1,4,5,5,5,-3,"A"
NA,1998,"Morecambe","Kidderminster Harriers","2-1",2,1,5,5,3,1,"H"
NA,1998,"Northwich Victoria","Kidderminster Harriers","1-0",1,0,5,5,1,1,"H"
NA,1998,"Rushden & Diamonds","Kidderminster Harriers","1-1",1,1,5,5,2,0,"D"
NA,1998,"Southport","Kidderminster Harriers","1-1",1,1,5,5,2,0,"D"
NA,1998,"Stevenage Borough","Kidderminster Harriers","3-0",3,0,5,5,3,3,"H"
NA,1998,"Telford United","Kidderminster Harriers","0-0",0,0,5,5,0,0,"D"
NA,1998,"Welling United","Kidderminster Harriers","0-0",0,0,5,5,0,0,"D"
NA,1998,"Woking","Kidderminster Harriers","2-1",2,1,5,5,3,1,"H"
NA,1998,"Yeovil","Kidderminster Harriers","3-1",3,1,5,5,4,2,"H"
NA,1998,"Barrow","Kingstonian","0-1",0,1,5,5,1,-1,"A"
NA,1998,"Cheltenham","Kingstonian","1-0",1,0,5,5,1,1,"H"
NA,1998,"Doncaster Rovers","Kingstonian","0-1",0,1,5,5,1,-1,"A"
NA,1998,"Dover Athletic","Kingstonian","5-1",5,1,5,5,6,4,"H"
NA,1998,"Farnborough Town","Kingstonian","4-2",4,2,5,5,6,2,"H"
NA,1998,"Forest Green Rovers","Kingstonian","1-0",1,0,5,5,1,1,"H"
NA,1998,"Hayes & Yeading","Kingstonian","3-0",3,0,5,5,3,3,"H"
NA,1998,"Hednesford Town","Kingstonian","1-2",1,2,5,5,3,-1,"A"
NA,1998,"Hereford United","Kingstonian","2-0",2,0,5,5,2,2,"H"
NA,1998,"Kettering Town","Kingstonian","2-0",2,0,5,5,2,2,"H"
NA,1998,"Kidderminster Harriers","Kingstonian","0-1",0,1,5,5,1,-1,"A"
NA,1998,"Leek Town","Kingstonian","2-2",2,2,5,5,4,0,"D"
NA,1998,"Morecambe","Kingstonian","0-0",0,0,5,5,0,0,"D"
NA,1998,"Northwich Victoria","Kingstonian","2-3",2,3,5,5,5,-1,"A"
NA,1998,"Rushden & Diamonds","Kingstonian","0-0",0,0,5,5,0,0,"D"
NA,1998,"Southport","Kingstonian","1-1",1,1,5,5,2,0,"D"
NA,1998,"Stevenage Borough","Kingstonian","3-3",3,3,5,5,6,0,"D"
NA,1998,"Telford United","Kingstonian","1-1",1,1,5,5,2,0,"D"
NA,1998,"Welling United","Kingstonian","1-3",1,3,5,5,4,-2,"A"
NA,1998,"Woking","Kingstonian","0-1",0,1,5,5,1,-1,"A"
NA,1998,"Yeovil","Kingstonian","1-3",1,3,5,5,4,-2,"A"
NA,1998,"Barrow","Leek Town","2-1",2,1,5,5,3,1,"H"
NA,1998,"Cheltenham","Leek Town","0-0",0,0,5,5,0,0,"D"
NA,1998,"Doncaster Rovers","Leek Town","0-1",0,1,5,5,1,-1,"A"
NA,1998,"Dover Athletic","Leek Town","2-1",2,1,5,5,3,1,"H"
NA,1998,"Farnborough Town","Leek Town","2-1",2,1,5,5,3,1,"H"
NA,1998,"Forest Green Rovers","Leek Town","3-1",3,1,5,5,4,2,"H"
NA,1998,"Hayes & Yeading","Leek Town","2-0",2,0,5,5,2,2,"H"
NA,1998,"Hednesford Town","Leek Town","1-1",1,1,5,5,2,0,"D"
NA,1998,"Hereford United","Leek Town","1-0",1,0,5,5,1,1,"H"
NA,1998,"Kettering Town","Leek Town","2-1",2,1,5,5,3,1,"H"
NA,1998,"Kidderminster Harriers","Leek Town","1-2",1,2,5,5,3,-1,"A"
NA,1998,"Kingstonian","Leek Town","3-0",3,0,5,5,3,3,"H"
NA,1998,"Morecambe","Leek Town","2-2",2,2,5,5,4,0,"D"
NA,1998,"Northwich Victoria","Leek Town","0-2",0,2,5,5,2,-2,"A"
NA,1998,"Rushden & Diamonds","Leek Town","2-0",2,0,5,5,2,2,"H"
NA,1998,"Southport","Leek Town","3-1",3,1,5,5,4,2,"H"
NA,1998,"Stevenage Borough","Leek Town","2-0",2,0,5,5,2,2,"H"
NA,1998,"Telford United","Leek Town","2-0",2,0,5,5,2,2,"H"
NA,1998,"Welling United","Leek Town","1-0",1,0,5,5,1,1,"H"
NA,1998,"Woking","Leek Town","1-0",1,0,5,5,1,1,"H"
NA,1998,"Yeovil","Leek Town","2-0",2,0,5,5,2,2,"H"
NA,1998,"Barrow","Morecambe","2-1",2,1,5,5,3,1,"H"
NA,1998,"Cheltenham","Morecambe","4-1",4,1,5,5,5,3,"H"
NA,1998,"Doncaster Rovers","Morecambe","2-1",2,1,5,5,3,1,"H"
NA,1998,"Dover Athletic","Morecambe","2-3",2,3,5,5,5,-1,"A"
NA,1998,"Farnborough Town","Morecambe","1-6",1,6,5,5,7,-5,"A"
NA,1998,"Forest Green Rovers","Morecambe","2-2",2,2,5,5,4,0,"D"
NA,1998,"Hayes & Yeading","Morecambe","1-2",1,2,5,5,3,-1,"A"
NA,1998,"Hednesford Town","Morecambe","1-0",1,0,5,5,1,1,"H"
NA,1998,"Hereford United","Morecambe","2-0",2,0,5,5,2,2,"H"
NA,1998,"Kettering Town","Morecambe","6-0",6,0,5,5,6,6,"H"
NA,1998,"Kidderminster Harriers","Morecambe","5-2",5,2,5,5,7,3,"H"
NA,1998,"Kingstonian","Morecambe","0-0",0,0,5,5,0,0,"D"
NA,1998,"Leek Town","Morecambe","7-0",7,0,5,5,7,7,"H"
NA,1998,"Northwich Victoria","Morecambe","1-1",1,1,5,5,2,0,"D"
NA,1998,"Rushden & Diamonds","Morecambe","3-1",3,1,5,5,4,2,"H"
NA,1998,"Southport","Morecambe","1-0",1,0,5,5,1,1,"H"
NA,1998,"Stevenage Borough","Morecambe","2-0",2,0,5,5,2,2,"H"
NA,1998,"Telford United","Morecambe","2-3",2,3,5,5,5,-1,"A"
NA,1998,"Welling United","Morecambe","3-2",3,2,5,5,5,1,"H"
NA,1998,"Woking","Morecambe","0-3",0,3,5,5,3,-3,"A"
NA,1998,"Yeovil","Morecambe","0-1",0,1,5,5,1,-1,"A"
NA,1998,"Barrow","Northwich Victoria","0-1",0,1,5,5,1,-1,"A"
NA,1998,"Cheltenham","Northwich Victoria","0-1",0,1,5,5,1,-1,"A"
NA,1998,"Doncaster Rovers","Northwich Victoria","2-2",2,2,5,5,4,0,"D"
NA,1998,"Dover Athletic","Northwich Victoria","0-0",0,0,5,5,0,0,"D"
NA,1998,"Farnborough Town","Northwich Victoria","1-6",1,6,5,5,7,-5,"A"
NA,1998,"Forest Green Rovers","Northwich Victoria","3-1",3,1,5,5,4,2,"H"
NA,1998,"Hayes & Yeading","Northwich Victoria","1-0",1,0,5,5,1,1,"H"
NA,1998,"Hednesford Town","Northwich Victoria","1-0",1,0,5,5,1,1,"H"
NA,1998,"Hereford United","Northwich Victoria","2-2",2,2,5,5,4,0,"D"
NA,1998,"Kettering Town","Northwich Victoria","0-0",0,0,5,5,0,0,"D"
NA,1998,"Kidderminster Harriers","Northwich Victoria","4-0",4,0,5,5,4,4,"H"
NA,1998,"Kingstonian","Northwich Victoria","1-1",1,1,5,5,2,0,"D"
NA,1998,"Leek Town","Northwich Victoria","0-3",0,3,5,5,3,-3,"A"
NA,1998,"Morecambe","Northwich Victoria","3-1",3,1,5,5,4,2,"H"
NA,1998,"Rushden & Diamonds","Northwich Victoria","1-2",1,2,5,5,3,-1,"A"
NA,1998,"Southport","Northwich Victoria","2-2",2,2,5,5,4,0,"D"
NA,1998,"Stevenage Borough","Northwich Victoria","1-3",1,3,5,5,4,-2,"A"
NA,1998,"Telford United","Northwich Victoria","3-0",3,0,5,5,3,3,"H"
NA,1998,"Welling United","Northwich Victoria","2-3",2,3,5,5,5,-1,"A"
NA,1998,"Woking","Northwich Victoria","2-1",2,1,5,5,3,1,"H"
NA,1998,"Yeovil","Northwich Victoria","1-2",1,2,5,5,3,-1,"A"
NA,1998,"Barrow","Rushden & Diamonds","0-2",0,2,5,5,2,-2,"A"
NA,1998,"Cheltenham","Rushden & Diamonds","1-0",1,0,5,5,1,1,"H"
NA,1998,"Doncaster Rovers","Rushden & Diamonds","1-1",1,1,5,5,2,0,"D"
NA,1998,"Dover Athletic","Rushden & Diamonds","1-1",1,1,5,5,2,0,"D"
NA,1998,"Farnborough Town","Rushden & Diamonds","1-2",1,2,5,5,3,-1,"A"
NA,1998,"Forest Green Rovers","Rushden & Diamonds","0-2",0,2,5,5,2,-2,"A"
NA,1998,"Hayes & Yeading","Rushden & Diamonds","2-1",2,1,5,5,3,1,"H"
NA,1998,"Hednesford Town","Rushden & Diamonds","1-1",1,1,5,5,2,0,"D"
NA,1998,"Hereford United","Rushden & Diamonds","3-2",3,2,5,5,5,1,"H"
NA,1998,"Kettering Town","Rushden & Diamonds","0-0",0,0,5,5,0,0,"D"
NA,1998,"Kidderminster Harriers","Rushden & Diamonds","0-0",0,0,5,5,0,0,"D"
NA,1998,"Kingstonian","Rushden & Diamonds","1-5",1,5,5,5,6,-4,"A"
NA,1998,"Leek Town","Rushden & Diamonds","2-3",2,3,5,5,5,-1,"A"
NA,1998,"Morecambe","Rushden & Diamonds","2-3",2,3,5,5,5,-1,"A"
NA,1998,"Northwich Victoria","Rushden & Diamonds","2-1",2,1,5,5,3,1,"H"
NA,1998,"Southport","Rushden & Diamonds","0-1",0,1,5,5,1,-1,"A"
NA,1998,"Stevenage Borough","Rushden & Diamonds","0-0",0,0,5,5,0,0,"D"
NA,1998,"Telford United","Rushden & Diamonds","2-2",2,2,5,5,4,0,"D"
NA,1998,"Welling United","Rushden & Diamonds","0-1",0,1,5,5,1,-1,"A"
NA,1998,"Woking","Rushden & Diamonds","1-1",1,1,5,5,2,0,"D"
NA,1998,"Yeovil","Rushden & Diamonds","0-1",0,1,5,5,1,-1,"A"
NA,1998,"Barrow","Southport","0-0",0,0,5,5,0,0,"D"
NA,1998,"Cheltenham","Southport","3-0",3,0,5,5,3,3,"H"
NA,1998,"Doncaster Rovers","Southport","0-1",0,1,5,5,1,-1,"A"
NA,1998,"Dover Athletic","Southport","2-1",2,1,5,5,3,1,"H"
NA,1998,"Farnborough Town","Southport","1-1",1,1,5,5,2,0,"D"
NA,1998,"Forest Green Rovers","Southport","1-0",1,0,5,5,1,1,"H"
NA,1998,"Hayes & Yeading","Southport","3-0",3,0,5,5,3,3,"H"
NA,1998,"Hednesford Town","Southport","3-1",3,1,5,5,4,2,"H"
NA,1998,"Hereford United","Southport","2-2",2,2,5,5,4,0,"D"
NA,1998,"Kettering Town","Southport","1-0",1,0,5,5,1,1,"H"
NA,1998,"Kidderminster Harriers","Southport","2-1",2,1,5,5,3,1,"H"
NA,1998,"Kingstonian","Southport","0-2",0,2,5,5,2,-2,"A"
NA,1998,"Leek Town","Southport","0-0",0,0,5,5,0,0,"D"
NA,1998,"Morecambe","Southport","1-1",1,1,5,5,2,0,"D"
NA,1998,"Northwich Victoria","Southport","1-2",1,2,5,5,3,-1,"A"
NA,1998,"Rushden & Diamonds","Southport","3-1",3,1,5,5,4,2,"H"
NA,1998,"Stevenage Borough","Southport","0-0",0,0,5,5,0,0,"D"
NA,1998,"Telford United","Southport","1-0",1,0,5,5,1,1,"H"
NA,1998,"Welling United","Southport","2-1",2,1,5,5,3,1,"H"
NA,1998,"Woking","Southport","2-3",2,3,5,5,5,-1,"A"
NA,1998,"Yeovil","Southport","3-1",3,1,5,5,4,2,"H"
NA,1998,"Barrow","Stevenage Borough","0-1",0,1,5,5,1,-1,"A"
NA,1998,"Cheltenham","Stevenage Borough","3-0",3,0,5,5,3,3,"H"
NA,1998,"Doncaster Rovers","Stevenage Borough","0-0",0,0,5,5,0,0,"D"
NA,1998,"Dover Athletic","Stevenage Borough","1-1",1,1,5,5,2,0,"D"
NA,1998,"Farnborough Town","Stevenage Borough","1-0",1,0,5,5,1,1,"H"
NA,1998,"Forest Green Rovers","Stevenage Borough","1-2",1,2,5,5,3,-1,"A"
NA,1998,"Hayes & Yeading","Stevenage Borough","2-2",2,2,5,5,4,0,"D"
NA,1998,"Hednesford Town","Stevenage Borough","2-2",2,2,5,5,4,0,"D"
NA,1998,"Hereford United","Stevenage Borough","0-1",0,1,5,5,1,-1,"A"
NA,1998,"Kettering Town","Stevenage Borough","1-2",1,2,5,5,3,-1,"A"
NA,1998,"Kidderminster Harriers","Stevenage Borough","2-0",2,0,5,5,2,2,"H"
NA,1998,"Kingstonian","Stevenage Borough","1-0",1,0,5,5,1,1,"H"
NA,1998,"Leek Town","Stevenage Borough","1-1",1,1,5,5,2,0,"D"
NA,1998,"Morecambe","Stevenage Borough","1-1",1,1,5,5,2,0,"D"
NA,1998,"Northwich Victoria","Stevenage Borough","0-1",0,1,5,5,1,-1,"A"
NA,1998,"Rushden & Diamonds","Stevenage Borough","2-1",2,1,5,5,3,1,"H"
NA,1998,"Southport","Stevenage Borough","1-1",1,1,5,5,2,0,"D"
NA,1998,"Telford United","Stevenage Borough","0-3",0,3,5,5,3,-3,"A"
NA,1998,"Welling United","Stevenage Borough","1-1",1,1,5,5,2,0,"D"
NA,1998,"Woking","Stevenage Borough","1-2",1,2,5,5,3,-1,"A"
NA,1998,"Yeovil","Stevenage Borough","1-3",1,3,5,5,4,-2,"A"
NA,1998,"Barrow","Telford United","1-1",1,1,5,5,2,0,"D"
NA,1998,"Cheltenham","Telford United","2-0",2,0,5,5,2,2,"H"
NA,1998,"Doncaster Rovers","Telford United","2-1",2,1,5,5,3,1,"H"
NA,1998,"Dover Athletic","Telford United","1-1",1,1,5,5,2,0,"D"
NA,1998,"Farnborough Town","Telford United","3-1",3,1,5,5,4,2,"H"
NA,1998,"Forest Green Rovers","Telford United","1-1",1,1,5,5,2,0,"D"
NA,1998,"Hayes & Yeading","Telford United","4-3",4,3,5,5,7,1,"H"
NA,1998,"Hednesford Town","Telford United","1-1",1,1,5,5,2,0,"D"
NA,1998,"Hereford United","Telford United","0-0",0,0,5,5,0,0,"D"
NA,1998,"Kettering Town","Telford United","2-1",2,1,5,5,3,1,"H"
NA,1998,"Kidderminster Harriers","Telford United","3-0",3,0,5,5,3,3,"H"
NA,1998,"Kingstonian","Telford United","1-0",1,0,5,5,1,1,"H"
NA,1998,"Leek Town","Telford United","1-1",1,1,5,5,2,0,"D"
NA,1998,"Morecambe","Telford United","0-1",0,1,5,5,1,-1,"A"
NA,1998,"Northwich Victoria","Telford United","1-1",1,1,5,5,2,0,"D"
NA,1998,"Rushden & Diamonds","Telford United","2-3",2,3,5,5,5,-1,"A"
NA,1998,"Southport","Telford United","2-1",2,1,5,5,3,1,"H"
NA,1998,"Stevenage Borough","Telford United","2-2",2,2,5,5,4,0,"D"
NA,1998,"Welling United","Telford United","0-1",0,1,5,5,1,-1,"A"
NA,1998,"Woking","Telford United","3-0",3,0,5,5,3,3,"H"
NA,1998,"Yeovil","Telford United","4-0",4,0,5,5,4,4,"H"
NA,1998,"Barrow","Welling United","2-1",2,1,5,5,3,1,"H"
NA,1998,"Cheltenham","Welling United","0-0",0,0,5,5,0,0,"D"
NA,1998,"Doncaster Rovers","Welling United","4-1",4,1,5,5,5,3,"H"
NA,1998,"Dover Athletic","Welling United","1-2",1,2,5,5,3,-1,"A"
NA,1998,"Farnborough Town","Welling United","1-1",1,1,5,5,2,0,"D"
NA,1998,"Forest Green Rovers","Welling United","3-2",3,2,5,5,5,1,"H"
NA,1998,"Hayes & Yeading","Welling United","1-2",1,2,5,5,3,-1,"A"
NA,1998,"Hednesford Town","Welling United","3-2",3,2,5,5,5,1,"H"
NA,1998,"Hereford United","Welling United","0-0",0,0,5,5,0,0,"D"
NA,1998,"Kettering Town","Welling United","1-1",1,1,5,5,2,0,"D"
NA,1998,"Kidderminster Harriers","Welling United","0-1",0,1,5,5,1,-1,"A"
NA,1998,"Kingstonian","Welling United","2-1",2,1,5,5,3,1,"H"
NA,1998,"Leek Town","Welling United","2-4",2,4,5,5,6,-2,"A"
NA,1998,"Morecambe","Welling United","2-1",2,1,5,5,3,1,"H"
NA,1998,"Northwich Victoria","Welling United","3-0",3,0,5,5,3,3,"H"
NA,1998,"Rushden & Diamonds","Welling United","3-1",3,1,5,5,4,2,"H"
NA,1998,"Southport","Welling United","5-2",5,2,5,5,7,3,"H"
NA,1998,"Stevenage Borough","Welling United","1-1",1,1,5,5,2,0,"D"
NA,1998,"Telford United","Welling United","0-0",0,0,5,5,0,0,"D"
NA,1998,"Woking","Welling United","0-0",0,0,5,5,0,0,"D"
NA,1998,"Yeovil","Welling United","1-3",1,3,5,5,4,-2,"A"
NA,1998,"Barrow","Woking","1-2",1,2,5,5,3,-1,"A"
NA,1998,"Cheltenham","Woking","1-1",1,1,5,5,2,0,"D"
NA,1998,"Doncaster Rovers","Woking","0-1",0,1,5,5,1,-1,"A"
NA,1998,"Dover Athletic","Woking","3-2",3,2,5,5,5,1,"H"
NA,1998,"Farnborough Town","Woking","2-1",2,1,5,5,3,1,"H"
NA,1998,"Forest Green Rovers","Woking","0-2",0,2,5,5,2,-2,"A"
NA,1998,"Hayes & Yeading","Woking","2-2",2,2,5,5,4,0,"D"
NA,1998,"Hednesford Town","Woking","2-1",2,1,5,5,3,1,"H"
NA,1998,"Hereford United","Woking","0-1",0,1,5,5,1,-1,"A"
NA,1998,"Kettering Town","Woking","3-0",3,0,5,5,3,3,"H"
NA,1998,"Kidderminster Harriers","Woking","3-2",3,2,5,5,5,1,"H"
NA,1998,"Kingstonian","Woking","0-0",0,0,5,5,0,0,"D"
NA,1998,"Leek Town","Woking","0-3",0,3,5,5,3,-3,"A"
NA,1998,"Morecambe","Woking","0-1",0,1,5,5,1,-1,"A"
NA,1998,"Northwich Victoria","Woking","0-3",0,3,5,5,3,-3,"A"
NA,1998,"Rushden & Diamonds","Woking","2-0",2,0,5,5,2,2,"H"
NA,1998,"Southport","Woking","0-0",0,0,5,5,0,0,"D"
NA,1998,"Stevenage Borough","Woking","5-0",5,0,5,5,5,5,"H"
NA,1998,"Telford United","Woking","1-0",1,0,5,5,1,1,"H"
NA,1998,"Welling United","Woking","0-1",0,1,5,5,1,-1,"A"
NA,1998,"Yeovil","Woking","0-1",0,1,5,5,1,-1,"A"
NA,1998,"Barrow","Yeovil","2-0",2,0,5,5,2,2,"H"
NA,1998,"Cheltenham","Yeovil","3-2",3,2,5,5,5,1,"H"
NA,1998,"Doncaster Rovers","Yeovil","0-2",0,2,5,5,2,-2,"A"
NA,1998,"Dover Athletic","Yeovil","1-2",1,2,5,5,3,-1,"A"
NA,1998,"Farnborough Town","Yeovil","0-0",0,0,5,5,0,0,"D"
NA,1998,"Forest Green Rovers","Yeovil","1-2",1,2,5,5,3,-1,"A"
NA,1998,"Hayes & Yeading","Yeovil","1-1",1,1,5,5,2,0,"D"
NA,1998,"Hednesford Town","Yeovil","2-3",2,3,5,5,5,-1,"A"
NA,1998,"Hereford United","Yeovil","0-1",0,1,5,5,1,-1,"A"
NA,1998,"Kettering Town","Yeovil","1-2",1,2,5,5,3,-1,"A"
NA,1998,"Kidderminster Harriers","Yeovil","0-1",0,1,5,5,1,-1,"A"
NA,1998,"Kingstonian","Yeovil","0-0",0,0,5,5,0,0,"D"
NA,1998,"Leek Town","Yeovil","2-4",2,4,5,5,6,-2,"A"
NA,1998,"Morecambe","Yeovil","1-1",1,1,5,5,2,0,"D"
NA,1998,"Northwich Victoria","Yeovil","1-2",1,2,5,5,3,-1,"A"
NA,1998,"Rushden & Diamonds","Yeovil","1-2",1,2,5,5,3,-1,"A"
NA,1998,"Southport","Yeovil","2-3",2,3,5,5,5,-1,"A"
NA,1998,"Stevenage Borough","Yeovil","1-1",1,1,5,5,2,0,"D"
NA,1998,"Telford United","Yeovil","2-2",2,2,5,5,4,0,"D"
NA,1998,"Welling United","Yeovil","1-2",1,2,5,5,3,-1,"A"
NA,1998,"Woking","Yeovil","0-0",0,0,5,5,0,0,"D"
"1999-08-14",1999,"Altrincham","Stevenage Borough","0-1",0,1,5,5,1,-1,"A"
"1999-08-14",1999,"Doncaster Rovers","Forest Green Rovers","3-2",3,2,5,5,5,1,"H"
"1999-08-14",1999,"Kettering Town","Northwich Victoria","1-1",1,1,5,5,2,0,"D"
"1999-08-14",1999,"Kidderminster Harriers","Dover Athletic","1-2",1,2,5,5,3,-1,"A"
"1999-08-14",1999,"Morecambe","Rushden & Diamonds","0-0",0,0,5,5,0,0,"D"
"1999-08-14",1999,"Nuneaton Town","Hayes & Yeading","2-1",2,1,5,5,3,1,"H"
"1999-08-14",1999,"Scarborough","Yeovil","5-0",5,0,5,5,5,5,"H"
"1999-08-14",1999,"Southport","Woking","4-1",4,1,5,5,5,3,"H"
"1999-08-14",1999,"Sutton United","Hereford United","1-1",1,1,5,5,2,0,"D"
"1999-08-14",1999,"Telford United","Kingstonian","1-0",1,0,5,5,1,1,"H"
"1999-08-14",1999,"Welling United","Hednesford Town","1-2",1,2,5,5,3,-1,"A"
"1999-08-17",1999,"Altrincham","Hednesford Town","0-1",0,1,5,5,1,-1,"A"
"1999-08-17",1999,"Hayes & Yeading","Welling United","1-0",1,0,5,5,1,1,"H"
"1999-08-17",1999,"Hereford United","Nuneaton Town","1-1",1,1,5,5,2,0,"D"
"1999-08-17",1999,"Northwich Victoria","Morecambe","0-0",0,0,5,5,0,0,"D"
"1999-08-17",1999,"Rushden & Diamonds","Telford United","1-1",1,1,5,5,2,0,"D"
"1999-08-17",1999,"Southport","Scarborough","2-2",2,2,5,5,4,0,"D"
"1999-08-17",1999,"Stevenage Borough","Doncaster Rovers","3-0",3,0,5,5,3,3,"H"
"1999-08-17",1999,"Woking","Kettering Town","1-1",1,1,5,5,2,0,"D"
"1999-08-17",1999,"Yeovil","Kidderminster Harriers","1-0",1,0,5,5,1,1,"H"
"1999-08-18",1999,"Kingstonian","Dover Athletic","4-1",4,1,5,5,5,3,"H"
"1999-08-21",1999,"Dover Athletic","Nuneaton Town","3-1",3,1,5,5,4,2,"H"
"1999-08-21",1999,"Forest Green Rovers","Scarborough","0-1",0,1,5,5,1,-1,"A"
"1999-08-21",1999,"Hayes & Yeading","Morecambe","0-1",0,1,5,5,1,-1,"A"
"1999-08-21",1999,"Hednesford Town","Sutton United","1-0",1,0,5,5,1,1,"H"
"1999-08-21",1999,"Hereford United","Kettering Town","4-2",4,2,5,5,6,2,"H"
"1999-08-21",1999,"Kingstonian","Southport","4-2",4,2,5,5,6,2,"H"
"1999-08-21",1999,"Northwich Victoria","Welling United","3-2",3,2,5,5,5,1,"H"
"1999-08-21",1999,"Rushden & Diamonds","Kidderminster Harriers","5-3",5,3,5,5,8,2,"H"
"1999-08-21",1999,"Stevenage Borough","Telford United","2-0",2,0,5,5,2,2,"H"
"1999-08-21",1999,"Woking","Doncaster Rovers","1-3",1,3,5,5,4,-2,"A"
"1999-08-21",1999,"Yeovil","Altrincham","3-0",3,0,5,5,3,3,"H"
"1999-08-24",1999,"Doncaster Rovers","Southport","1-1",1,1,5,5,2,0,"D"
"1999-08-24",1999,"Dover Athletic","Hayes & Yeading","2-2",2,2,5,5,4,0,"D"
"1999-08-24",1999,"Kettering Town","Kingstonian","2-1",2,1,5,5,3,1,"H"
"1999-08-24",1999,"Morecambe","Hereford United","3-2",3,2,5,5,5,1,"H"
"1999-08-24",1999,"Nuneaton Town","Yeovil","1-1",1,1,5,5,2,0,"D"
"1999-08-24",1999,"Scarborough","Hednesford Town","1-1",1,1,5,5,2,0,"D"
"1999-08-24",1999,"Sutton United","Stevenage Borough","0-2",0,2,5,5,2,-2,"A"
"1999-08-24",1999,"Telford United","Forest Green Rovers","2-0",2,0,5,5,2,2,"H"
"1999-08-24",1999,"Welling United","Woking","1-2",1,2,5,5,3,-1,"A"
"1999-08-28",1999,"Doncaster Rovers","Hayes & Yeading","0-0",0,0,5,5,0,0,"D"
"1999-08-28",1999,"Hednesford Town","Morecambe","1-3",1,3,5,5,4,-2,"A"
"1999-08-28",1999,"Kidderminster Harriers","Woking","3-2",3,2,5,5,5,1,"H"
"1999-08-28",1999,"Kingstonian","Altrincham","2-2",2,2,5,5,4,0,"D"
"1999-08-28",1999,"Nuneaton Town","Northwich Victoria","3-1",3,1,5,5,4,2,"H"
"1999-08-28",1999,"Scarborough","Stevenage Borough","1-3",1,3,5,5,4,-2,"A"
"1999-08-28",1999,"Southport","Forest Green Rovers","2-1",2,1,5,5,3,1,"H"
"1999-08-28",1999,"Sutton United","Rushden & Diamonds","0-4",0,4,5,5,4,-4,"A"
"1999-08-28",1999,"Telford United","Dover Athletic","1-1",1,1,5,5,2,0,"D"
"1999-08-28",1999,"Welling United","Hereford United","3-1",3,1,5,5,4,2,"H"
"1999-08-28",1999,"Yeovil","Kettering Town","2-0",2,0,5,5,2,2,"H"
"1999-08-30",1999,"Altrincham","Southport","3-0",3,0,5,5,3,3,"H"
"1999-08-30",1999,"Dover Athletic","Sutton United","1-1",1,1,5,5,2,0,"D"
"1999-08-30",1999,"Forest Green Rovers","Kidderminster Harriers","3-2",3,2,5,5,5,1,"H"
"1999-08-30",1999,"Hayes & Yeading","Kingstonian","1-2",1,2,5,5,3,-1,"A"
"1999-08-30",1999,"Hednesford Town","Nuneaton Town","0-0",0,0,5,5,0,0,"D"
"1999-08-30",1999,"Hereford United","Telford United","2-2",2,2,5,5,4,0,"D"
"1999-08-30",1999,"Morecambe","Scarborough","0-1",0,1,5,5,1,-1,"A"
"1999-08-30",1999,"Northwich Victoria","Doncaster Rovers","2-1",2,1,5,5,3,1,"H"
"1999-08-30",1999,"Rushden & Diamonds","Welling United","2-0",2,0,5,5,2,2,"H"
"1999-08-30",1999,"Stevenage Borough","Kettering Town","3-0",3,0,5,5,3,3,"H"
"1999-08-30",1999,"Woking","Yeovil","2-0",2,0,5,5,2,2,"H"
"1999-09-04",1999,"Altrincham","Dover Athletic","3-0",3,0,5,5,3,3,"H"
"1999-09-04",1999,"Forest Green Rovers","Nuneaton Town","1-2",1,2,5,5,3,-1,"A"
"1999-09-04",1999,"Hayes & Yeading","Southport","0-2",0,2,5,5,2,-2,"A"
"1999-09-04",1999,"Hereford United","Doncaster Rovers","5-3",5,3,5,5,8,2,"H"
"1999-09-04",1999,"Kettering Town","Sutton United","1-0",1,0,5,5,1,1,"H"
"1999-09-04",1999,"Morecambe","Telford United","5-2",5,2,5,5,7,3,"H"
"1999-09-04",1999,"Northwich Victoria","Rushden & Diamonds","2-1",2,1,5,5,3,1,"H"
"1999-09-04",1999,"Scarborough","Kingstonian","0-1",0,1,5,5,1,-1,"A"
"1999-09-04",1999,"Stevenage Borough","Kidderminster Harriers","0-2",0,2,5,5,2,-2,"A"
"1999-09-04",1999,"Welling United","Yeovil","2-5",2,5,5,5,7,-3,"A"
"1999-09-04",1999,"Woking","Hednesford Town","0-1",0,1,5,5,1,-1,"A"
"1999-09-06",1999,"Hednesford Town","Kettering Town","1-1",1,1,5,5,2,0,"D"
"1999-09-07",1999,"Doncaster Rovers","Altrincham","0-1",0,1,5,5,1,-1,"A"
"1999-09-07",1999,"Rushden & Diamonds","Hayes & Yeading","1-0",1,0,5,5,1,1,"H"
"1999-09-07",1999,"Yeovil","Hereford United","1-0",1,0,5,5,1,1,"H"
"1999-09-11",1999,"Dover Athletic","Doncaster Rovers","1-3",1,3,5,5,4,-2,"A"
"1999-09-11",1999,"Hednesford Town","Stevenage Borough","2-2",2,2,5,5,4,0,"D"
"1999-09-11",1999,"Kettering Town","Forest Green Rovers","1-0",1,0,5,5,1,1,"H"
"1999-09-11",1999,"Kidderminster Harriers","Scarborough","2-0",2,0,5,5,2,2,"H"
"1999-09-11",1999,"Kingstonian","Northwich Victoria","3-3",3,3,5,5,6,0,"D"
"1999-09-11",1999,"Nuneaton Town","Welling United","4-3",4,3,5,5,7,1,"H"
"1999-09-11",1999,"Rushden & Diamonds","Woking","1-3",1,3,5,5,4,-2,"A"
"1999-09-11",1999,"Southport","Hereford United","0-1",0,1,5,5,1,-1,"A"
"1999-09-11",1999,"Sutton United","Altrincham","3-0",3,0,5,5,3,3,"H"
"1999-09-11",1999,"Telford United","Hayes & Yeading","1-2",1,2,5,5,3,-1,"A"
"1999-09-11",1999,"Yeovil","Morecambe","2-0",2,0,5,5,2,2,"H"
"1999-09-13",1999,"Kidderminster Harriers","Nuneaton Town","1-2",1,2,5,5,3,-1,"A"
"1999-09-14",1999,"Doncaster Rovers","Hednesford Town","2-1",2,1,5,5,3,1,"H"
"1999-09-14",1999,"Hayes & Yeading","Yeovil","2-3",2,3,5,5,5,-1,"A"
"1999-09-14",1999,"Hereford United","Forest Green Rovers","1-0",1,0,5,5,1,1,"H"
"1999-09-14",1999,"Kettering Town","Rushden & Diamonds","1-1",1,1,5,5,2,0,"D"
"1999-09-14",1999,"Northwich Victoria","Scarborough","2-0",2,0,5,5,2,2,"H"
"1999-09-18",1999,"Altrincham","Woking","1-1",1,1,5,5,2,0,"D"
"1999-09-18",1999,"Doncaster Rovers","Kettering Town","2-1",2,1,5,5,3,1,"H"
"1999-09-18",1999,"Forest Green Rovers","Kingstonian","0-3",0,3,5,5,3,-3,"A"
"1999-09-18",1999,"Hednesford Town","Hayes & Yeading","2-1",2,1,5,5,3,1,"H"
"1999-09-18",1999,"Hereford United","Stevenage Borough","1-2",1,2,5,5,3,-1,"A"
"1999-09-18",1999,"Morecambe","Kidderminster Harriers","0-1",0,1,5,5,1,-1,"A"
"1999-09-18",1999,"Northwich Victoria","Dover Athletic","1-1",1,1,5,5,2,0,"D"
"1999-09-18",1999,"Rushden & Diamonds","Southport","4-2",4,2,5,5,6,2,"H"
"1999-09-18",1999,"Scarborough","Nuneaton Town","1-1",1,1,5,5,2,0,"D"
"1999-09-18",1999,"Welling United","Telford United","2-0",2,0,5,5,2,2,"H"
"1999-09-18",1999,"Yeovil","Sutton United","1-2",1,2,5,5,3,-1,"A"
"1999-09-21",1999,"Sutton United","Welling United","2-3",2,3,5,5,5,-1,"A"
"1999-09-25",1999,"Dover Athletic","Hereford United","2-0",2,0,5,5,2,2,"H"
"1999-09-25",1999,"Hednesford Town","Rushden & Diamonds","1-2",1,2,5,5,3,-1,"A"
"1999-09-25",1999,"Kettering Town","Morecambe","1-1",1,1,5,5,2,0,"D"
"1999-09-25",1999,"Kidderminster Harriers","Doncaster Rovers","1-0",1,0,5,5,1,1,"H"
"1999-09-25",1999,"Nuneaton Town","Altrincham","3-1",3,1,5,5,4,2,"H"
"1999-09-25",1999,"Scarborough","Hayes & Yeading","4-1",4,1,5,5,5,3,"H"
"1999-09-25",1999,"Southport","Sutton United","1-1",1,1,5,5,2,0,"D"
"1999-09-25",1999,"Stevenage Borough","Kingstonian","0-1",0,1,5,5,1,-1,"A"
"1999-09-25",1999,"Telford United","Yeovil","3-1",3,1,5,5,4,2,"H"
"1999-09-25",1999,"Welling United","Forest Green Rovers","1-1",1,1,5,5,2,0,"D"
"1999-09-28",1999,"Hereford United","Rushden & Diamonds","4-0",4,0,5,5,4,4,"H"
"1999-09-28",1999,"Welling United","Kingstonian","0-1",0,1,5,5,1,-1,"A"
"1999-09-29",1999,"Forest Green Rovers","Northwich Victoria","5-1",5,1,5,5,6,4,"H"
"1999-10-02",1999,"Altrincham","Rushden & Diamonds","1-2",1,2,5,5,3,-1,"A"
"1999-10-02",1999,"Doncaster Rovers","Welling United","1-1",1,1,5,5,2,0,"D"
"1999-10-02",1999,"Forest Green Rovers","Stevenage Borough","3-2",3,2,5,5,5,1,"H"
"1999-10-02",1999,"Hayes & Yeading","Kidderminster Harriers","2-0",2,0,5,5,2,2,"H"
"1999-10-02",1999,"Hereford United","Scarborough","4-4",4,4,5,5,8,0,"D"
"1999-10-02",1999,"Kingstonian","Kettering Town","2-0",2,0,5,5,2,2,"H"
"1999-10-02",1999,"Morecambe","Woking","1-0",1,0,5,5,1,1,"H"
"1999-10-02",1999,"Northwich Victoria","Hednesford Town","3-2",3,2,5,5,5,1,"H"
"1999-10-02",1999,"Nuneaton Town","Southport","0-2",0,2,5,5,2,-2,"A"
"1999-10-02",1999,"Sutton United","Telford United","2-1",2,1,5,5,3,1,"H"
"1999-10-02",1999,"Yeovil","Dover Athletic","1-1",1,1,5,5,2,0,"D"
"1999-10-09",1999,"Doncaster Rovers","Nuneaton Town","0-1",0,1,5,5,1,-1,"A"
"1999-10-09",1999,"Dover Athletic","Scarborough","1-1",1,1,5,5,2,0,"D"
"1999-10-09",1999,"Hednesford Town","Forest Green Rovers","1-0",1,0,5,5,1,1,"H"
"1999-10-09",1999,"Kettering Town","Hayes & Yeading","1-1",1,1,5,5,2,0,"D"
"1999-10-09",1999,"Kidderminster Harriers","Yeovil","4-0",4,0,5,5,4,4,"H"
"1999-10-09",1999,"Rushden & Diamonds","Kingstonian","1-0",1,0,5,5,1,1,"H"
"1999-10-09",1999,"Southport","Welling United","3-2",3,2,5,5,5,1,"H"
"1999-10-09",1999,"Stevenage Borough","Morecambe","1-2",1,2,5,5,3,-1,"A"
"1999-10-09",1999,"Sutton United","Northwich Victoria","2-2",2,2,5,5,4,0,"D"
"1999-10-09",1999,"Telford United","Altrincham","0-1",0,1,5,5,1,-1,"A"
"1999-10-09",1999,"Woking","Hereford United","0-2",0,2,5,5,2,-2,"A"
"1999-10-13",1999,"Kingstonian","Yeovil","0-1",0,1,5,5,1,-1,"A"
"1999-10-22",1999,"Telford United","Doncaster Rovers","0-2",0,2,5,5,2,-2,"A"
"1999-10-23",1999,"Dover Athletic","Hednesford Town","4-1",4,1,5,5,5,3,"H"
"1999-10-23",1999,"Hereford United","Hayes & Yeading","0-2",0,2,5,5,2,-2,"A"
"1999-10-23",1999,"Kidderminster Harriers","Kettering Town","1-0",1,0,5,5,1,1,"H"
"1999-10-23",1999,"Morecambe","Kingstonian","1-2",1,2,5,5,3,-1,"A"
"1999-10-23",1999,"Northwich Victoria","Stevenage Borough","3-3",3,3,5,5,6,0,"D"
"1999-10-23",1999,"Nuneaton Town","Sutton United","2-0",2,0,5,5,2,2,"H"
"1999-10-23",1999,"Scarborough","Rushden & Diamonds","0-1",0,1,5,5,1,-1,"A"
"1999-10-23",1999,"Welling United","Altrincham","2-2",2,2,5,5,4,0,"D"
"1999-10-23",1999,"Woking","Forest Green Rovers","2-1",2,1,5,5,3,1,"H"
"1999-10-23",1999,"Yeovil","Southport","1-1",1,1,5,5,2,0,"D"
"1999-10-30",1999,"Dover Athletic","Stevenage Borough","4-2",4,2,5,5,6,2,"H"
"1999-10-30",1999,"Telford United","Nuneaton Town","1-0",1,0,5,5,1,1,"H"
"1999-10-30",1999,"Woking","Northwich Victoria","1-1",1,1,5,5,2,0,"D"
"1999-11-01",1999,"Hednesford Town","Kidderminster Harriers","0-2",0,2,5,5,2,-2,"A"
"1999-11-02",1999,"Kettering Town","Welling United","2-1",2,1,5,5,3,1,"H"
"1999-11-02",1999,"Nuneaton Town","Rushden & Diamonds","1-1",1,1,5,5,2,0,"D"
"1999-11-02",1999,"Sutton United","Kingstonian","2-2",2,2,5,5,4,0,"D"
"1999-11-06",1999,"Altrincham","Hereford United","2-1",2,1,5,5,3,1,"H"
"1999-11-06",1999,"Forest Green Rovers","Morecambe","1-2",1,2,5,5,3,-1,"A"
"1999-11-06",1999,"Hayes & Yeading","Northwich Victoria","2-1",2,1,5,5,3,1,"H"
"1999-11-06",1999,"Hednesford Town","Yeovil","1-0",1,0,5,5,1,1,"H"
"1999-11-06",1999,"Kingstonian","Welling United","1-0",1,0,5,5,1,1,"H"
"1999-11-06",1999,"Rushden & Diamonds","Dover Athletic","1-1",1,1,5,5,2,0,"D"
"1999-11-06",1999,"Southport","Kettering Town","0-1",0,1,5,5,1,-1,"A"
"1999-11-06",1999,"Stevenage Borough","Scarborough","0-1",0,1,5,5,1,-1,"A"
"1999-11-06",1999,"Sutton United","Doncaster Rovers","1-0",1,0,5,5,1,1,"H"
"1999-11-06",1999,"Telford United","Kidderminster Harriers","3-2",3,2,5,5,5,1,"H"
"1999-11-06",1999,"Woking","Nuneaton Town","1-1",1,1,5,5,2,0,"D"
"1999-11-12",1999,"Nuneaton Town","Kingstonian","2-0",2,0,5,5,2,2,"H"
"1999-11-12",1999,"Scarborough","Telford United","2-0",2,0,5,5,2,2,"H"
"1999-11-12",1999,"Welling United","Sutton United","2-3",2,3,5,5,5,-1,"A"
"1999-11-13",1999,"Doncaster Rovers","Woking","0-0",0,0,5,5,0,0,"D"
"1999-11-13",1999,"Kidderminster Harriers","Southport","5-0",5,0,5,5,5,5,"H"
"1999-11-13",1999,"Yeovil","Rushden & Diamonds","5-1",5,1,5,5,6,4,"H"
"1999-11-14",1999,"Dover Athletic","Forest Green Rovers","4-0",4,0,5,5,4,4,"H"
"1999-11-14",1999,"Hayes & Yeading","Stevenage Borough","1-2",1,2,5,5,3,-1,"A"
"1999-11-14",1999,"Hereford United","Northwich Victoria","3-0",3,0,5,5,3,3,"H"
"1999-11-14",1999,"Kettering Town","Altrincham","0-0",0,0,5,5,0,0,"D"
"1999-11-14",1999,"Morecambe","Hednesford Town","4-0",4,0,5,5,4,4,"H"
"1999-11-20",1999,"Altrincham","Morecambe","2-2",2,2,5,5,4,0,"D"
"1999-11-20",1999,"Kingstonian","Doncaster Rovers","0-1",0,1,5,5,1,-1,"A"
"1999-11-20",1999,"Northwich Victoria","Kidderminster Harriers","1-1",1,1,5,5,2,0,"D"
"1999-11-20",1999,"Nuneaton Town","Telford United","1-1",1,1,5,5,2,0,"D"
"1999-11-20",1999,"Scarborough","Kettering Town","0-0",0,0,5,5,0,0,"D"
"1999-11-20",1999,"Southport","Dover Athletic","1-2",1,2,5,5,3,-1,"A"
"1999-11-20",1999,"Sutton United","Yeovil","0-1",0,1,5,5,1,-1,"A"
"1999-11-20",1999,"Woking","Welling United","2-3",2,3,5,5,5,-1,"A"
"1999-11-30",1999,"Altrincham","Nuneaton Town","2-2",2,2,5,5,4,0,"D"
"1999-12-04",1999,"Doncaster Rovers","Stevenage Borough","1-2",1,2,5,5,3,-1,"A"
"1999-12-04",1999,"Dover Athletic","Altrincham","2-2",2,2,5,5,4,0,"D"
"1999-12-04",1999,"Hayes & Yeading","Rushden & Diamonds","0-5",0,5,5,5,5,-5,"A"
"1999-12-04",1999,"Hednesford Town","Woking","3-0",3,0,5,5,3,3,"H"
"1999-12-04",1999,"Hereford United","Southport","2-1",2,1,5,5,3,1,"H"
"1999-12-04",1999,"Kettering Town","Telford United","0-0",0,0,5,5,0,0,"D"
"1999-12-04",1999,"Kidderminster Harriers","Kingstonian","2-0",2,0,5,5,2,2,"H"
"1999-12-04",1999,"Morecambe","Sutton United","6-2",6,2,5,5,8,4,"H"
"1999-12-04",1999,"Nuneaton Town","Forest Green Rovers","2-3",2,3,5,5,5,-1,"A"
"1999-12-04",1999,"Welling United","Scarborough","2-1",2,1,5,5,3,1,"H"
"1999-12-04",1999,"Yeovil","Northwich Victoria","3-2",3,2,5,5,5,1,"H"
"1999-12-11",1999,"Forest Green Rovers","Hednesford Town","3-0",3,0,5,5,3,3,"H"
"1999-12-11",1999,"Northwich Victoria","Nuneaton Town","3-1",3,1,5,5,4,2,"H"
"1999-12-11",1999,"Scarborough","Kidderminster Harriers","0-0",0,0,5,5,0,0,"D"
"1999-12-11",1999,"Stevenage Borough","Dover Athletic","3-1",3,1,5,5,4,2,"H"
"1999-12-11",1999,"Sutton United","Kettering Town","1-1",1,1,5,5,2,0,"D"
"1999-12-11",1999,"Telford United","Welling United","2-1",2,1,5,5,3,1,"H"
"1999-12-11",1999,"Woking","Morecambe","0-0",0,0,5,5,0,0,"D"
"1999-12-15",1999,"Forest Green Rovers","Sutton United","1-2",1,2,5,5,3,-1,"A"
"1999-12-18",1999,"Altrincham","Forest Green Rovers","1-1",1,1,5,5,2,0,"D"
"1999-12-18",1999,"Kettering Town","Dover Athletic","1-2",1,2,5,5,3,-1,"A"
"1999-12-18",1999,"Kidderminster Harriers","Morecambe","2-1",2,1,5,5,3,1,"H"
"1999-12-18",1999,"Kingstonian","Hednesford Town","0-2",0,2,5,5,2,-2,"A"
"1999-12-18",1999,"Scarborough","Hereford United","3-0",3,0,5,5,3,3,"H"
"1999-12-18",1999,"Southport","Northwich Victoria","0-1",0,1,5,5,1,-1,"A"
"1999-12-18",1999,"Stevenage Borough","Woking","0-1",0,1,5,5,1,-1,"A"
"1999-12-18",1999,"Sutton United","Nuneaton Town","1-2",1,2,5,5,3,-1,"A"
"1999-12-18",1999,"Telford United","Rushden & Diamonds","1-1",1,1,5,5,2,0,"D"
"1999-12-18",1999,"Welling United","Doncaster Rovers","0-1",0,1,5,5,1,-1,"A"
"1999-12-18",1999,"Yeovil","Hayes & Yeading","2-4",2,4,5,5,6,-2,"A"
"1999-12-27",1999,"Doncaster Rovers","Scarborough","0-1",0,1,5,5,1,-1,"A"
"1999-12-27",1999,"Dover Athletic","Welling United","2-1",2,1,5,5,3,1,"H"
"1999-12-27",1999,"Forest Green Rovers","Yeovil","3-0",3,0,5,5,3,3,"H"
"1999-12-27",1999,"Hayes & Yeading","Sutton United","1-0",1,0,5,5,1,1,"H"
"1999-12-27",1999,"Hednesford Town","Telford United","2-1",2,1,5,5,3,1,"H"
"1999-12-27",1999,"Hereford United","Kidderminster Harriers","1-1",1,1,5,5,2,0,"D"
"1999-12-27",1999,"Morecambe","Southport","3-3",3,3,5,5,6,0,"D"
"1999-12-27",1999,"Northwich Victoria","Altrincham","1-1",1,1,5,5,2,0,"D"
"1999-12-27",1999,"Nuneaton Town","Kettering Town","0-1",0,1,5,5,1,-1,"A"
"1999-12-27",1999,"Rushden & Diamonds","Stevenage Borough","2-1",2,1,5,5,3,1,"H"
"1999-12-27",1999,"Woking","Kingstonian","1-1",1,1,5,5,2,0,"D"
"2000-01-03",1999,"Altrincham","Northwich Victoria","2-0",2,0,5,5,2,2,"H"
"2000-01-03",1999,"Doncaster Rovers","Sutton United","1-0",1,0,5,5,1,1,"H"
"2000-01-03",1999,"Dover Athletic","Yeovil","3-0",3,0,5,5,3,3,"H"
"2000-01-03",1999,"Forest Green Rovers","Altrincham","1-1",1,1,5,5,2,0,"D"
"2000-01-03",1999,"Hayes & Yeading","Kettering Town","0-1",0,1,5,5,1,-1,"A"
"2000-01-03",1999,"Hednesford Town","Scarborough","0-3",0,3,5,5,3,-3,"A"
"2000-01-03",1999,"Kettering Town","Nuneaton Town","1-1",1,1,5,5,2,0,"D"
"2000-01-03",1999,"Kidderminster Harriers","Hereford United","1-1",1,1,5,5,2,0,"D"
"2000-01-03",1999,"Kingstonian","Woking","0-2",0,2,5,5,2,-2,"A"
"2000-01-03",1999,"Kingstonian","Telford United","4-2",4,2,5,5,6,2,"H"
"2000-01-03",1999,"Morecambe","Stevenage Borough","3-3",3,3,5,5,6,0,"D"
"2000-01-03",1999,"Nuneaton Town","Kidderminster Harriers","2-3",2,3,5,5,5,-1,"A"
"2000-01-03",1999,"Scarborough","Doncaster Rovers","0-0",0,0,5,5,0,0,"D"
"2000-01-03",1999,"Southport","Morecambe","1-1",1,1,5,5,2,0,"D"
"2000-01-03",1999,"Stevenage Borough","Rushden & Diamonds","2-2",2,2,5,5,4,0,"D"
"2000-01-03",1999,"Sutton United","Hayes & Yeading","2-2",2,2,5,5,4,0,"D"
"2000-01-03",1999,"Telford United","Hednesford Town","6-2",6,2,5,5,8,4,"H"
"2000-01-03",1999,"Welling United","Northwich Victoria","1-3",1,3,5,5,4,-2,"A"
"2000-01-03",1999,"Welling United","Dover Athletic","1-1",1,1,5,5,2,0,"D"
"2000-01-03",1999,"Yeovil","Forest Green Rovers","1-0",1,0,5,5,1,1,"H"
"2000-01-08",1999,"Woking","Southport","0-0",0,0,5,5,0,0,"D"
"2000-01-15",1999,"Kidderminster Harriers","Hayes & Yeading","2-1",2,1,5,5,3,1,"H"
"2000-01-18",1999,"Telford United","Morecambe","3-2",3,2,5,5,5,1,"H"
"2000-01-22",1999,"Doncaster Rovers","Kingstonian","1-0",1,0,5,5,1,1,"H"
"2000-01-22",1999,"Forest Green Rovers","Rushden & Diamonds","1-0",1,0,5,5,1,1,"H"
"2000-01-22",1999,"Hereford United","Altrincham","2-2",2,2,5,5,4,0,"D"
"2000-01-22",1999,"Kettering Town","Woking","0-0",0,0,5,5,0,0,"D"
"2000-01-22",1999,"Kidderminster Harriers","Sutton United","1-0",1,0,5,5,1,1,"H"
"2000-01-22",1999,"Morecambe","Hayes & Yeading","1-4",1,4,5,5,5,-3,"A"
"2000-01-22",1999,"Nuneaton Town","Dover Athletic","0-2",0,2,5,5,2,-2,"A"
"2000-01-22",1999,"Scarborough","Northwich Victoria","3-0",3,0,5,5,3,3,"H"
"2000-01-22",1999,"Southport","Hednesford Town","2-0",2,0,5,5,2,2,"H"
"2000-01-22",1999,"Welling United","Stevenage Borough","2-1",2,1,5,5,3,1,"H"
"2000-01-22",1999,"Yeovil","Telford United","2-1",2,1,5,5,3,1,"H"
"2000-01-25",1999,"Telford United","Southport","0-0",0,0,5,5,0,0,"D"
"2000-01-26",1999,"Forest Green Rovers","Hayes & Yeading","0-1",0,1,5,5,1,-1,"A"
"2000-01-29",1999,"Dover Athletic","Morecambe","3-1",3,1,5,5,4,2,"H"
"2000-01-29",1999,"Hayes & Yeading","Doncaster Rovers","3-4",3,4,5,5,7,-1,"A"
"2000-01-29",1999,"Hednesford Town","Hereford United","0-1",0,1,5,5,1,-1,"A"
"2000-01-29",1999,"Kettering Town","Yeovil","1-2",1,2,5,5,3,-1,"A"
"2000-01-29",1999,"Kingstonian","Kidderminster Harriers","0-1",0,1,5,5,1,-1,"A"
"2000-01-29",1999,"Rushden & Diamonds","Northwich Victoria","6-0",6,0,5,5,6,6,"H"
"2000-01-29",1999,"Stevenage Borough","Altrincham","1-1",1,1,5,5,2,0,"D"
"2000-01-29",1999,"Sutton United","Southport","1-1",1,1,5,5,2,0,"D"
"2000-01-29",1999,"Telford United","Scarborough","1-0",1,0,5,5,1,1,"H"
"2000-01-29",1999,"Welling United","Nuneaton Town","0-0",0,0,5,5,0,0,"D"
"2000-02-01",1999,"Altrincham","Telford United","3-3",3,3,5,5,6,0,"D"
"2000-02-05",1999,"Hednesford Town","Altrincham","5-0",5,0,5,5,5,5,"H"
"2000-02-05",1999,"Northwich Victoria","Hereford United","0-0",0,0,5,5,0,0,"D"
"2000-02-05",1999,"Stevenage Borough","Nuneaton Town","2-1",2,1,5,5,3,1,"H"
"2000-02-12",1999,"Altrincham","Welling United","0-1",0,1,5,5,1,-1,"A"
"2000-02-12",1999,"Doncaster Rovers","Hereford United","2-2",2,2,5,5,4,0,"D"
"2000-02-12",1999,"Dover Athletic","Rushden & Diamonds","0-4",0,4,5,5,4,-4,"A"
"2000-02-12",1999,"Forest Green Rovers","Telford United","5-2",5,2,5,5,7,3,"H"
"2000-02-12",1999,"Kettering Town","Scarborough","0-0",0,0,5,5,0,0,"D"
"2000-02-12",1999,"Kidderminster Harriers","Hednesford Town","3-0",3,0,5,5,3,3,"H"
"2000-02-12",1999,"Kingstonian","Sutton United","4-2",4,2,5,5,6,2,"H"
"2000-02-12",1999,"Northwich Victoria","Hayes & Yeading","0-0",0,0,5,5,0,0,"D"
"2000-02-12",1999,"Nuneaton Town","Morecambe","1-1",1,1,5,5,2,0,"D"
"2000-02-12",1999,"Southport","Yeovil","1-1",1,1,5,5,2,0,"D"
"2000-02-12",1999,"Woking","Stevenage Borough","0-2",0,2,5,5,2,-2,"A"
"2000-02-15",1999,"Rushden & Diamonds","Forest Green Rovers","3-2",3,2,5,5,5,1,"H"
"2000-02-16",1999,"Kingstonian","Stevenage Borough","1-0",1,0,5,5,1,1,"H"
"2000-02-19",1999,"Doncaster Rovers","Rushden & Diamonds","0-1",0,1,5,5,1,-1,"A"
"2000-02-19",1999,"Forest Green Rovers","Southport","1-0",1,0,5,5,1,1,"H"
"2000-02-19",1999,"Hayes & Yeading","Hednesford Town","2-1",2,1,5,5,3,1,"H"
"2000-02-19",1999,"Hereford United","Dover Athletic","2-0",2,0,5,5,2,2,"H"
"2000-02-19",1999,"Kettering Town","Kidderminster Harriers","3-1",3,1,5,5,4,2,"H"
"2000-02-19",1999,"Scarborough","Sutton United","3-0",3,0,5,5,3,3,"H"
"2000-02-19",1999,"Stevenage Borough","Northwich Victoria","3-1",3,1,5,5,4,2,"H"
"2000-02-19",1999,"Welling United","Morecambe","0-0",0,0,5,5,0,0,"D"
"2000-02-19",1999,"Woking","Altrincham","0-1",0,1,5,5,1,-1,"A"
"2000-02-19",1999,"Yeovil","Nuneaton Town","1-3",1,3,5,5,4,-2,"A"
"2000-02-22",1999,"Altrincham","Scarborough","2-1",2,1,5,5,3,1,"H"
"2000-02-22",1999,"Rushden & Diamonds","Hednesford Town","1-1",1,1,5,5,2,0,"D"
"2000-02-28",1999,"Hayes & Yeading","Hereford United","0-0",0,0,5,5,0,0,"D"
"2000-02-28",1999,"Kidderminster Harriers","Welling United","4-1",4,1,5,5,5,3,"H"
"2000-02-28",1999,"Morecambe","Altrincham","3-3",3,3,5,5,6,0,"D"
"2000-02-28",1999,"Northwich Victoria","Forest Green Rovers","0-0",0,0,5,5,0,0,"D"
"2000-02-28",1999,"Stevenage Borough","Hereford United","0-3",0,3,5,5,3,-3,"A"
"2000-02-29",1999,"Scarborough","Southport","3-0",3,0,5,5,3,3,"H"
"2000-03-04",1999,"Altrincham","Sutton United","3-0",3,0,5,5,3,3,"H"
"2000-03-04",1999,"Hednesford Town","Doncaster Rovers","2-1",2,1,5,5,3,1,"H"
"2000-03-04",1999,"Kidderminster Harriers","Stevenage Borough","3-1",3,1,5,5,4,2,"H"
"2000-03-04",1999,"Kingstonian","Rushden & Diamonds","0-1",0,1,5,5,1,-1,"A"
"2000-03-04",1999,"Morecambe","Forest Green Rovers","1-1",1,1,5,5,2,0,"D"
"2000-03-04",1999,"Northwich Victoria","Yeovil","3-0",3,0,5,5,3,3,"H"
"2000-03-04",1999,"Nuneaton Town","Hereford United","0-1",0,1,5,5,1,-1,"A"
"2000-03-04",1999,"Scarborough","Dover Athletic","1-2",1,2,5,5,3,-1,"A"
"2000-03-04",1999,"Southport","Hayes & Yeading","4-1",4,1,5,5,5,3,"H"
"2000-03-04",1999,"Telford United","Woking","1-2",1,2,5,5,3,-1,"A"
"2000-03-04",1999,"Welling United","Kettering Town","1-0",1,0,5,5,1,1,"H"
"2000-03-07",1999,"Doncaster Rovers","Kidderminster Harriers","1-2",1,2,5,5,3,-1,"A"
"2000-03-07",1999,"Rushden & Diamonds","Yeovil","1-1",1,1,5,5,2,0,"D"
"2000-03-11",1999,"Forest Green Rovers","Dover Athletic","3-1",3,1,5,5,4,2,"H"
"2000-03-11",1999,"Hereford United","Hednesford Town","3-0",3,0,5,5,3,3,"H"
"2000-03-11",1999,"Kidderminster Harriers","Altrincham","1-1",1,1,5,5,2,0,"D"
"2000-03-11",1999,"Nuneaton Town","Scarborough","1-1",1,1,5,5,2,0,"D"
"2000-03-11",1999,"Stevenage Borough","Welling United","0-1",0,1,5,5,1,-1,"A"
"2000-03-11",1999,"Woking","Hayes & Yeading","0-3",0,3,5,5,3,-3,"A"
"2000-03-11",1999,"Yeovil","Doncaster Rovers","1-3",1,3,5,5,4,-2,"A"
"2000-03-14",1999,"Hereford United","Woking","2-4",2,4,5,5,6,-2,"A"
"2000-03-18",1999,"Doncaster Rovers","Yeovil","0-3",0,3,5,5,3,-3,"A"
"2000-03-18",1999,"Forest Green Rovers","Hereford United","0-1",0,1,5,5,1,-1,"A"
"2000-03-18",1999,"Hayes & Yeading","Altrincham","1-1",1,1,5,5,2,0,"D"
"2000-03-18",1999,"Kettering Town","Southport","0-3",0,3,5,5,3,-3,"A"
"2000-03-18",1999,"Kingstonian","Nuneaton Town","2-0",2,0,5,5,2,2,"H"
"2000-03-18",1999,"Morecambe","Dover Athletic","2-0",2,0,5,5,2,2,"H"
"2000-03-18",1999,"Rushden & Diamonds","Sutton United","4-0",4,0,5,5,4,4,"H"
"2000-03-18",1999,"Scarborough","Woking","3-2",3,2,5,5,5,1,"H"
"2000-03-18",1999,"Stevenage Borough","Hednesford Town","0-1",0,1,5,5,1,-1,"A"
"2000-03-18",1999,"Telford United","Northwich Victoria","0-1",0,1,5,5,1,-1,"A"
"2000-03-18",1999,"Welling United","Kidderminster Harriers","1-2",1,2,5,5,3,-1,"A"
"2000-03-21",1999,"Hayes & Yeading","Dover Athletic","1-2",1,2,5,5,3,-1,"A"
"2000-03-21",1999,"Southport","Doncaster Rovers","1-0",1,0,5,5,1,1,"H"
"2000-03-25",1999,"Altrincham","Kettering Town","1-1",1,1,5,5,2,0,"D"
"2000-03-25",1999,"Dover Athletic","Kingstonian","0-1",0,1,5,5,1,-1,"A"
"2000-03-25",1999,"Hayes & Yeading","Forest Green Rovers","3-0",3,0,5,5,3,3,"H"
"2000-03-25",1999,"Hednesford Town","Northwich Victoria","1-0",1,0,5,5,1,1,"H"
"2000-03-25",1999,"Kidderminster Harriers","Telford United","2-0",2,0,5,5,2,2,"H"
"2000-03-25",1999,"Morecambe","Welling United","2-1",2,1,5,5,3,1,"H"
"2000-03-25",1999,"Nuneaton Town","Doncaster Rovers","0-0",0,0,5,5,0,0,"D"
"2000-03-25",1999,"Rushden & Diamonds","Hereford United","0-0",0,0,5,5,0,0,"D"
"2000-03-25",1999,"Southport","Stevenage Borough","2-1",2,1,5,5,3,1,"H"
"2000-03-25",1999,"Woking","Sutton United","1-2",1,2,5,5,3,-1,"A"
"2000-03-25",1999,"Yeovil","Scarborough","1-2",1,2,5,5,3,-1,"A"
"2000-04-01",1999,"Dover Athletic","Woking","2-2",2,2,5,5,4,0,"D"
"2000-04-01",1999,"Forest Green Rovers","Woking","0-0",0,0,5,5,0,0,"D"
"2000-04-01",1999,"Hednesford Town","Dover Athletic","1-0",1,0,5,5,1,1,"H"
"2000-04-01",1999,"Hereford United","Morecambe","1-1",1,1,5,5,2,0,"D"
"2000-04-01",1999,"Northwich Victoria","Southport","0-1",0,1,5,5,1,-1,"A"
"2000-04-01",1999,"Rushden & Diamonds","Nuneaton Town","1-1",1,1,5,5,2,0,"D"
"2000-04-01",1999,"Rushden & Diamonds","Kettering Town","2-0",2,0,5,5,2,2,"H"
"2000-04-01",1999,"Scarborough","Welling United","0-0",0,0,5,5,0,0,"D"
"2000-04-01",1999,"Stevenage Borough","Hayes & Yeading","3-0",3,0,5,5,3,3,"H"
"2000-04-01",1999,"Sutton United","Hednesford Town","0-0",0,0,5,5,0,0,"D"
"2000-04-04",1999,"Rushden & Diamonds","Morecambe","0-2",0,2,5,5,2,-2,"A"
"2000-04-04",1999,"Southport","Nuneaton Town","2-0",2,0,5,5,2,2,"H"
"2000-04-04",1999,"Telford United","Kettering Town","3-1",3,1,5,5,4,2,"H"
"2000-04-04",1999,"Yeovil","Stevenage Borough","2-2",2,2,5,5,4,0,"D"
"2000-04-06",1999,"Kingstonian","Hereford United","0-0",0,0,5,5,0,0,"D"
"2000-04-06",1999,"Sutton United","Woking","1-1",1,1,5,5,2,0,"D"
"2000-04-08",1999,"Doncaster Rovers","Morecambe","0-1",0,1,5,5,1,-1,"A"
"2000-04-08",1999,"Dover Athletic","Northwich Victoria","4-1",4,1,5,5,5,3,"H"
"2000-04-08",1999,"Hayes & Yeading","Woking","0-0",0,0,5,5,0,0,"D"
"2000-04-08",1999,"Hereford United","Yeovil","0-1",0,1,5,5,1,-1,"A"
"2000-04-08",1999,"Kettering Town","Hednesford Town","4-2",4,2,5,5,6,2,"H"
"2000-04-08",1999,"Kidderminster Harriers","Rushden & Diamonds","2-0",2,0,5,5,2,2,"H"
"2000-04-08",1999,"Kingstonian","Scarborough","2-0",2,0,5,5,2,2,"H"
"2000-04-08",1999,"Stevenage Borough","Forest Green Rovers","1-1",1,1,5,5,2,0,"D"
"2000-04-08",1999,"Telford United","Sutton United","2-0",2,0,5,5,2,2,"H"
"2000-04-08",1999,"Welling United","Southport","4-1",4,1,5,5,5,3,"H"
"2000-04-11",1999,"Hayes & Yeading","Scarborough","0-1",0,1,5,5,1,-1,"A"
"2000-04-11",1999,"Kettering Town","Doncaster Rovers","2-2",2,2,5,5,4,0,"D"
"2000-04-11",1999,"Morecambe","Northwich Victoria","5-0",5,0,5,5,5,5,"H"
"2000-04-11",1999,"Southport","Telford United","1-3",1,3,5,5,4,-2,"A"
"2000-04-11",1999,"Sutton United","Forest Green Rovers","3-2",3,2,5,5,5,1,"H"
"2000-04-11",1999,"Woking","Rushden & Diamonds","1-3",1,3,5,5,4,-2,"A"
"2000-04-11",1999,"Yeovil","Kingstonian","3-2",3,2,5,5,5,1,"H"
"2000-04-15",1999,"Morecambe","Doncaster Rovers","2-1",2,1,5,5,3,1,"H"
"2000-04-15",1999,"Rushden & Diamonds","Altrincham","1-0",1,0,5,5,1,1,"H"
"2000-04-15",1999,"Scarborough","Forest Green Rovers","5-0",5,0,5,5,5,5,"H"
"2000-04-15",1999,"Southport","Kidderminster Harriers","0-1",0,1,5,5,1,-1,"A"
"2000-04-15",1999,"Yeovil","Welling United","1-1",1,1,5,5,2,0,"D"
"2000-04-17",1999,"Stevenage Borough","Yeovil","0-0",0,0,5,5,0,0,"D"
"2000-04-18",1999,"Altrincham","Hayes & Yeading","1-2",1,2,5,5,3,-1,"A"
"2000-04-18",1999,"Dover Athletic","Kettering Town","1-1",1,1,5,5,2,0,"D"
"2000-04-18",1999,"Northwich Victoria","Woking","3-1",3,1,5,5,4,2,"H"
"2000-04-20",1999,"Sutton United","Scarborough","1-2",1,2,5,5,3,-1,"A"
"2000-04-20",1999,"Telford United","Hereford United","1-1",1,1,5,5,2,0,"D"
"2000-04-22",1999,"Doncaster Rovers","Dover Athletic","0-1",0,1,5,5,1,-1,"A"
"2000-04-22",1999,"Kettering Town","Hereford United","2-0",2,0,5,5,2,2,"H"
"2000-04-22",1999,"Kidderminster Harriers","Northwich Victoria","3-1",3,1,5,5,4,2,"H"
"2000-04-22",1999,"Kingstonian","Forest Green Rovers","0-1",0,1,5,5,1,-1,"A"
"2000-04-22",1999,"Nuneaton Town","Woking","0-1",0,1,5,5,1,-1,"A"
"2000-04-22",1999,"Southport","Rushden & Diamonds","2-1",2,1,5,5,3,1,"H"
"2000-04-22",1999,"Sutton United","Morecambe","0-1",0,1,5,5,1,-1,"A"
"2000-04-22",1999,"Telford United","Stevenage Borough","2-1",2,1,5,5,3,1,"H"
"2000-04-22",1999,"Welling United","Hayes & Yeading","1-2",1,2,5,5,3,-1,"A"
"2000-04-22",1999,"Yeovil","Hednesford Town","3-0",3,0,5,5,3,3,"H"
"2000-04-24",1999,"Altrincham","Doncaster Rovers","1-2",1,2,5,5,3,-1,"A"
"2000-04-24",1999,"Doncaster Rovers","Telford United","2-0",2,0,5,5,2,2,"H"
"2000-04-24",1999,"Dover Athletic","Kidderminster Harriers","0-1",0,1,5,5,1,-1,"A"
"2000-04-24",1999,"Forest Green Rovers","Welling United","1-2",1,2,5,5,3,-1,"A"
"2000-04-24",1999,"Hednesford Town","Southport","1-2",1,2,5,5,3,-1,"A"
"2000-04-24",1999,"Hereford United","Kingstonian","0-2",0,2,5,5,2,-2,"A"
"2000-04-24",1999,"Kingstonian","Morecambe","0-0",0,0,5,5,0,0,"D"
"2000-04-24",1999,"Morecambe","Nuneaton Town","1-1",1,1,5,5,2,0,"D"
"2000-04-24",1999,"Northwich Victoria","Kettering Town","2-6",2,6,5,5,8,-4,"A"
"2000-04-24",1999,"Scarborough","Altrincham","1-0",1,0,5,5,1,1,"H"
"2000-04-24",1999,"Stevenage Borough","Sutton United","1-0",1,0,5,5,1,1,"H"
"2000-04-24",1999,"Woking","Telford United","1-0",1,0,5,5,1,1,"H"
"2000-04-29",1999,"Altrincham","Yeovil","2-2",2,2,5,5,4,0,"D"
"2000-04-29",1999,"Dover Athletic","Southport","1-1",1,1,5,5,2,0,"D"
"2000-04-29",1999,"Forest Green Rovers","Doncaster Rovers","1-0",1,0,5,5,1,1,"H"
"2000-04-29",1999,"Hayes & Yeading","Telford United","1-2",1,2,5,5,3,-1,"A"
"2000-04-29",1999,"Hednesford Town","Kingstonian","2-3",2,3,5,5,5,-1,"A"
"2000-04-29",1999,"Hereford United","Welling United","1-2",1,2,5,5,3,-1,"A"
"2000-04-29",1999,"Morecambe","Kettering Town","2-1",2,1,5,5,3,1,"H"
"2000-04-29",1999,"Northwich Victoria","Sutton United","2-0",2,0,5,5,2,2,"H"
"2000-04-29",1999,"Nuneaton Town","Stevenage Borough","0-1",0,1,5,5,1,-1,"A"
"2000-04-29",1999,"Rushden & Diamonds","Scarborough","0-0",0,0,5,5,0,0,"D"
"2000-04-29",1999,"Woking","Kidderminster Harriers","1-0",1,0,5,5,1,1,"H"
"2000-05-01",1999,"Doncaster Rovers","Northwich Victoria","2-0",2,0,5,5,2,2,"H"
"2000-05-01",1999,"Kettering Town","Stevenage Borough","1-0",1,0,5,5,1,1,"H"
"2000-05-01",1999,"Kidderminster Harriers","Forest Green Rovers","3-3",3,3,5,5,6,0,"D"
"2000-05-01",1999,"Kingstonian","Hayes & Yeading","1-3",1,3,5,5,4,-2,"A"
"2000-05-01",1999,"Nuneaton Town","Hednesford Town","3-0",3,0,5,5,3,3,"H"
"2000-05-01",1999,"Scarborough","Morecambe","0-2",0,2,5,5,2,-2,"A"
"2000-05-01",1999,"Southport","Altrincham","2-0",2,0,5,5,2,2,"H"
"2000-05-01",1999,"Sutton United","Dover Athletic","0-1",0,1,5,5,1,-1,"A"
"2000-05-01",1999,"Welling United","Rushden & Diamonds","0-3",0,3,5,5,3,-3,"A"
"2000-05-01",1999,"Yeovil","Woking","0-3",0,3,5,5,3,-3,"A"
"2000-05-03",1999,"Altrincham","Kingstonian","1-3",1,3,5,5,4,-2,"A"
"2000-05-03",1999,"Northwich Victoria","Telford United","2-1",2,1,5,5,3,1,"H"
"2000-05-03",1999,"Sutton United","Kidderminster Harriers","0-3",0,3,5,5,3,-3,"A"
"2000-05-03",1999,"Woking","Dover Athletic","2-0",2,0,5,5,2,2,"H"
"2000-05-04",1999,"Southport","Kingstonian","0-0",0,0,5,5,0,0,"D"
"2000-05-06",1999,"Altrincham","Kidderminster Harriers","0-0",0,0,5,5,0,0,"D"
"2000-05-06",1999,"Dover Athletic","Telford United","3-0",3,0,5,5,3,3,"H"
"2000-05-06",1999,"Forest Green Rovers","Kettering Town","2-0",2,0,5,5,2,2,"H"
"2000-05-06",1999,"Hayes & Yeading","Nuneaton Town","3-0",3,0,5,5,3,3,"H"
"2000-05-06",1999,"Hednesford Town","Welling United","0-1",0,1,5,5,1,-1,"A"
"2000-05-06",1999,"Hereford United","Sutton United","4-1",4,1,5,5,5,3,"H"
"2000-05-06",1999,"Morecambe","Yeovil","1-1",1,1,5,5,2,0,"D"
"2000-05-06",1999,"Northwich Victoria","Kingstonian","0-3",0,3,5,5,3,-3,"A"
"2000-05-06",1999,"Rushden & Diamonds","Doncaster Rovers","0-0",0,0,5,5,0,0,"D"
"2000-05-06",1999,"Stevenage Borough","Southport","1-1",1,1,5,5,2,0,"D"
"2000-05-06",1999,"Woking","Scarborough","0-2",0,2,5,5,2,-2,"A"
"2001-01-05",2000,"Boston United","Stevenage Borough","3-3",3,3,5,5,6,0,"D"
"2001-01-05",2000,"Forest Green Rovers","Telford United","1-1",1,1,5,5,2,0,"D"
"2001-01-05",2000,"Hayes & Yeading","Hednesford Town","1-1",1,1,5,5,2,0,"D"
"2001-01-05",2000,"Kettering Town","Dover Athletic","0-2",0,2,5,5,2,-2,"A"
"2001-01-05",2000,"Northwich Victoria","Hereford United","1-0",1,0,5,5,1,1,"H"
"2001-01-05",2000,"Scarborough","Leigh Genesis","1-1",1,1,5,5,2,0,"D"
"2001-01-05",2000,"Southport","Rushden & Diamonds","1-3",1,3,5,5,4,-2,"A"
"2001-01-05",2000,"Woking","Doncaster Rovers","1-1",1,1,5,5,2,0,"D"
"2001-01-19",2000,"Boston United","Woking","0-0",0,0,5,5,0,0,"D"
"2001-01-19",2000,"Doncaster Rovers","Forest Green Rovers","3-0",3,0,5,5,3,3,"H"
"2001-01-19",2000,"Hereford United","Hayes & Yeading","3-2",3,2,5,5,5,1,"H"
"2001-01-19",2000,"Telford United","Nuneaton Town","2-1",2,1,5,5,3,1,"H"
"2001-01-19",2000,"Yeovil","Southport","0-1",0,1,5,5,1,-1,"A"
"2001-01-26",2000,"Chester","Morecambe","1-0",1,0,5,5,1,1,"H"
"2001-01-26",2000,"Dover Athletic","Doncaster Rovers","1-1",1,1,5,5,2,0,"D"
"2001-01-26",2000,"Forest Green Rovers","Northwich Victoria","1-0",1,0,5,5,1,1,"H"
"2001-01-26",2000,"Hednesford Town","Leigh Genesis","1-2",1,2,5,5,3,-1,"A"
"2001-01-26",2000,"Kettering Town","Hayes & Yeading","0-2",0,2,5,5,2,-2,"A"
"2001-01-26",2000,"Nuneaton Town","Woking","1-1",1,1,5,5,2,0,"D"
"2001-01-26",2000,"Scarborough","Southport","1-1",1,1,5,5,2,0,"D"
"2001-01-26",2000,"Stevenage Borough","Rushden & Diamonds","0-2",0,2,5,5,2,-2,"A"
"2001-01-26",2000,"Telford United","Hereford United","1-0",1,0,5,5,1,1,"H"
"2001-01-28",2000,"Hednesford Town","Yeovil","1-1",1,1,5,5,2,0,"D"
"2001-02-02",2000,"Northwich Victoria","Hednesford Town","2-2",2,2,5,5,4,0,"D"
"2001-02-02",2000,"Nuneaton Town","Doncaster Rovers","1-0",1,0,5,5,1,1,"H"
"2001-02-05",2000,"Telford United","Doncaster Rovers","1-0",1,0,5,5,1,1,"H"
"2001-02-09",2000,"Boston United","Leigh Genesis","0-1",0,1,5,5,1,-1,"A"
"2001-02-09",2000,"Chester","Yeovil","2-1",2,1,5,5,3,1,"H"
"2001-02-09",2000,"Doncaster Rovers","Kingstonian","0-2",0,2,5,5,2,-2,"A"
"2001-02-09",2000,"Forest Green Rovers","Rushden & Diamonds","0-0",0,0,5,5,0,0,"D"
"2001-02-09",2000,"Hednesford Town","Hereford United","0-3",0,3,5,5,3,-3,"A"
"2001-02-09",2000,"Kettering Town","Morecambe","1-5",1,5,5,5,6,-4,"A"
"2001-02-09",2000,"Nuneaton Town","Dagenham and Redbridge","2-0",2,0,5,5,2,2,"H"
"2001-02-09",2000,"Scarborough","Hayes & Yeading","2-0",2,0,5,5,2,2,"H"
"2001-02-09",2000,"Stevenage Borough","Northwich Victoria","3-1",3,1,5,5,4,2,"H"
"2001-02-09",2000,"Telford United","Southport","2-3",2,3,5,5,5,-1,"A"
"2001-02-09",2000,"Woking","Dover Athletic","4-1",4,1,5,5,5,3,"H"
"2001-02-12",2000,"Telford United","Hednesford Town","2-1",2,1,5,5,3,1,"H"
"2001-02-16",2000,"Dagenham and Redbridge","Kettering Town","5-1",5,1,5,5,6,4,"H"
"2001-02-16",2000,"Doncaster Rovers","Dover Athletic","1-1",1,1,5,5,2,0,"D"
"2001-02-16",2000,"Hayes & Yeading","Woking","1-2",1,2,5,5,3,-1,"A"
"2001-02-16",2000,"Hereford United","Nuneaton Town","0-1",0,1,5,5,1,-1,"A"
"2001-02-16",2000,"Kingstonian","Stevenage Borough","0-2",0,2,5,5,2,-2,"A"
"2001-02-16",2000,"Morecambe","Hednesford Town","0-0",0,0,5,5,0,0,"D"
"2001-02-16",2000,"Northwich Victoria","Chester","1-1",1,1,5,5,2,0,"D"
"2001-02-16",2000,"Rushden & Diamonds","Scarborough","1-0",1,0,5,5,1,1,"H"
"2001-02-16",2000,"Southport","Forest Green Rovers","1-1",1,1,5,5,2,0,"D"
"2001-02-16",2000,"Yeovil","Boston United","2-1",2,1,5,5,3,1,"H"
"2001-02-19",2000,"Chester","Telford United","1-0",1,0,5,5,1,1,"H"
"2001-02-19",2000,"Kingstonian","Kettering Town","0-1",0,1,5,5,1,-1,"A"
"2001-02-19",2000,"Rushden & Diamonds","Northwich Victoria","2-1",2,1,5,5,3,1,"H"
"2001-02-19",2000,"Yeovil","Dagenham and Redbridge","1-3",1,3,5,5,4,-2,"A"
"2001-02-23",2000,"Boston United","Northwich Victoria","1-1",1,1,5,5,2,0,"D"
"2001-02-23",2000,"Hednesford Town","Dagenham and Redbridge","0-2",0,2,5,5,2,-2,"A"
"2001-02-23",2000,"Nuneaton Town","Hayes & Yeading","1-1",1,1,5,5,2,0,"D"
"2001-02-23",2000,"Scarborough","Dover Athletic","2-0",2,0,5,5,2,2,"H"
"2001-02-23",2000,"Woking","Kettering Town","1-1",1,1,5,5,2,0,"D"
"2001-02-26",2000,"Chester","Boston United","2-2",2,2,5,5,4,0,"D"
"2001-02-26",2000,"Hayes & Yeading","Kingstonian","1-1",1,1,5,5,2,0,"D"
"2001-02-26",2000,"Woking","Telford United","3-0",3,0,5,5,3,3,"H"
"2001-03-02",2000,"Dagenham and Redbridge","Forest Green Rovers","3-1",3,1,5,5,4,2,"H"
"2001-03-02",2000,"Dover Athletic","Telford United","1-3",1,3,5,5,4,-2,"A"
"2001-03-02",2000,"Hayes & Yeading","Chester","1-3",1,3,5,5,4,-2,"A"
"2001-03-02",2000,"Kingstonian","Hednesford Town","1-0",1,0,5,5,1,1,"H"
"2001-03-02",2000,"Leigh Genesis","Nuneaton Town","6-2",6,2,5,5,8,4,"H"
"2001-03-02",2000,"Morecambe","Boston United","2-0",2,0,5,5,2,2,"H"
"2001-03-02",2000,"Northwich Victoria","Scarborough","3-0",3,0,5,5,3,3,"H"
"2001-03-02",2000,"Rushden & Diamonds","Woking","2-0",2,0,5,5,2,2,"H"
"2001-03-02",2000,"Southport","Kettering Town","2-3",2,3,5,5,5,-1,"A"
"2001-03-02",2000,"Yeovil","Stevenage Borough","1-1",1,1,5,5,2,0,"D"
"2001-03-05",2000,"Dagenham and Redbridge","Scarborough","1-0",1,0,5,5,1,1,"H"
"2001-03-05",2000,"Morecambe","Northwich Victoria","4-0",4,0,5,5,4,4,"H"
"2001-03-09",2000,"Boston United","Rushden & Diamonds","1-1",1,1,5,5,2,0,"D"
"2001-03-09",2000,"Kettering Town","Yeovil","2-1",2,1,5,5,3,1,"H"
"2001-03-09",2000,"Kingstonian","Morecambe","1-6",1,6,5,5,7,-5,"A"
"2001-03-09",2000,"Leigh Genesis","Hayes & Yeading","4-0",4,0,5,5,4,4,"H"
"2001-03-09",2000,"Northwich Victoria","Dover Athletic","2-0",2,0,5,5,2,2,"H"
"2001-03-11",2000,"Stevenage Borough","Hereford United","2-1",2,1,5,5,3,1,"H"
"2001-03-12",2000,"Hayes & Yeading","Forest Green Rovers","1-0",1,0,5,5,1,1,"H"
"2001-03-12",2000,"Kettering Town","Rushden & Diamonds","0-2",0,2,5,5,2,-2,"A"
"2001-03-12",2000,"Southport","Chester","1-0",1,0,5,5,1,1,"H"
"2001-03-12",2000,"Telford United","Kingstonian","0-1",0,1,5,5,1,-1,"A"
"2001-03-12",2000,"Woking","Morecambe","3-1",3,1,5,5,4,2,"H"
"2001-03-13",2000,"Yeovil","Nuneaton Town","0-0",0,0,5,5,0,0,"D"
"2001-03-16",2000,"Chester","Hednesford Town","0-1",0,1,5,5,1,-1,"A"
"2001-03-16",2000,"Doncaster Rovers","Boston United","4-2",4,2,5,5,6,2,"H"
"2001-03-16",2000,"Dover Athletic","Leigh Genesis","1-2",1,2,5,5,3,-1,"A"
"2001-03-16",2000,"Forest Green Rovers","Kettering Town","3-2",3,2,5,5,5,1,"H"
"2001-03-16",2000,"Hayes & Yeading","Northwich Victoria","2-2",2,2,5,5,4,0,"D"
"2001-03-16",2000,"Hereford United","Dagenham and Redbridge","0-1",0,1,5,5,1,-1,"A"
"2001-03-16",2000,"Morecambe","Yeovil","0-0",0,0,5,5,0,0,"D"
"2001-03-16",2000,"Rushden & Diamonds","Kingstonian","2-1",2,1,5,5,3,1,"H"
"2001-03-16",2000,"Southport","Nuneaton Town","1-2",1,2,5,5,3,-1,"A"
"2001-03-16",2000,"Woking","Scarborough","1-1",1,1,5,5,2,0,"D"
"2001-03-19",2000,"Dagenham and Redbridge","Stevenage Borough","3-0",3,0,5,5,3,3,"H"
"2001-03-22",2000,"Kettering Town","Telford United","0-1",0,1,5,5,1,-1,"A"
"2001-03-22",2000,"Leigh Genesis","Hereford United","2-1",2,1,5,5,3,1,"H"
"2001-03-22",2000,"Nuneaton Town","Chester","1-2",1,2,5,5,3,-1,"A"
"2001-03-23",2000,"Hednesford Town","Doncaster Rovers","2-4",2,4,5,5,6,-2,"A"
"2001-03-23",2000,"Yeovil","Hayes & Yeading","3-0",3,0,5,5,3,3,"H"
"2001-03-24",2000,"Boston United","Southport","1-0",1,0,5,5,1,1,"H"
"2001-03-24",2000,"Dagenham and Redbridge","Morecambe","3-2",3,2,5,5,5,1,"H"
"2001-03-24",2000,"Northwich Victoria","Rushden & Diamonds","0-0",0,0,5,5,0,0,"D"
"2001-03-24",2000,"Scarborough","Forest Green Rovers","1-0",1,0,5,5,1,1,"H"
"2001-03-25",2000,"Hednesford Town","Dover Athletic","0-0",0,0,5,5,0,0,"D"
"2001-03-25",2000,"Stevenage Borough","Woking","0-3",0,3,5,5,3,-3,"A"
"2001-03-26",2000,"Dagenham and Redbridge","Doncaster Rovers","2-1",2,1,5,5,3,1,"H"
"2001-03-26",2000,"Southport","Hereford United","1-1",1,1,5,5,2,0,"D"
"2001-03-26",2000,"Telford United","Chester","3-0",3,0,5,5,3,3,"H"
"2001-03-27",2000,"Forest Green Rovers","Leigh Genesis","3-1",3,1,5,5,4,2,"H"
"2001-03-30",2000,"Doncaster Rovers","Kettering Town","0-0",0,0,5,5,0,0,"D"
"2001-03-30",2000,"Dover Athletic","Yeovil","1-1",1,1,5,5,2,0,"D"
"2001-03-30",2000,"Hayes & Yeading","Dagenham and Redbridge","4-1",4,1,5,5,5,3,"H"
"2001-03-30",2000,"Morecambe","Stevenage Borough","1-2",1,2,5,5,3,-1,"A"
"2001-03-30",2000,"Nuneaton Town","Kingstonian","2-1",2,1,5,5,3,1,"H"
"2001-03-30",2000,"Rushden & Diamonds","Leigh Genesis","1-1",1,1,5,5,2,0,"D"
"2001-03-30",2000,"Southport","Northwich Victoria","1-1",1,1,5,5,2,0,"D"
"2001-03-30",2000,"Telford United","Boston United","3-2",3,2,5,5,5,1,"H"
"2001-04-01",2000,"Stevenage Borough","Hednesford Town","4-1",4,1,5,5,5,3,"H"
"2001-04-02",2000,"Dover Athletic","Chester","1-1",1,1,5,5,2,0,"D"
"2001-04-02",2000,"Hereford United","Woking","0-1",0,1,5,5,1,-1,"A"
"2001-04-02",2000,"Kingstonian","Scarborough","2-2",2,2,5,5,4,0,"D"
"2001-04-02",2000,"Leigh Genesis","Kettering Town","1-0",1,0,5,5,1,1,"H"
"2001-04-06",2000,"Dagenham and Redbridge","Telford United","0-0",0,0,5,5,0,0,"D"
"2001-04-06",2000,"Hayes & Yeading","Southport","1-0",1,0,5,5,1,1,"H"
"2001-04-06",2000,"Kingstonian","Yeovil","3-4",3,4,5,5,7,-1,"A"
"2001-04-06",2000,"Rushden & Diamonds","Morecambe","4-1",4,1,5,5,5,3,"H"
"2001-04-06",2000,"Scarborough","Kettering Town","0-1",0,1,5,5,1,-1,"A"
"2001-04-06",2000,"Stevenage Borough","Nuneaton Town","1-1",1,1,5,5,2,0,"D"
"2001-04-09",2000,"Doncaster Rovers","Yeovil","2-0",2,0,5,5,2,2,"H"
"2001-04-09",2000,"Dover Athletic","Hereford United","1-0",1,0,5,5,1,1,"H"
"2001-04-09",2000,"Leigh Genesis","Stevenage Borough","1-4",1,4,5,5,5,-3,"A"
"2001-04-09",2000,"Northwich Victoria","Kingstonian","2-1",2,1,5,5,3,1,"H"
"2001-04-09",2000,"Scarborough","Telford United","1-1",1,1,5,5,2,0,"D"
"2001-04-09",2000,"Woking","Southport","1-2",1,2,5,5,3,-1,"A"
"2001-04-10",2000,"Boston United","Dagenham and Redbridge","5-1",5,1,5,5,6,4,"H"
"2001-04-11",2000,"Nuneaton Town","Morecambe","5-1",5,1,5,5,6,4,"H"
"2001-04-13",2000,"Chester","Forest Green Rovers","0-1",0,1,5,5,1,-1,"A"
"2001-04-13",2000,"Doncaster Rovers","Hayes & Yeading","0-0",0,0,5,5,0,0,"D"
"2001-04-13",2000,"Hereford United","Rushden & Diamonds","3-1",3,1,5,5,4,2,"H"
"2001-04-13",2000,"Kettering Town","Hednesford Town","2-0",2,0,5,5,2,2,"H"
"2001-04-13",2000,"Morecambe","Dover Athletic","1-2",1,2,5,5,3,-1,"A"
"2001-04-13",2000,"Nuneaton Town","Scarborough","1-2",1,2,5,5,3,-1,"A"
"2001-04-13",2000,"Southport","Kingstonian","2-2",2,2,5,5,4,0,"D"
"2001-04-13",2000,"Telford United","Northwich Victoria","2-3",2,3,5,5,5,-1,"A"
"2001-04-13",2000,"Woking","Dagenham and Redbridge","4-4",4,4,5,5,8,0,"D"
"2001-04-13",2000,"Yeovil","Leigh Genesis","6-1",6,1,5,5,7,5,"H"
"2001-04-15",2000,"Dagenham and Redbridge","Yeovil","2-0",2,0,5,5,2,2,"H"
"2001-04-15",2000,"Dover Athletic","Southport","0-1",0,1,5,5,1,-1,"A"
"2001-04-15",2000,"Forest Green Rovers","Hereford United","1-1",1,1,5,5,2,0,"D"
"2001-04-15",2000,"Hayes & Yeading","Morecambe","1-1",1,1,5,5,2,0,"D"
"2001-04-15",2000,"Hednesford Town","Nuneaton Town","0-3",0,3,5,5,3,-3,"A"
"2001-04-15",2000,"Kingstonian","Telford United","0-1",0,1,5,5,1,-1,"A"
"2001-04-15",2000,"Leigh Genesis","Woking","2-0",2,0,5,5,2,2,"H"
"2001-04-15",2000,"Northwich Victoria","Kettering Town","1-2",1,2,5,5,3,-1,"A"
"2001-04-15",2000,"Rushden & Diamonds","Doncaster Rovers","0-0",0,0,5,5,0,0,"D"
"2001-04-15",2000,"Scarborough","Boston United","2-2",2,2,5,5,4,0,"D"
"2001-04-15",2000,"Stevenage Borough","Chester","1-2",1,2,5,5,3,-1,"A"
"2001-04-17",2000,"Hereford United","Kingstonian","0-0",0,0,5,5,0,0,"D"
"2001-04-17",2000,"Leigh Genesis","Chester","0-1",0,1,5,5,1,-1,"A"
"2001-04-17",2000,"Morecambe","Doncaster Rovers","2-1",2,1,5,5,3,1,"H"
"2001-04-17",2000,"Telford United","Stevenage Borough","2-2",2,2,5,5,4,0,"D"
"2001-04-18",2000,"Hednesford Town","Forest Green Rovers","1-1",1,1,5,5,2,0,"D"
"2001-04-20",2000,"Boston United","Kingstonian","2-1",2,1,5,5,3,1,"H"
"2001-04-20",2000,"Chester","Dagenham and Redbridge","1-1",1,1,5,5,2,0,"D"
"2001-04-20",2000,"Doncaster Rovers","Leigh Genesis","4-0",4,0,5,5,4,4,"H"
"2001-04-20",2000,"Hereford United","Scarborough","1-1",1,1,5,5,2,0,"D"
"2001-04-20",2000,"Kettering Town","Stevenage Borough","1-2",1,2,5,5,3,-1,"A"
"2001-04-20",2000,"Morecambe","Forest Green Rovers","0-2",0,2,5,5,2,-2,"A"
"2001-04-20",2000,"Nuneaton Town","Dover Athletic","1-2",1,2,5,5,3,-1,"A"
"2001-04-20",2000,"Southport","Hednesford Town","2-0",2,0,5,5,2,2,"H"
"2001-04-20",2000,"Woking","Northwich Victoria","1-1",1,1,5,5,2,0,"D"
"2001-04-20",2000,"Yeovil","Rushden & Diamonds","0-0",0,0,5,5,0,0,"D"
"2001-04-22",2000,"Hednesford Town","Boston United","2-4",2,4,5,5,6,-2,"A"
"2001-04-22",2000,"Stevenage Borough","Morecambe","1-1",1,1,5,5,2,0,"D"
"2001-04-23",2000,"Kettering Town","Chester","4-0",4,0,5,5,4,4,"H"
"2001-04-23",2000,"Kingstonian","Dover Athletic","0-0",0,0,5,5,0,0,"D"
"2001-04-23",2000,"Leigh Genesis","Yeovil","2-3",2,3,5,5,5,-1,"A"
"2001-04-23",2000,"Nuneaton Town","Northwich Victoria","3-1",3,1,5,5,4,2,"H"
"2001-04-23",2000,"Rushden & Diamonds","Telford United","3-0",3,0,5,5,3,3,"H"
"2001-04-24",2000,"Forest Green Rovers","Woking","0-0",0,0,5,5,0,0,"D"
"2001-04-25",2000,"Chester","Kingstonian","0-0",0,0,5,5,0,0,"D"
"2001-04-25",2000,"Leigh Genesis","Morecambe","1-0",1,0,5,5,1,1,"H"
"2001-04-27",2000,"Dagenham and Redbridge","Northwich Victoria","1-0",1,0,5,5,1,1,"H"
"2001-04-27",2000,"Forest Green Rovers","Southport","2-0",2,0,5,5,2,2,"H"
"2001-04-27",2000,"Hayes & Yeading","Boston United","1-1",1,1,5,5,2,0,"D"
"2001-04-27",2000,"Hereford United","Morecambe","2-2",2,2,5,5,4,0,"D"
"2001-04-27",2000,"Leigh Genesis","Kingstonian","2-1",2,1,5,5,3,1,"H"
"2001-04-27",2000,"Nuneaton Town","Kettering Town","1-1",1,1,5,5,2,0,"D"
"2001-04-27",2000,"Rushden & Diamonds","Dover Athletic","2-1",2,1,5,5,3,1,"H"
"2001-04-27",2000,"Scarborough","Hednesford Town","0-0",0,0,5,5,0,0,"D"
"2001-04-27",2000,"Stevenage Borough","Doncaster Rovers","0-0",0,0,5,5,0,0,"D"
"2001-04-27",2000,"Telford United","Yeovil","1-2",1,2,5,5,3,-1,"A"
"2001-04-27",2000,"Woking","Chester","1-0",1,0,5,5,1,1,"H"
"2001-04-29",2000,"Stevenage Borough","Southport","1-3",1,3,5,5,4,-2,"A"
"2001-04-30",2000,"Chester","Scarborough","3-2",3,2,5,5,5,1,"H"
"2001-04-30",2000,"Forest Green Rovers","Nuneaton Town","0-0",0,0,5,5,0,0,"D"
"2001-04-30",2000,"Telford United","Morecambe","2-0",2,0,5,5,2,2,"H"
"2001-04-30",2000,"Yeovil","Hereford United","2-3",2,3,5,5,5,-1,"A"
"2001-05-02",2000,"Morecambe","Dagenham and Redbridge","2-3",2,3,5,5,5,-1,"A"
"2001-05-04",2000,"Boston United","Hereford United","5-3",5,3,5,5,8,2,"H"
"2001-05-04",2000,"Chester","Rushden & Diamonds","1-2",1,2,5,5,3,-1,"A"
"2001-05-04",2000,"Doncaster Rovers","Telford United","1-2",1,2,5,5,3,-1,"A"
"2001-05-04",2000,"Dover Athletic","Stevenage Borough","1-0",1,0,5,5,1,1,"H"
"2001-05-04",2000,"Hednesford Town","Hayes & Yeading","1-3",1,3,5,5,4,-2,"A"
"2001-05-04",2000,"Kettering Town","Woking","2-0",2,0,5,5,2,2,"H"
"2001-05-04",2000,"Kingstonian","Forest Green Rovers","0-1",0,1,5,5,1,-1,"A"
"2001-05-04",2000,"Morecambe","Leigh Genesis","1-2",1,2,5,5,3,-1,"A"
"2001-05-04",2000,"Northwich Victoria","Nuneaton Town","2-2",2,2,5,5,4,0,"D"
"2001-05-04",2000,"Southport","Dagenham and Redbridge","0-1",0,1,5,5,1,-1,"A"
"2001-05-04",2000,"Yeovil","Scarborough","0-1",0,1,5,5,1,-1,"A"
"2001-08-18",2000,"Boston United","Forest Green Rovers","0-0",0,0,5,5,0,0,"D"
"2001-08-18",2000,"Doncaster Rovers","Nuneaton Town","1-1",1,1,5,5,2,0,"D"
"2001-08-18",2000,"Dover Athletic","Hednesford Town","4-0",4,0,5,5,4,4,"H"
"2001-08-18",2000,"Hereford United","Southport","0-0",0,0,5,5,0,0,"D"
"2001-08-18",2000,"Kingstonian","Northwich Victoria","1-0",1,0,5,5,1,1,"H"
"2001-08-18",2000,"Leigh Genesis","Dagenham and Redbridge","1-2",1,2,5,5,3,-1,"A"
"2001-08-18",2000,"Morecambe","Woking","3-0",3,0,5,5,3,3,"H"
"2001-08-18",2000,"Rushden & Diamonds","Chester","2-0",2,0,5,5,2,2,"H"
"2001-08-18",2000,"Stevenage Borough","Scarborough","1-1",1,1,5,5,2,0,"D"
"2001-08-18",2000,"Telford United","Hayes & Yeading","2-0",2,0,5,5,2,2,"H"
"2001-08-18",2000,"Yeovil","Kettering Town","2-0",2,0,5,5,2,2,"H"
"2001-08-20",2000,"Hednesford Town","Rushden & Diamonds","2-3",2,3,5,5,5,-1,"A"
"2001-08-21",2000,"Chester","Doncaster Rovers","3-0",3,0,5,5,3,3,"H"
"2001-08-21",2000,"Dagenham and Redbridge","Kingstonian","1-2",1,2,5,5,3,-1,"A"
"2001-08-21",2000,"Hayes & Yeading","Dover Athletic","3-2",3,2,5,5,5,1,"H"
"2001-08-21",2000,"Kettering Town","Hereford United","0-2",0,2,5,5,2,-2,"A"
"2001-08-21",2000,"Northwich Victoria","Telford United","0-1",0,1,5,5,1,-1,"A"
"2001-08-21",2000,"Nuneaton Town","Boston United","3-1",3,1,5,5,4,2,"H"
"2001-08-21",2000,"Scarborough","Morecambe","2-2",2,2,5,5,4,0,"D"
"2001-08-21",2000,"Southport","Leigh Genesis","1-2",1,2,5,5,3,-1,"A"
"2001-08-21",2000,"Woking","Yeovil","2-3",2,3,5,5,5,-1,"A"
"2001-08-22",2000,"Forest Green Rovers","Stevenage Borough","2-3",2,3,5,5,5,-1,"A"
"2001-08-25",2000,"Chester","Dover Athletic","1-0",1,0,5,5,1,1,"H"
"2001-08-25",2000,"Dagenham and Redbridge","Rushden & Diamonds","0-2",0,2,5,5,2,-2,"A"
"2001-08-25",2000,"Forest Green Rovers","Doncaster Rovers","2-2",2,2,5,5,4,0,"D"
"2001-08-25",2000,"Hayes & Yeading","Hereford United","0-2",0,2,5,5,2,-2,"A"
"2001-08-25",2000,"Hednesford Town","Stevenage Borough","1-1",1,1,5,5,2,0,"D"
"2001-08-25",2000,"Kettering Town","Leigh Genesis","0-1",0,1,5,5,1,-1,"A"
"2001-08-25",2000,"Northwich Victoria","Morecambe","1-0",1,0,5,5,1,1,"H"
"2001-08-25",2000,"Nuneaton Town","Telford United","1-1",1,1,5,5,2,0,"D"
"2001-08-25",2000,"Scarborough","Kingstonian","1-0",1,0,5,5,1,1,"H"
"2001-08-25",2000,"Southport","Yeovil","3-0",3,0,5,5,3,3,"H"
"2001-08-25",2000,"Woking","Boston United","1-1",1,1,5,5,2,0,"D"
"2001-08-27",2000,"Doncaster Rovers","Woking","0-1",0,1,5,5,1,-1,"A"
"2001-08-27",2000,"Dover Athletic","Kettering Town","1-0",1,0,5,5,1,1,"H"
"2001-08-27",2000,"Hereford United","Northwich Victoria","0-0",0,0,5,5,0,0,"D"
"2001-08-27",2000,"Kingstonian","Hayes & Yeading","0-1",0,1,5,5,1,-1,"A"
"2001-08-27",2000,"Leigh Genesis","Scarborough","2-0",2,0,5,5,2,2,"H"
"2001-08-27",2000,"Morecambe","Nuneaton Town","4-2",4,2,5,5,6,2,"H"
"2001-08-27",2000,"Rushden & Diamonds","Southport","4-0",4,0,5,5,4,4,"H"
"2001-08-27",2000,"Stevenage Borough","Dagenham and Redbridge","0-2",0,2,5,5,2,-2,"A"
"2001-08-27",2000,"Telford United","Forest Green Rovers","1-0",1,0,5,5,1,1,"H"
"2001-08-27",2000,"Yeovil","Hednesford Town","4-2",4,2,5,5,6,2,"H"
"2001-08-29",2000,"Boston United","Chester","0-0",0,0,5,5,0,0,"D"
"2001-09-01",2000,"Boston United","Dover Athletic","1-2",1,2,5,5,3,-1,"A"
"2001-09-01",2000,"Chester","Southport","0-1",0,1,5,5,1,-1,"A"
"2001-09-01",2000,"Doncaster Rovers","Morecambe","1-0",1,0,5,5,1,1,"H"
"2001-09-01",2000,"Forest Green Rovers","Hayes & Yeading","1-2",1,2,5,5,3,-1,"A"
"2001-09-01",2000,"Hednesford Town","Northwich Victoria","7-1",7,1,5,5,8,6,"H"
"2001-09-01",2000,"Kettering Town","Kingstonian","3-1",3,1,5,5,4,2,"H"
"2001-09-01",2000,"Nuneaton Town","Yeovil","0-2",0,2,5,5,2,-2,"A"
"2001-09-01",2000,"Scarborough","Dagenham and Redbridge","0-1",0,1,5,5,1,-1,"A"
"2001-09-01",2000,"Stevenage Borough","Leigh Genesis","3-0",3,0,5,5,3,3,"H"
"2001-09-01",2000,"Telford United","Rushden & Diamonds","1-2",1,2,5,5,3,-1,"A"
"2001-09-01",2000,"Woking","Hereford United","0-3",0,3,5,5,3,-3,"A"
"2001-09-04",2000,"Dagenham and Redbridge","Boston United","2-1",2,1,5,5,3,1,"H"
"2001-09-04",2000,"Dover Athletic","Forest Green Rovers","1-2",1,2,5,5,3,-1,"A"
"2001-09-04",2000,"Hayes & Yeading","Kettering Town","2-1",2,1,5,5,3,1,"H"
"2001-09-04",2000,"Hereford United","Telford United","2-0",2,0,5,5,2,2,"H"
"2001-09-04",2000,"Kingstonian","Nuneaton Town","2-2",2,2,5,5,4,0,"D"
"2001-09-04",2000,"Leigh Genesis","Hednesford Town","2-2",2,2,5,5,4,0,"D"
"2001-09-04",2000,"Morecambe","Chester","0-2",0,2,5,5,2,-2,"A"
"2001-09-04",2000,"Northwich Victoria","Doncaster Rovers","1-1",1,1,5,5,2,0,"D"
"2001-09-04",2000,"Rushden & Diamonds","Stevenage Borough","2-2",2,2,5,5,4,0,"D"
"2001-09-04",2000,"Southport","Scarborough","3-1",3,1,5,5,4,2,"H"
"2001-09-04",2000,"Yeovil","Woking","1-0",1,0,5,5,1,1,"H"
"2001-09-08",2000,"Dagenham and Redbridge","Nuneaton Town","1-1",1,1,5,5,2,0,"D"
"2001-09-08",2000,"Dover Athletic","Woking","0-0",0,0,5,5,0,0,"D"
"2001-09-08",2000,"Hayes & Yeading","Scarborough","0-1",0,1,5,5,1,-1,"A"
"2001-09-08",2000,"Hereford United","Hednesford Town","1-1",1,1,5,5,2,0,"D"
"2001-09-08",2000,"Kingstonian","Doncaster Rovers","1-1",1,1,5,5,2,0,"D"
"2001-09-08",2000,"Leigh Genesis","Boston United","2-2",2,2,5,5,4,0,"D"
"2001-09-08",2000,"Morecambe","Kettering Town","0-2",0,2,5,5,2,-2,"A"
"2001-09-08",2000,"Northwich Victoria","Stevenage Borough","3-2",3,2,5,5,5,1,"H"
"2001-09-08",2000,"Rushden & Diamonds","Forest Green Rovers","0-0",0,0,5,5,0,0,"D"
"2001-09-08",2000,"Southport","Telford United","3-0",3,0,5,5,3,3,"H"
"2001-09-08",2000,"Yeovil","Chester","2-1",2,1,5,5,3,1,"H"
"2001-09-10",2000,"Hednesford Town","Morecambe","0-0",0,0,5,5,0,0,"D"
"2001-09-10",2000,"Stevenage Borough","Dover Athletic","1-1",1,1,5,5,2,0,"D"
"2001-09-11",2000,"Chester","Northwich Victoria","1-1",1,1,5,5,2,0,"D"
"2001-09-11",2000,"Doncaster Rovers","Southport","1-0",1,0,5,5,1,1,"H"
"2001-09-11",2000,"Kettering Town","Dagenham and Redbridge","0-0",0,0,5,5,0,0,"D"
"2001-09-11",2000,"Nuneaton Town","Hereford United","1-2",1,2,5,5,3,-1,"A"
"2001-09-11",2000,"Scarborough","Rushden & Diamonds","0-3",0,3,5,5,3,-3,"A"
"2001-09-11",2000,"Telford United","Leigh Genesis","2-1",2,1,5,5,3,1,"H"
"2001-09-11",2000,"Woking","Hayes & Yeading","1-2",1,2,5,5,3,-1,"A"
"2001-09-12",2000,"Boston United","Yeovil","4-1",4,1,5,5,5,3,"H"
"2001-09-12",2000,"Forest Green Rovers","Kingstonian","3-1",3,1,5,5,4,2,"H"
"2001-09-15",2000,"Boston United","Morecambe","2-1",2,1,5,5,3,1,"H"
"2001-09-15",2000,"Doncaster Rovers","Hereford United","2-1",2,1,5,5,3,1,"H"
"2001-09-15",2000,"Forest Green Rovers","Dagenham and Redbridge","4-4",4,4,5,5,8,0,"D"
"2001-09-15",2000,"Hednesford Town","Kingstonian","3-2",3,2,5,5,5,1,"H"
"2001-09-15",2000,"Kettering Town","Southport","1-1",1,1,5,5,2,0,"D"
"2001-09-15",2000,"Nuneaton Town","Leigh Genesis","2-1",2,1,5,5,3,1,"H"
"2001-09-15",2000,"Scarborough","Northwich Victoria","4-0",4,0,5,5,4,4,"H"
"2001-09-15",2000,"Stevenage Borough","Yeovil","0-0",0,0,5,5,0,0,"D"
"2001-09-15",2000,"Telford United","Dover Athletic","0-2",0,2,5,5,2,-2,"A"
"2001-09-15",2000,"Woking","Rushden & Diamonds","1-4",1,4,5,5,5,-3,"A"
"2001-09-22",2000,"Dagenham and Redbridge","Hednesford Town","6-1",6,1,5,5,7,5,"H"
"2001-09-22",2000,"Dover Athletic","Scarborough","0-2",0,2,5,5,2,-2,"A"
"2001-09-22",2000,"Hayes & Yeading","Nuneaton Town","0-0",0,0,5,5,0,0,"D"
"2001-09-22",2000,"Hereford United","Stevenage Borough","1-1",1,1,5,5,2,0,"D"
"2001-09-22",2000,"Kingstonian","Chester","1-3",1,3,5,5,4,-2,"A"
"2001-09-22",2000,"Leigh Genesis","Forest Green Rovers","1-1",1,1,5,5,2,0,"D"
"2001-09-22",2000,"Morecambe","Telford United","0-0",0,0,5,5,0,0,"D"
"2001-09-22",2000,"Northwich Victoria","Boston United","0-3",0,3,5,5,3,-3,"A"
"2001-09-22",2000,"Rushden & Diamonds","Kettering Town","1-1",1,1,5,5,2,0,"D"
"2001-09-22",2000,"Southport","Woking","0-1",0,1,5,5,1,-1,"A"
"2001-09-22",2000,"Yeovil","Doncaster Rovers","2-0",2,0,5,5,2,2,"H"
"2001-09-25",2000,"Chester","Nuneaton Town","4-0",4,0,5,5,4,4,"H"
"2001-09-25",2000,"Doncaster Rovers","Hednesford Town","3-1",3,1,5,5,4,2,"H"
"2001-09-25",2000,"Dover Athletic","Kingstonian","1-3",1,3,5,5,4,-2,"A"
"2001-09-25",2000,"Hayes & Yeading","Yeovil","2-3",2,3,5,5,5,-1,"A"
"2001-09-25",2000,"Hereford United","Leigh Genesis","1-1",1,1,5,5,2,0,"D"
"2001-09-25",2000,"Rushden & Diamonds","Dagenham and Redbridge","2-1",2,1,5,5,3,1,"H"
"2001-09-25",2000,"Southport","Boston United","3-1",3,1,5,5,4,2,"H"
"2001-09-25",2000,"Telford United","Kettering Town","2-1",2,1,5,5,3,1,"H"
"2001-09-25",2000,"Woking","Stevenage Borough","1-1",1,1,5,5,2,0,"D"
"2001-09-26",2000,"Forest Green Rovers","Scarborough","2-3",2,3,5,5,5,-1,"A"
"2001-09-29",2000,"Boston United","Doncaster Rovers","3-1",3,1,5,5,4,2,"H"
"2001-09-29",2000,"Dagenham and Redbridge","Hereford United","2-1",2,1,5,5,3,1,"H"
"2001-09-29",2000,"Hednesford Town","Chester","0-0",0,0,5,5,0,0,"D"
"2001-09-29",2000,"Kettering Town","Forest Green Rovers","1-3",1,3,5,5,4,-2,"A"
"2001-09-29",2000,"Kingstonian","Rushden & Diamonds","2-4",2,4,5,5,6,-2,"A"
"2001-09-29",2000,"Leigh Genesis","Dover Athletic","2-1",2,1,5,5,3,1,"H"
"2001-09-29",2000,"Northwich Victoria","Hayes & Yeading","3-4",3,4,5,5,7,-1,"A"
"2001-09-29",2000,"Nuneaton Town","Southport","1-2",1,2,5,5,3,-1,"A"
"2001-09-29",2000,"Scarborough","Woking","3-2",3,2,5,5,5,1,"H"
"2001-09-29",2000,"Stevenage Borough","Telford United","5-3",5,3,5,5,8,2,"H"
"2001-09-29",2000,"Yeovil","Morecambe","3-2",3,2,5,5,5,1,"H"
"2001-10-01",2000,"Hednesford Town","Woking","1-2",1,2,5,5,3,-1,"A"
"2001-10-02",2000,"Dagenham and Redbridge","Hayes & Yeading","2-0",2,0,5,5,2,2,"H"
"2001-10-02",2000,"Kettering Town","Doncaster Rovers","0-0",0,0,5,5,0,0,"D"
"2001-10-02",2000,"Kingstonian","Hereford United","0-3",0,3,5,5,3,-3,"A"
"2001-10-02",2000,"Leigh Genesis","Rushden & Diamonds","1-0",1,0,5,5,1,1,"H"
"2001-10-02",2000,"Northwich Victoria","Southport","0-2",0,2,5,5,2,-2,"A"
"2001-10-02",2000,"Nuneaton Town","Forest Green Rovers","2-0",2,0,5,5,2,2,"H"
"2001-10-02",2000,"Scarborough","Chester","0-2",0,2,5,5,2,-2,"A"
"2001-10-02",2000,"Yeovil","Dover Athletic","4-0",4,0,5,5,4,4,"H"
"2001-10-03",2000,"Boston United","Telford United","2-1",2,1,5,5,3,1,"H"
"2001-10-05",2000,"Doncaster Rovers","Dagenham and Redbridge","1-0",1,0,5,5,1,1,"H"
"2001-10-05",2000,"Telford United","Scarborough","1-0",1,0,5,5,1,1,"H"
"2001-10-05",2000,"Woking","Nuneaton Town","0-2",0,2,5,5,2,-2,"A"
"2001-10-06",2000,"Hayes & Yeading","Leigh Genesis","1-2",1,2,5,5,3,-1,"A"
"2001-10-07",2000,"Chester","Kettering Town","2-1",2,1,5,5,3,1,"H"
"2001-10-07",2000,"Dover Athletic","Northwich Victoria","3-0",3,0,5,5,3,3,"H"
"2001-10-07",2000,"Forest Green Rovers","Hednesford Town","0-2",0,2,5,5,2,-2,"A"
"2001-10-07",2000,"Hereford United","Yeovil","2-2",2,2,5,5,4,0,"D"
"2001-10-07",2000,"Morecambe","Kingstonian","3-2",3,2,5,5,5,1,"H"
"2001-10-07",2000,"Rushden & Diamonds","Boston United","0-0",0,0,5,5,0,0,"D"
"2001-10-13",2000,"Dagenham and Redbridge","Woking","1-2",1,2,5,5,3,-1,"A"
"2001-10-13",2000,"Dover Athletic","Morecambe","2-2",2,2,5,5,4,0,"D"
"2001-10-13",2000,"Forest Green Rovers","Chester","1-1",1,1,5,5,2,0,"D"
"2001-10-13",2000,"Hayes & Yeading","Doncaster Rovers","0-3",0,3,5,5,3,-3,"A"
"2001-10-13",2000,"Hednesford Town","Kettering Town","1-2",1,2,5,5,3,-1,"A"
"2001-10-13",2000,"Kingstonian","Southport","3-1",3,1,5,5,4,2,"H"
"2001-10-13",2000,"Leigh Genesis","Telford United","1-1",1,1,5,5,2,0,"D"
"2001-10-13",2000,"Northwich Victoria","Yeovil","1-2",1,2,5,5,3,-1,"A"
"2001-10-13",2000,"Rushden & Diamonds","Hereford United","1-0",1,0,5,5,1,1,"H"
"2001-10-13",2000,"Scarborough","Nuneaton Town","0-0",0,0,5,5,0,0,"D"
"2001-10-13",2000,"Stevenage Borough","Boston United","3-2",3,2,5,5,5,1,"H"
"2001-10-19",2000,"Doncaster Rovers","Northwich Victoria","0-2",0,2,5,5,2,-2,"A"
"2001-10-20",2000,"Boston United","Hednesford Town","3-4",3,4,5,5,7,-1,"A"
"2001-10-20",2000,"Chester","Leigh Genesis","1-1",1,1,5,5,2,0,"D"
"2001-10-20",2000,"Hereford United","Dover Athletic","4-2",4,2,5,5,6,2,"H"
"2001-10-20",2000,"Kettering Town","Scarborough","1-1",1,1,5,5,2,0,"D"
"2001-10-20",2000,"Morecambe","Rushden & Diamonds","2-1",2,1,5,5,3,1,"H"
"2001-10-20",2000,"Nuneaton Town","Stevenage Borough","0-3",0,3,5,5,3,-3,"A"
"2001-10-20",2000,"Southport","Hayes & Yeading","2-0",2,0,5,5,2,2,"H"
"2001-10-20",2000,"Telford United","Dagenham and Redbridge","0-1",0,1,5,5,1,-1,"A"
"2001-10-20",2000,"Woking","Forest Green Rovers","2-0",2,0,5,5,2,2,"H"
"2001-10-20",2000,"Yeovil","Kingstonian","3-1",3,1,5,5,4,2,"H"
"2001-10-30",2000,"Northwich Victoria","Forest Green Rovers","0-0",0,0,5,5,0,0,"D"
"2001-10-30",2000,"Rushden & Diamonds","Hayes & Yeading","4-0",4,0,5,5,4,4,"H"
"2001-11-03",2000,"Dagenham and Redbridge","Chester","1-1",1,1,5,5,2,0,"D"
"2001-11-03",2000,"Dover Athletic","Nuneaton Town","2-1",2,1,5,5,3,1,"H"
"2001-11-03",2000,"Forest Green Rovers","Morecambe","0-0",0,0,5,5,0,0,"D"
"2001-11-03",2000,"Hayes & Yeading","Telford United","0-1",0,1,5,5,1,-1,"A"
"2001-11-03",2000,"Hednesford Town","Southport","0-1",0,1,5,5,1,-1,"A"
"2001-11-03",2000,"Kingstonian","Boston United","0-0",0,0,5,5,0,0,"D"
"2001-11-03",2000,"Leigh Genesis","Doncaster Rovers","0-1",0,1,5,5,1,-1,"A"
"2001-11-03",2000,"Northwich Victoria","Woking","4-0",4,0,5,5,4,4,"H"
"2001-11-03",2000,"Rushden & Diamonds","Yeovil","1-2",1,2,5,5,3,-1,"A"
"2001-11-03",2000,"Scarborough","Hereford United","2-4",2,4,5,5,6,-2,"A"
"2001-11-03",2000,"Stevenage Borough","Kettering Town","2-0",2,0,5,5,2,2,"H"
"2001-11-10",2000,"Boston United","Scarborough","2-2",2,2,5,5,4,0,"D"
"2001-11-10",2000,"Chester","Stevenage Borough","1-1",1,1,5,5,2,0,"D"
"2001-11-10",2000,"Doncaster Rovers","Rushden & Diamonds","3-2",3,2,5,5,5,1,"H"
"2001-11-10",2000,"Hereford United","Forest Green Rovers","3-1",3,1,5,5,4,2,"H"
"2001-11-10",2000,"Kettering Town","Northwich Victoria","2-3",2,3,5,5,5,-1,"A"
"2001-11-10",2000,"Morecambe","Hayes & Yeading","4-0",4,0,5,5,4,4,"H"
"2001-11-10",2000,"Nuneaton Town","Hednesford Town","5-1",5,1,5,5,6,4,"H"
"2001-11-10",2000,"Southport","Dover Athletic","2-1",2,1,5,5,3,1,"H"
"2001-11-10",2000,"Woking","Leigh Genesis","1-1",1,1,5,5,2,0,"D"
"2001-11-17",2000,"Dover Athletic","Boston United","0-0",0,0,5,5,0,0,"D"
"2001-11-17",2000,"Scarborough","Stevenage Borough","2-2",2,2,5,5,4,0,"D"
"2001-11-24",2000,"Dagenham and Redbridge","Southport","0-1",0,1,5,5,1,-1,"A"
"2001-11-24",2000,"Forest Green Rovers","Dover Athletic","2-1",2,1,5,5,3,1,"H"
"2001-11-24",2000,"Hereford United","Boston United","1-1",1,1,5,5,2,0,"D"
"2001-11-24",2000,"Scarborough","Yeovil","2-2",2,2,5,5,4,0,"D"
"2001-11-24",2000,"Stevenage Borough","Kingstonian","2-5",2,5,5,5,7,-3,"A"
"2001-11-27",2000,"Southport","Doncaster Rovers","1-0",1,0,5,5,1,1,"H"
"2001-12-01",2000,"Boston United","Hayes & Yeading","0-1",0,1,5,5,1,-1,"A"
"2001-12-01",2000,"Chester","Woking","3-3",3,3,5,5,6,0,"D"
"2001-12-01",2000,"Doncaster Rovers","Stevenage Borough","0-0",0,0,5,5,0,0,"D"
"2001-12-01",2000,"Dover Athletic","Rushden & Diamonds","4-1",4,1,5,5,5,3,"H"
"2001-12-01",2000,"Hednesford Town","Scarborough","0-1",0,1,5,5,1,-1,"A"
"2001-12-01",2000,"Kettering Town","Nuneaton Town","1-2",1,2,5,5,3,-1,"A"
"2001-12-01",2000,"Kingstonian","Leigh Genesis","0-2",0,2,5,5,2,-2,"A"
"2001-12-01",2000,"Morecambe","Hereford United","1-1",1,1,5,5,2,0,"D"
"2001-12-01",2000,"Northwich Victoria","Dagenham and Redbridge","3-0",3,0,5,5,3,3,"H"
"2001-12-01",2000,"Yeovil","Telford United","2-0",2,0,5,5,2,2,"H"
"2001-12-08",2000,"Hayes & Yeading","Rushden & Diamonds","0-3",0,3,5,5,3,-3,"A"
"2001-12-08",2000,"Hereford United","Doncaster Rovers","0-1",0,1,5,5,1,-1,"A"
"2001-12-08",2000,"Woking","Hednesford Town","1-1",1,1,5,5,2,0,"D"
"2001-12-15",2000,"Boston United","Nuneaton Town","4-1",4,1,5,5,5,3,"H"
"2001-12-15",2000,"Doncaster Rovers","Chester","1-0",1,0,5,5,1,1,"H"
"2001-12-15",2000,"Dover Athletic","Hayes & Yeading","4-1",4,1,5,5,5,3,"H"
"2001-12-15",2000,"Hereford United","Kettering Town","0-0",0,0,5,5,0,0,"D"
"2001-12-15",2000,"Kingstonian","Dagenham and Redbridge","2-3",2,3,5,5,5,-1,"A"
"2001-12-15",2000,"Leigh Genesis","Southport","2-2",2,2,5,5,4,0,"D"
"2001-12-15",2000,"Morecambe","Scarborough","4-4",4,4,5,5,8,0,"D"
"2001-12-15",2000,"Rushden & Diamonds","Hednesford Town","5-1",5,1,5,5,6,4,"H"
"2001-12-15",2000,"Stevenage Borough","Forest Green Rovers","3-1",3,1,5,5,4,2,"H"
"2001-12-15",2000,"Telford United","Woking","3-1",3,1,5,5,4,2,"H"
"2001-12-15",2000,"Yeovil","Northwich Victoria","1-0",1,0,5,5,1,1,"H"
"2001-12-21",2000,"Stevenage Borough","Southport","2-2",2,2,5,5,4,0,"D"
"2001-12-22",2000,"Chester","Hayes & Yeading","0-0",0,0,5,5,0,0,"D"
"2001-12-25",2000,"Chester","Hereford United","2-1",2,1,5,5,3,1,"H"
"2001-12-25",2000,"Dagenham and Redbridge","Dover Athletic","1-1",1,1,5,5,2,0,"D"
"2001-12-25",2000,"Forest Green Rovers","Yeovil","0-1",0,1,5,5,1,-1,"A"
"2001-12-25",2000,"Hayes & Yeading","Stevenage Borough","0-1",0,1,5,5,1,-1,"A"
"2001-12-25",2000,"Hednesford Town","Telford United","1-1",1,1,5,5,2,0,"D"
"2001-12-25",2000,"Kettering Town","Boston United","2-2",2,2,5,5,4,0,"D"
"2001-12-25",2000,"Northwich Victoria","Leigh Genesis","1-1",1,1,5,5,2,0,"D"
"2001-12-25",2000,"Nuneaton Town","Rushden & Diamonds","1-1",1,1,5,5,2,0,"D"
"2001-12-25",2000,"Scarborough","Doncaster Rovers","3-1",3,1,5,5,4,2,"H"
"2001-12-25",2000,"Southport","Morecambe","1-2",1,2,5,5,3,-1,"A"
"2001-12-25",2000,"Woking","Kingstonian","0-0",0,0,5,5,0,0,"D"
"2001-12-29",2000,"Dagenham and Redbridge","Leigh Genesis","2-1",2,1,5,5,3,1,"H"
"2001-12-29",2000,"Forest Green Rovers","Boston United","0-3",0,3,5,5,3,-3,"A"
"2001-12-31",2000,"Boston United","Kettering Town","4-3",4,3,5,5,7,1,"H"
"2001-12-31",2000,"Doncaster Rovers","Scarborough","0-2",0,2,5,5,2,-2,"A"
"2001-12-31",2000,"Dover Athletic","Dagenham and Redbridge","3-1",3,1,5,5,4,2,"H"
"2001-12-31",2000,"Hereford United","Chester","2-0",2,0,5,5,2,2,"H"
"2001-12-31",2000,"Kingstonian","Woking","0-3",0,3,5,5,3,-3,"A"
"2001-12-31",2000,"Leigh Genesis","Northwich Victoria","3-0",3,0,5,5,3,3,"H"
"2001-12-31",2000,"Morecambe","Southport","1-3",1,3,5,5,4,-2,"A"
"2001-12-31",2000,"Rushden & Diamonds","Nuneaton Town","2-1",2,1,5,5,3,1,"H"
"2001-12-31",2000,"Stevenage Borough","Hayes & Yeading","3-3",3,3,5,5,6,0,"D"
"2001-12-31",2000,"Yeovil","Forest Green Rovers","2-0",2,0,5,5,2,2,"H"
"2002-01-04",2001,"Forest Green Rovers","Hereford United","1-1",1,1,5,5,2,0,"D"
"2002-01-04",2001,"Woking","Yeovil","0-2",0,2,5,5,2,-2,"A"
"2002-01-05",2001,"Hayes & Yeading","Dover Athletic","2-1",2,1,5,5,3,1,"H"
"2002-01-05",2001,"Margate","Farnborough Town","2-1",2,1,5,5,3,1,"H"
"2002-01-05",2001,"Nuneaton Town","Stevenage Borough","2-1",2,1,5,5,3,1,"H"
"2002-01-05",2001,"Southport","Leigh Genesis","5-0",5,0,5,5,5,5,"H"
"2002-01-08",2001,"Chester","Northwich Victoria","1-2",1,2,5,5,3,-1,"A"
"2002-01-15",2001,"Scarborough","Doncaster Rovers","1-0",1,0,5,5,1,1,"H"
"2002-01-18",2001,"Chester","Barnet","1-0",1,0,5,5,1,1,"H"
"2002-01-18",2001,"Dover Athletic","Doncaster Rovers","0-1",0,1,5,5,1,-1,"A"
"2002-01-18",2001,"Hereford United","Margate","3-0",3,0,5,5,3,3,"H"
"2002-01-18",2001,"Leigh Genesis","Telford United","3-1",3,1,5,5,4,2,"H"
"2002-01-18",2001,"Scarborough","Woking","1-0",1,0,5,5,1,1,"H"
"2002-01-18",2001,"Stevenage Borough","Southport","2-1",2,1,5,5,3,1,"H"
"2002-01-19",2001,"Boston United","Northwich Victoria","3-2",3,2,5,5,5,1,"H"
"2002-01-19",2001,"Dagenham and Redbridge","Forest Green Rovers","1-1",1,1,5,5,2,0,"D"
"2002-01-19",2001,"Farnborough Town","Stalybridge Celtic","2-0",2,0,5,5,2,2,"H"
"2002-01-19",2001,"Morecambe","Hayes & Yeading","2-1",2,1,5,5,3,1,"H"
"2002-01-19",2001,"Yeovil","Nuneaton Town","2-1",2,1,5,5,3,1,"H"
"2002-01-22",2001,"Telford United","Chester","0-3",0,3,5,5,3,-3,"A"
"2002-01-25",2001,"Doncaster Rovers","Stevenage Borough","2-0",2,0,5,5,2,2,"H"
"2002-01-25",2001,"Hayes & Yeading","Yeovil","0-4",0,4,5,5,4,-4,"A"
"2002-01-26",2001,"Margate","Scarborough","1-1",1,1,5,5,2,0,"D"
"2002-01-26",2001,"Northwich Victoria","Leigh Genesis","0-3",0,3,5,5,3,-3,"A"
"2002-01-26",2001,"Southport","Hereford United","1-1",1,1,5,5,2,0,"D"
"2002-01-26",2001,"Stalybridge Celtic","Boston United","2-1",2,1,5,5,3,1,"H"
"2002-01-28",2001,"Northwich Victoria","Morecambe","4-3",4,3,5,5,7,1,"H"
"2002-01-29",2001,"Yeovil","Forest Green Rovers","2-2",2,2,5,5,4,0,"D"
"2002-02-02",2001,"Southport","Nuneaton Town","1-1",1,1,5,5,2,0,"D"
"2002-02-08",2001,"Forest Green Rovers","Doncaster Rovers","0-2",0,2,5,5,2,-2,"A"
"2002-02-08",2001,"Morecambe","Yeovil","1-5",1,5,5,5,6,-4,"A"
"2002-02-08",2001,"Telford United","Southport","1-1",1,1,5,5,2,0,"D"
"2002-02-09",2001,"Barnet","Stalybridge Celtic","1-2",1,2,5,5,3,-1,"A"
"2002-02-09",2001,"Dagenham and Redbridge","Farnborough Town","2-1",2,1,5,5,3,1,"H"
"2002-02-09",2001,"Hereford United","Leigh Genesis","0-1",0,1,5,5,1,-1,"A"
"2002-02-09",2001,"Margate","Chester","0-0",0,0,5,5,0,0,"D"
"2002-02-09",2001,"Northwich Victoria","Dover Athletic","2-1",2,1,5,5,3,1,"H"
"2002-02-09",2001,"Stevenage Borough","Woking","1-4",1,4,5,5,5,-3,"A"
"2002-02-12",2001,"Dagenham and Redbridge","Hayes & Yeading","1-1",1,1,5,5,2,0,"D"
"2002-02-14",2001,"Hayes & Yeading","Northwich Victoria","1-2",1,2,5,5,3,-1,"A"
"2002-02-14",2001,"Leigh Genesis","Barnet","3-3",3,3,5,5,6,0,"D"
"2002-02-14",2001,"Stalybridge Celtic","Nuneaton Town","4-2",4,2,5,5,6,2,"H"
"2002-02-14",2001,"Yeovil","Dagenham and Redbridge","3-3",3,3,5,5,6,0,"D"
"2002-02-16",2001,"Doncaster Rovers","Margate","1-0",1,0,5,5,1,1,"H"
"2002-02-16",2001,"Dover Athletic","Scarborough","0-2",0,2,5,5,2,-2,"A"
"2002-02-16",2001,"Farnborough Town","Telford United","1-1",1,1,5,5,2,0,"D"
"2002-02-16",2001,"Southport","Woking","2-0",2,0,5,5,2,2,"H"
"2002-02-16",2001,"Stevenage Borough","Forest Green Rovers","4-1",4,1,5,5,5,3,"H"
"2002-02-18",2001,"Boston United","Hereford United","3-4",3,4,5,5,7,-1,"A"
"2002-02-19",2001,"Barnet","Farnborough Town","0-3",0,3,5,5,3,-3,"A"
"2002-02-19",2001,"Nuneaton Town","Chester","1-3",1,3,5,5,4,-2,"A"
"2002-02-20",2001,"Forest Green Rovers","Dover Athletic","2-1",2,1,5,5,3,1,"H"
"2002-02-23",2001,"Dagenham and Redbridge","Dover Athletic","1-0",1,0,5,5,1,1,"H"
"2002-02-23",2001,"Nuneaton Town","Farnborough Town","1-1",1,1,5,5,2,0,"D"
"2002-02-26",2001,"Stalybridge Celtic","Leigh Genesis","0-1",0,1,5,5,1,-1,"A"
"2002-03-01",2001,"Dover Athletic","Farnborough Town","2-1",2,1,5,5,3,1,"H"
"2002-03-01",2001,"Hayes & Yeading","Barnet","0-2",0,2,5,5,2,-2,"A"
"2002-03-01",2001,"Nuneaton Town","Doncaster Rovers","2-3",2,3,5,5,5,-1,"A"
"2002-03-01",2001,"Telford United","Northwich Victoria","1-0",1,0,5,5,1,1,"H"
"2002-03-02",2001,"Chester","Leigh Genesis","1-1",1,1,5,5,2,0,"D"
"2002-03-02",2001,"Morecambe","Scarborough","2-0",2,0,5,5,2,2,"H"
"2002-03-02",2001,"Southport","Stalybridge Celtic","3-1",3,1,5,5,4,2,"H"
"2002-03-02",2001,"Stevenage Borough","Margate","3-1",3,1,5,5,4,2,"H"
"2002-03-02",2001,"Woking","Forest Green Rovers","3-4",3,4,5,5,7,-1,"A"
"2002-03-02",2001,"Yeovil","Hereford United","2-1",2,1,5,5,3,1,"H"
"2002-03-04",2001,"Dagenham and Redbridge","Boston United","1-0",1,0,5,5,1,1,"H"
"2002-03-05",2001,"Chester","Scarborough","0-0",0,0,5,5,0,0,"D"
"2002-03-05",2001,"Farnborough Town","Woking","0-1",0,1,5,5,1,-1,"A"
"2002-03-05",2001,"Hereford United","Telford United","0-1",0,1,5,5,1,-1,"A"
"2002-03-05",2001,"Leigh Genesis","Stalybridge Celtic","1-0",1,0,5,5,1,1,"H"
"2002-03-08",2001,"Barnet","Morecambe","1-0",1,0,5,5,1,1,"H"
"2002-03-08",2001,"Farnborough Town","Yeovil","1-3",1,3,5,5,4,-2,"A"
"2002-03-08",2001,"Northwich Victoria","Southport","3-1",3,1,5,5,4,2,"H"
"2002-03-08",2001,"Scarborough","Stevenage Borough","1-1",1,1,5,5,2,0,"D"
"2002-03-08",2001,"Stalybridge Celtic","Chester","0-4",0,4,5,5,4,-4,"A"
"2002-03-09",2001,"Boston United","Dover Athletic","4-2",4,2,5,5,6,2,"H"
"2002-03-09",2001,"Doncaster Rovers","Telford United","1-0",1,0,5,5,1,1,"H"
"2002-03-09",2001,"Forest Green Rovers","Hayes & Yeading","2-1",2,1,5,5,3,1,"H"
"2002-03-09",2001,"Leigh Genesis","Nuneaton Town","0-1",0,1,5,5,1,-1,"A"
"2002-03-09",2001,"Margate","Woking","4-3",4,3,5,5,7,1,"H"
"2002-03-10",2001,"Stevenage Borough","Dagenham and Redbridge","1-3",1,3,5,5,4,-2,"A"
"2002-03-11",2001,"Doncaster Rovers","Boston United","0-1",0,1,5,5,1,-1,"A"
"2002-03-11",2001,"Hayes & Yeading","Margate","2-4",2,4,5,5,6,-2,"A"
"2002-03-11",2001,"Leigh Genesis","Morecambe","0-1",0,1,5,5,1,-1,"A"
"2002-03-12",2001,"Farnborough Town","Hereford United","4-2",4,2,5,5,6,2,"H"
"2002-03-12",2001,"Stalybridge Celtic","Scarborough","2-3",2,3,5,5,5,-1,"A"
"2002-03-16",2001,"Boston United","Telford United","3-1",3,1,5,5,4,2,"H"
"2002-03-16",2001,"Dover Athletic","Hereford United","0-1",0,1,5,5,1,-1,"A"
"2002-03-16",2001,"Forest Green Rovers","Leigh Genesis","1-2",1,2,5,5,3,-1,"A"
"2002-03-16",2001,"Hayes & Yeading","Scarborough","1-2",1,2,5,5,3,-1,"A"
"2002-03-16",2001,"Southport","Barnet","0-1",0,1,5,5,1,-1,"A"
"2002-03-16",2001,"Woking","Doncaster Rovers","3-1",3,1,5,5,4,2,"H"
"2002-03-19",2001,"Barnet","Dagenham and Redbridge","4-0",4,0,5,5,4,4,"H"
"2002-03-19",2001,"Doncaster Rovers","Northwich Victoria","2-2",2,2,5,5,4,0,"D"
"2002-03-19",2001,"Morecambe","Southport","2-2",2,2,5,5,4,0,"D"
"2002-03-20",2001,"Boston United","Nuneaton Town","4-1",4,1,5,5,5,3,"H"
"2002-03-22",2001,"Doncaster Rovers","Hayes & Yeading","5-2",5,2,5,5,7,3,"H"
"2002-03-22",2001,"Hereford United","Morecambe","0-2",0,2,5,5,2,-2,"A"
"2002-03-22",2001,"Margate","Southport","2-0",2,0,5,5,2,2,"H"
"2002-03-23",2001,"Barnet","Telford United","0-0",0,0,5,5,0,0,"D"
"2002-03-23",2001,"Boston United","Chester","0-1",0,1,5,5,1,-1,"A"
"2002-03-23",2001,"Farnborough Town","Stevenage Borough","6-1",6,1,5,5,7,5,"H"
"2002-03-23",2001,"Forest Green Rovers","Nuneaton Town","1-2",1,2,5,5,3,-1,"A"
"2002-03-23",2001,"Leigh Genesis","Dagenham and Redbridge","2-0",2,0,5,5,2,2,"H"
"2002-03-23",2001,"Northwich Victoria","Woking","0-3",0,3,5,5,3,-3,"A"
"2002-03-23",2001,"Scarborough","Yeovil","0-0",0,0,5,5,0,0,"D"
"2002-03-23",2001,"Stalybridge Celtic","Dover Athletic","0-2",0,2,5,5,2,-2,"A"
"2002-03-25",2001,"Dover Athletic","Margate","0-0",0,0,5,5,0,0,"D"
"2002-03-25",2001,"Stevenage Borough","Barnet","3-2",3,2,5,5,5,1,"H"
"2002-03-26",2001,"Hereford United","Chester","1-0",1,0,5,5,1,1,"H"
"2002-03-26",2001,"Morecambe","Dagenham and Redbridge","1-1",1,1,5,5,2,0,"D"
"2002-03-26",2001,"Stalybridge Celtic","Forest Green Rovers","2-1",2,1,5,5,3,1,"H"
"2002-03-26",2001,"Woking","Hayes & Yeading","0-1",0,1,5,5,1,-1,"A"
"2002-03-26",2001,"Yeovil","Boston United","0-1",0,1,5,5,1,-1,"A"
"2002-03-29",2001,"Boston United","Barnet","1-1",1,1,5,5,2,0,"D"
"2002-03-29",2001,"Forest Green Rovers","Telford United","1-1",1,1,5,5,2,0,"D"
"2002-03-29",2001,"Hayes & Yeading","Farnborough Town","0-3",0,3,5,5,3,-3,"A"
"2002-03-29",2001,"Northwich Victoria","Margate","1-1",1,1,5,5,2,0,"D"
"2002-03-29",2001,"Nuneaton Town","Dagenham and Redbridge","2-0",2,0,5,5,2,2,"H"
"2002-03-29",2001,"Woking","Leigh Genesis","1-1",1,1,5,5,2,0,"D"
"2002-03-30",2001,"Doncaster Rovers","Chester","2-0",2,0,5,5,2,2,"H"
"2002-03-30",2001,"Morecambe","Stevenage Borough","0-3",0,3,5,5,3,-3,"A"
"2002-03-30",2001,"Scarborough","Hereford United","3-2",3,2,5,5,5,1,"H"
"2002-03-30",2001,"Yeovil","Stalybridge Celtic","0-2",0,2,5,5,2,-2,"A"
"2002-03-31",2001,"Chester","Yeovil","1-1",1,1,5,5,2,0,"D"
"2002-03-31",2001,"Leigh Genesis","Scarborough","1-1",1,1,5,5,2,0,"D"
"2002-03-31",2001,"Southport","Boston United","2-3",2,3,5,5,5,-1,"A"
"2002-03-31",2001,"Stalybridge Celtic","Doncaster Rovers","1-0",1,0,5,5,1,1,"H"
"2002-04-01",2001,"Barnet","Nuneaton Town","0-1",0,1,5,5,1,-1,"A"
"2002-04-01",2001,"Dagenham and Redbridge","Morecambe","3-2",3,2,5,5,5,1,"H"
"2002-04-01",2001,"Farnborough Town","Northwich Victoria","4-1",4,1,5,5,5,3,"H"
"2002-04-01",2001,"Hereford United","Woking","2-2",2,2,5,5,4,0,"D"
"2002-04-01",2001,"Margate","Forest Green Rovers","1-1",1,1,5,5,2,0,"D"
"2002-04-01",2001,"Stevenage Borough","Dover Athletic","1-3",1,3,5,5,4,-2,"A"
"2002-04-01",2001,"Telford United","Hayes & Yeading","1-2",1,2,5,5,3,-1,"A"
"2002-04-03",2001,"Telford United","Morecambe","4-1",4,1,5,5,5,3,"H"
"2002-04-05",2001,"Dover Athletic","Leigh Genesis","0-0",0,0,5,5,0,0,"D"
"2002-04-05",2001,"Forest Green Rovers","Chester","0-2",0,2,5,5,2,-2,"A"
"2002-04-05",2001,"Hayes & Yeading","Stalybridge Celtic","0-0",0,0,5,5,0,0,"D"
"2002-04-05",2001,"Woking","Barnet","1-3",1,3,5,5,4,-2,"A"
"2002-04-06",2001,"Doncaster Rovers","Hereford United","4-0",4,0,5,5,4,4,"H"
"2002-04-06",2001,"Northwich Victoria","Dagenham and Redbridge","1-2",1,2,5,5,3,-1,"A"
"2002-04-06",2001,"Nuneaton Town","Margate","0-0",0,0,5,5,0,0,"D"
"2002-04-06",2001,"Scarborough","Telford United","3-1",3,1,5,5,4,2,"H"
"2002-04-07",2001,"Dover Athletic","Woking","2-2",2,2,5,5,4,0,"D"
"2002-04-07",2001,"Telford United","Margate","2-0",2,0,5,5,2,2,"H"
"2002-04-08",2001,"Boston United","Stevenage Borough","0-0",0,0,5,5,0,0,"D"
"2002-04-08",2001,"Dagenham and Redbridge","Stalybridge Celtic","2-1",2,1,5,5,3,1,"H"
"2002-04-08",2001,"Morecambe","Forest Green Rovers","2-0",2,0,5,5,2,2,"H"
"2002-04-10",2001,"Nuneaton Town","Northwich Victoria","0-1",0,1,5,5,1,-1,"A"
"2002-04-10",2001,"Scarborough","Southport","2-0",2,0,5,5,2,2,"H"
"2002-04-13",2001,"Barnet","Forest Green Rovers","0-1",0,1,5,5,1,-1,"A"
"2002-04-13",2001,"Chester","Dover Athletic","3-0",3,0,5,5,3,3,"H"
"2002-04-13",2001,"Dagenham and Redbridge","Doncaster Rovers","1-0",1,0,5,5,1,1,"H"
"2002-04-13",2001,"Farnborough Town","Scarborough","4-2",4,2,5,5,6,2,"H"
"2002-04-13",2001,"Hereford United","Northwich Victoria","1-0",1,0,5,5,1,1,"H"
"2002-04-13",2001,"Leigh Genesis","Boston United","1-2",1,2,5,5,3,-1,"A"
"2002-04-13",2001,"Southport","Hayes & Yeading","2-3",2,3,5,5,5,-1,"A"
"2002-04-13",2001,"Stalybridge Celtic","Woking","0-2",0,2,5,5,2,-2,"A"
"2002-04-13",2001,"Telford United","Nuneaton Town","0-2",0,2,5,5,2,-2,"A"
"2002-04-15",2001,"Stevenage Borough","Leigh Genesis","0-1",0,1,5,5,1,-1,"A"
"2002-04-16",2001,"Chester","Farnborough Town","1-0",1,0,5,5,1,1,"H"
"2002-04-16",2001,"Hereford United","Dagenham and Redbridge","1-0",1,0,5,5,1,1,"H"
"2002-04-16",2001,"Northwich Victoria","Stalybridge Celtic","1-0",1,0,5,5,1,1,"H"
"2002-04-16",2001,"Scarborough","Boston United","2-0",2,0,5,5,2,2,"H"
"2002-04-16",2001,"Yeovil","Barnet","1-2",1,2,5,5,3,-1,"A"
"2002-04-17",2001,"Stevenage Borough","Yeovil","2-3",2,3,5,5,5,-1,"A"
"2002-04-18",2001,"Margate","Morecambe","1-1",1,1,5,5,2,0,"D"
"2002-04-19",2001,"Dover Athletic","Morecambe","1-1",1,1,5,5,2,0,"D"
"2002-04-19",2001,"Forest Green Rovers","Northwich Victoria","2-0",2,0,5,5,2,2,"H"
"2002-04-19",2001,"Leigh Genesis","Yeovil","0-1",0,1,5,5,1,-1,"A"
"2002-04-19",2001,"Stalybridge Celtic","Telford United","0-2",0,2,5,5,2,-2,"A"
"2002-04-19",2001,"Woking","Nuneaton Town","0-0",0,0,5,5,0,0,"D"
"2002-04-20",2001,"Barnet","Margate","4-1",4,1,5,5,5,3,"H"
"2002-04-20",2001,"Boston United","Farnborough Town","4-0",4,0,5,5,4,4,"H"
"2002-04-20",2001,"Chester","Stevenage Borough","5-1",5,1,5,5,6,4,"H"
"2002-04-20",2001,"Doncaster Rovers","Southport","1-0",1,0,5,5,1,1,"H"
"2002-04-20",2001,"Hereford United","Hayes & Yeading","0-1",0,1,5,5,1,-1,"A"
"2002-04-20",2001,"Scarborough","Dagenham and Redbridge","0-0",0,0,5,5,0,0,"D"
"2002-04-22",2001,"Barnet","Doncaster Rovers","2-0",2,0,5,5,2,2,"H"
"2002-04-22",2001,"Stevenage Borough","Northwich Victoria","1-0",1,0,5,5,1,1,"H"
"2002-04-23",2001,"Morecambe","Boston United","0-0",0,0,5,5,0,0,"D"
"2002-04-23",2001,"Woking","Dagenham and Redbridge","0-2",0,2,5,5,2,-2,"A"
"2002-04-23",2001,"Yeovil","Southport","0-0",0,0,5,5,0,0,"D"
"2002-04-25",2001,"Morecambe","Farnborough Town","1-1",1,1,5,5,2,0,"D"
"2002-04-27",2001,"Farnborough Town","Leigh Genesis","3-0",3,0,5,5,3,3,"H"
"2002-04-27",2001,"Margate","Stalybridge Celtic","8-0",8,0,5,5,8,8,"H"
"2002-04-27",2001,"Morecambe","Doncaster Rovers","2-1",2,1,5,5,3,1,"H"
"2002-04-27",2001,"Northwich Victoria","Barnet","0-3",0,3,5,5,3,-3,"A"
"2002-04-27",2001,"Nuneaton Town","Scarborough","1-2",1,2,5,5,3,-1,"A"
"2002-04-27",2001,"Southport","Forest Green Rovers","5-1",5,1,5,5,6,4,"H"
"2002-04-27",2001,"Stevenage Borough","Hereford United","3-1",3,1,5,5,4,2,"H"
"2002-04-27",2001,"Telford United","Woking","3-3",3,3,5,5,6,0,"D"
"2002-04-27",2001,"Yeovil","Dover Athletic","2-0",2,0,5,5,2,2,"H"
"2002-04-28",2001,"Dagenham and Redbridge","Chester","3-0",3,0,5,5,3,3,"H"
"2002-04-28",2001,"Hayes & Yeading","Boston United","0-2",0,2,5,5,2,-2,"A"
"2002-08-17",2001,"Boston United","Margate","0-1",0,1,5,5,1,-1,"A"
"2002-08-17",2002,"Burton Albion","Scarborough","1-1",1,1,5,5,2,0,"D"
"2002-08-17",2002,"Chester","Kettering Town","0-0",0,0,5,5,0,0,"D"
"2002-08-17",2001,"Chester","Woking","0-2",0,2,5,5,2,-2,"A"
"2002-08-17",2002,"Dagenham and Redbridge","Leigh Genesis","3-1",3,1,5,5,4,2,"H"
"2002-08-17",2001,"Dagenham and Redbridge","Southport","1-1",1,1,5,5,2,0,"D"
"2002-08-17",2002,"Doncaster Rovers","Barnet","2-1",2,1,5,5,3,1,"H"
"2002-08-17",2001,"Dover Athletic","Telford United","0-1",0,1,5,5,1,-1,"A"
"2002-08-17",2001,"Farnborough Town","Doncaster Rovers","0-1",0,1,5,5,1,-1,"A"
"2002-08-17",2002,"Halifax Town","Telford United","2-0",2,0,5,5,2,2,"H"
"2002-08-17",2002,"Hereford United","Farnborough Town","2-1",2,1,5,5,3,1,"H"
"2002-08-17",2001,"Hereford United","Barnet","2-1",2,1,5,5,3,1,"H"
"2002-08-17",2001,"Leigh Genesis","Hayes & Yeading","1-1",1,1,5,5,2,0,"D"
"2002-08-17",2002,"Margate","Morecambe","1-1",1,1,5,5,2,0,"D"
"2002-08-17",2001,"Morecambe","Nuneaton Town","1-0",1,0,5,5,1,1,"H"
"2002-08-17",2001,"Scarborough","Forest Green Rovers","1-1",1,1,5,5,2,0,"D"
"2002-08-17",2002,"Southport","Nuneaton Town","1-0",1,0,5,5,1,1,"H"
"2002-08-17",2002,"Stevenage Borough","Northwich Victoria","2-2",2,2,5,5,4,0,"D"
"2002-08-17",2001,"Stevenage Borough","Stalybridge Celtic","2-0",2,0,5,5,2,2,"H"
"2002-08-17",2002,"Woking","Forest Green Rovers","1-0",1,0,5,5,1,1,"H"
"2002-08-17",2002,"Yeovil","Ebbsfleet United","2-2",2,2,5,5,4,0,"D"
"2002-08-17",2001,"Yeovil","Northwich Victoria","2-3",2,3,5,5,5,-1,"A"
"2002-08-19",2002,"Telford United","Chester","0-1",0,1,5,5,1,-1,"A"
"2002-08-20",2002,"Barnet","Yeovil","2-1",2,1,5,5,3,1,"H"
"2002-08-20",2001,"Barnet","Dover Athletic","2-0",2,0,5,5,2,2,"H"
"2002-08-20",2001,"Doncaster Rovers","Leigh Genesis","2-0",2,0,5,5,2,2,"H"
"2002-08-20",2002,"Ebbsfleet United","Dagenham and Redbridge","1-2",1,2,5,5,3,-1,"A"
"2002-08-20",2002,"Farnborough Town","Stevenage Borough","0-1",0,1,5,5,1,-1,"A"
"2002-08-20",2002,"Forest Green Rovers","Hereford United","1-3",1,3,5,5,4,-2,"A"
"2002-08-20",2001,"Hayes & Yeading","Stevenage Borough","0-2",0,2,5,5,2,-2,"A"
"2002-08-20",2002,"Kettering Town","Margate","1-1",1,1,5,5,2,0,"D"
"2002-08-20",2002,"Leigh Genesis","Doncaster Rovers","0-2",0,2,5,5,2,-2,"A"
"2002-08-20",2001,"Margate","Dagenham and Redbridge","1-1",1,1,5,5,2,0,"D"
"2002-08-20",2002,"Morecambe","Halifax Town","2-0",2,0,5,5,2,2,"H"
"2002-08-20",2002,"Northwich Victoria","Burton Albion","1-3",1,3,5,5,4,-2,"A"
"2002-08-20",2001,"Northwich Victoria","Scarborough","1-1",1,1,5,5,2,0,"D"
"2002-08-20",2002,"Nuneaton Town","Woking","1-1",1,1,5,5,2,0,"D"
"2002-08-20",2001,"Nuneaton Town","Hereford United","2-0",2,0,5,5,2,2,"H"
"2002-08-20",2002,"Scarborough","Southport","2-2",2,2,5,5,4,0,"D"
"2002-08-20",2001,"Southport","Chester","3-2",3,2,5,5,5,1,"H"
"2002-08-20",2001,"Stalybridge Celtic","Morecambe","4-3",4,3,5,5,7,1,"H"
"2002-08-20",2001,"Telford United","Yeovil","2-2",2,2,5,5,4,0,"D"
"2002-08-20",2001,"Woking","Boston United","0-2",0,2,5,5,2,-2,"A"
"2002-08-21",2001,"Forest Green Rovers","Farnborough Town","1-0",1,0,5,5,1,1,"H"
"2002-08-24",2002,"Barnet","Chester","0-3",0,3,5,5,3,-3,"A"
"2002-08-24",2001,"Barnet","Scarborough","1-1",1,1,5,5,2,0,"D"
"2002-08-24",2001,"Doncaster Rovers","Yeovil","1-2",1,2,5,5,3,-1,"A"
"2002-08-24",2002,"Ebbsfleet United","Hereford United","3-0",3,0,5,5,3,3,"H"
"2002-08-24",2002,"Farnborough Town","Halifax Town","3-0",3,0,5,5,3,3,"H"
"2002-08-24",2002,"Forest Green Rovers","Southport","0-2",0,2,5,5,2,-2,"A"
"2002-08-24",2001,"Forest Green Rovers","Boston United","0-3",0,3,5,5,3,-3,"A"
"2002-08-24",2001,"Hayes & Yeading","Chester","1-3",1,3,5,5,4,-2,"A"
"2002-08-24",2002,"Kettering Town","Woking","0-3",0,3,5,5,3,-3,"A"
"2002-08-24",2002,"Leigh Genesis","Burton Albion","4-2",4,2,5,5,6,2,"H"
"2002-08-24",2001,"Margate","Leigh Genesis","1-2",1,2,5,5,3,-1,"A"
"2002-08-24",2002,"Morecambe","Yeovil","1-2",1,2,5,5,3,-1,"A"
"2002-08-24",2002,"Northwich Victoria","Margate","1-0",1,0,5,5,1,1,"H"
"2002-08-24",2001,"Northwich Victoria","Stevenage Borough","2-1",2,1,5,5,3,1,"H"
"2002-08-24",2002,"Nuneaton Town","Stevenage Borough","3-0",3,0,5,5,3,3,"H"
"2002-08-24",2001,"Nuneaton Town","Dover Athletic","3-0",3,0,5,5,3,3,"H"
"2002-08-24",2002,"Scarborough","Dagenham and Redbridge","0-1",0,1,5,5,1,-1,"A"
"2002-08-24",2001,"Southport","Farnborough Town","2-5",2,5,5,5,7,-3,"A"
"2002-08-24",2001,"Stalybridge Celtic","Hereford United","0-2",0,2,5,5,2,-2,"A"
"2002-08-24",2002,"Telford United","Doncaster Rovers","4-4",4,4,5,5,8,0,"D"
"2002-08-24",2001,"Telford United","Dagenham and Redbridge","1-4",1,4,5,5,5,-3,"A"
"2002-08-24",2001,"Woking","Morecambe","1-3",1,3,5,5,4,-2,"A"
"2002-08-26",2002,"Burton Albion","Barnet","0-3",0,3,5,5,3,-3,"A"
"2002-08-26",2002,"Chester","Scarborough","0-0",0,0,5,5,0,0,"D"
"2002-08-26",2001,"Chester","Nuneaton Town","1-0",1,0,5,5,1,1,"H"
"2002-08-26",2002,"Dagenham and Redbridge","Telford United","1-1",1,1,5,5,2,0,"D"
"2002-08-26",2001,"Dagenham and Redbridge","Woking","3-1",3,1,5,5,4,2,"H"
"2002-08-26",2002,"Doncaster Rovers","Farnborough Town","1-0",1,0,5,5,1,1,"H"
"2002-08-26",2001,"Dover Athletic","Forest Green Rovers","1-2",1,2,5,5,3,-1,"A"
"2002-08-26",2001,"Farnborough Town","Barnet","2-1",2,1,5,5,3,1,"H"
"2002-08-26",2002,"Halifax Town","Northwich Victoria","0-5",0,5,5,5,5,-5,"A"
"2002-08-26",2002,"Hereford United","Morecambe","1-2",1,2,5,5,3,-1,"A"
"2002-08-26",2001,"Hereford United","Southport","0-0",0,0,5,5,0,0,"D"
"2002-08-26",2001,"Leigh Genesis","Northwich Victoria","1-2",1,2,5,5,3,-1,"A"
"2002-08-26",2002,"Margate","Forest Green Rovers","3-0",3,0,5,5,3,3,"H"
"2002-08-26",2001,"Morecambe","Telford United","2-1",2,1,5,5,3,1,"H"
"2002-08-26",2001,"Scarborough","Margate","0-1",0,1,5,5,1,-1,"A"
"2002-08-26",2002,"Southport","Kettering Town","0-0",0,0,5,5,0,0,"D"
"2002-08-26",2002,"Stevenage Borough","Ebbsfleet United","1-0",1,0,5,5,1,1,"H"
"2002-08-26",2001,"Stevenage Borough","Doncaster Rovers","0-0",0,0,5,5,0,0,"D"
"2002-08-26",2002,"Woking","Leigh Genesis","3-0",3,0,5,5,3,3,"H"
"2002-08-26",2002,"Yeovil","Nuneaton Town","3-2",3,2,5,5,5,1,"H"
"2002-08-26",2001,"Yeovil","Hayes & Yeading","2-1",2,1,5,5,3,1,"H"
"2002-08-28",2001,"Boston United","Stalybridge Celtic","4-1",4,1,5,5,5,3,"H"
"2002-08-31",2002,"Barnet","Halifax Town","0-0",0,0,5,5,0,0,"D"
"2002-08-31",2001,"Barnet","Chester","3-1",3,1,5,5,4,2,"H"
"2002-08-31",2001,"Doncaster Rovers","Dover Athletic","2-1",2,1,5,5,3,1,"H"
"2002-08-31",2002,"Ebbsfleet United","Southport","1-3",1,3,5,5,4,-2,"A"
"2002-08-31",2002,"Farnborough Town","Dagenham and Redbridge","1-0",1,0,5,5,1,1,"H"
"2002-08-31",2002,"Forest Green Rovers","Chester","0-2",0,2,5,5,2,-2,"A"
"2002-08-31",2001,"Forest Green Rovers","Dagenham and Redbridge","2-4",2,4,5,5,6,-2,"A"
"2002-08-31",2001,"Hayes & Yeading","Morecambe","3-1",3,1,5,5,4,2,"H"
"2002-08-31",2002,"Kettering Town","Yeovil","0-1",0,1,5,5,1,-1,"A"
"2002-08-31",2002,"Leigh Genesis","Margate","2-0",2,0,5,5,2,2,"H"
"2002-08-31",2001,"Margate","Hereford United","2-2",2,2,5,5,4,0,"D"
"2002-08-31",2002,"Morecambe","Stevenage Borough","3-1",3,1,5,5,4,2,"H"
"2002-08-31",2002,"Northwich Victoria","Doncaster Rovers","1-2",1,2,5,5,3,-1,"A"
"2002-08-31",2001,"Northwich Victoria","Boston United","1-2",1,2,5,5,3,-1,"A"
"2002-08-31",2002,"Nuneaton Town","Hereford United","0-3",0,3,5,5,3,-3,"A"
"2002-08-31",2001,"Nuneaton Town","Yeovil","1-2",1,2,5,5,3,-1,"A"
"2002-08-31",2002,"Scarborough","Woking","1-1",1,1,5,5,2,0,"D"
"2002-08-31",2001,"Southport","Stevenage Borough","0-0",0,0,5,5,0,0,"D"
"2002-08-31",2001,"Stalybridge Celtic","Farnborough Town","1-1",1,1,5,5,2,0,"D"
"2002-08-31",2002,"Telford United","Burton Albion","0-2",0,2,5,5,2,-2,"A"
"2002-08-31",2001,"Telford United","Leigh Genesis","3-1",3,1,5,5,4,2,"H"
"2002-08-31",2001,"Woking","Scarborough","1-2",1,2,5,5,3,-1,"A"
"2002-09-02",2001,"Dover Athletic","Hayes & Yeading","3-2",3,2,5,5,5,1,"H"
"2002-09-02",2002,"Stevenage Borough","Telford United","1-3",1,3,5,5,4,-2,"A"
"2002-09-02",2001,"Stevenage Borough","Nuneaton Town","2-2",2,2,5,5,4,0,"D"
"2002-09-03",2002,"Burton Albion","Forest Green Rovers","2-3",2,3,5,5,5,-1,"A"
"2002-09-03",2002,"Chester","Morecambe","2-1",2,1,5,5,3,1,"H"
"2002-09-03",2001,"Chester","Telford United","2-2",2,2,5,5,4,0,"D"
"2002-09-03",2002,"Dagenham and Redbridge","Nuneaton Town","1-2",1,2,5,5,3,-1,"A"
"2002-09-03",2001,"Dagenham and Redbridge","Barnet","1-1",1,1,5,5,2,0,"D"
"2002-09-03",2002,"Doncaster Rovers","Kettering Town","1-0",1,0,5,5,1,1,"H"
"2002-09-03",2001,"Farnborough Town","Margate","0-0",0,0,5,5,0,0,"D"
"2002-09-03",2002,"Halifax Town","Scarborough","2-1",2,1,5,5,3,1,"H"
"2002-09-03",2001,"Hereford United","Forest Green Rovers","0-0",0,0,5,5,0,0,"D"
"2002-09-03",2001,"Leigh Genesis","Southport","1-2",1,2,5,5,3,-1,"A"
"2002-09-03",2002,"Margate","Barnet","2-2",2,2,5,5,4,0,"D"
"2002-09-03",2001,"Morecambe","Northwich Victoria","2-1",2,1,5,5,3,1,"H"
"2002-09-03",2001,"Scarborough","Stalybridge Celtic","1-1",1,1,5,5,2,0,"D"
"2002-09-03",2002,"Southport","Leigh Genesis","4-2",4,2,5,5,6,2,"H"
"2002-09-03",2002,"Woking","Ebbsfleet United","2-3",2,3,5,5,5,-1,"A"
"2002-09-03",2002,"Yeovil","Farnborough Town","2-0",2,0,5,5,2,2,"H"
"2002-09-03",2001,"Yeovil","Woking","1-3",1,3,5,5,4,-2,"A"
"2002-09-04",2001,"Boston United","Doncaster Rovers","2-2",2,2,5,5,4,0,"D"
"2002-09-06",2002,"Chester","Leigh Genesis","2-1",2,1,5,5,3,1,"H"
"2002-09-07",2002,"Barnet","Telford United","3-0",3,0,5,5,3,3,"H"
"2002-09-07",2001,"Barnet","Southport","0-0",0,0,5,5,0,0,"D"
"2002-09-07",2001,"Boston United","Yeovil","4-0",4,0,5,5,4,4,"H"
"2002-09-07",2002,"Burton Albion","Halifax Town","2-2",2,2,5,5,4,0,"D"
"2002-09-07",2002,"Doncaster Rovers","Dagenham and Redbridge","5-1",5,1,5,5,6,4,"H"
"2002-09-07",2001,"Doncaster Rovers","Woking","1-1",1,1,5,5,2,0,"D"
"2002-09-07",2002,"Ebbsfleet United","Nuneaton Town","4-1",4,1,5,5,5,3,"H"
"2002-09-07",2001,"Farnborough Town","Chester","1-1",1,1,5,5,2,0,"D"
"2002-09-07",2001,"Forest Green Rovers","Morecambe","3-1",3,1,5,5,4,2,"H"
"2002-09-07",2001,"Hereford United","Dover Athletic","3-0",3,0,5,5,3,3,"H"
"2002-09-07",2001,"Leigh Genesis","Stevenage Borough","1-2",1,2,5,5,3,-1,"A"
"2002-09-07",2002,"Margate","Stevenage Borough","1-1",1,1,5,5,2,0,"D"
"2002-09-07",2001,"Margate","Telford United","3-1",3,1,5,5,4,2,"H"
"2002-09-07",2002,"Morecambe","Forest Green Rovers","4-0",4,0,5,5,4,4,"H"
"2002-09-07",2001,"Northwich Victoria","Nuneaton Town","3-0",3,0,5,5,3,3,"H"
"2002-09-07",2002,"Scarborough","Kettering Town","4-1",4,1,5,5,5,3,"H"
"2002-09-07",2001,"Scarborough","Hayes & Yeading","1-2",1,2,5,5,3,-1,"A"
"2002-09-07",2002,"Southport","Farnborough Town","0-0",0,0,5,5,0,0,"D"
"2002-09-07",2001,"Stalybridge Celtic","Dagenham and Redbridge","2-3",2,3,5,5,5,-1,"A"
"2002-09-07",2002,"Yeovil","Northwich Victoria","2-1",2,1,5,5,3,1,"H"
"2002-09-09",2001,"Dover Athletic","Boston United","3-2",3,2,5,5,5,1,"H"
"2002-09-09",2001,"Stevenage Borough","Scarborough","2-0",2,0,5,5,2,2,"H"
"2002-09-09",2002,"Woking","Hereford United","1-2",1,2,5,5,3,-1,"A"
"2002-09-10",2001,"Chester","Stalybridge Celtic","0-0",0,0,5,5,0,0,"D"
"2002-09-10",2001,"Dagenham and Redbridge","Hereford United","1-0",1,0,5,5,1,1,"H"
"2002-09-10",2002,"Halifax Town","Doncaster Rovers","2-1",2,1,5,5,3,1,"H"
"2002-09-10",2001,"Hayes & Yeading","Forest Green Rovers","1-1",1,1,5,5,2,0,"D"
"2002-09-10",2001,"Morecambe","Barnet","1-0",1,0,5,5,1,1,"H"
"2002-09-10",2001,"Nuneaton Town","Leigh Genesis","2-1",2,1,5,5,3,1,"H"
"2002-09-10",2001,"Southport","Northwich Victoria","5-1",5,1,5,5,6,4,"H"
"2002-09-10",2001,"Telford United","Doncaster Rovers","1-1",1,1,5,5,2,0,"D"
"2002-09-10",2001,"Woking","Margate","0-1",0,1,5,5,1,-1,"A"
"2002-09-10",2001,"Yeovil","Farnborough Town","0-1",0,1,5,5,1,-1,"A"
"2002-09-14",2001,"Chester","Boston United","1-2",1,2,5,5,3,-1,"A"
"2002-09-14",2002,"Dagenham and Redbridge","Burton Albion","1-2",1,2,5,5,3,-1,"A"
"2002-09-14",2001,"Dagenham and Redbridge","Leigh Genesis","0-1",0,1,5,5,1,-1,"A"
"2002-09-14",2001,"Dover Athletic","Stalybridge Celtic","1-0",1,0,5,5,1,1,"H"
"2002-09-14",2002,"Farnborough Town","Scarborough","1-1",1,1,5,5,2,0,"D"
"2002-09-14",2002,"Forest Green Rovers","Ebbsfleet United","2-1",2,1,5,5,3,1,"H"
"2002-09-14",2001,"Hayes & Yeading","Doncaster Rovers","1-5",1,5,5,5,6,-4,"A"
"2002-09-14",2002,"Hereford United","Chester","0-0",0,0,5,5,0,0,"D"
"2002-09-14",2002,"Kettering Town","Morecambe","3-2",3,2,5,5,5,1,"H"
"2002-09-14",2002,"Leigh Genesis","Barnet","4-2",4,2,5,5,6,2,"H"
"2002-09-14",2001,"Morecambe","Hereford United","2-2",2,2,5,5,4,0,"D"
"2002-09-14",2002,"Nuneaton Town","Margate","3-2",3,2,5,5,5,1,"H"
"2002-09-14",2001,"Nuneaton Town","Forest Green Rovers","2-1",2,1,5,5,3,1,"H"
"2002-09-14",2001,"Southport","Margate","1-2",1,2,5,5,3,-1,"A"
"2002-09-14",2002,"Stevenage Borough","Yeovil","2-2",2,2,5,5,4,0,"D"
"2002-09-14",2001,"Stevenage Borough","Farnborough Town","1-2",1,2,5,5,3,-1,"A"
"2002-09-14",2002,"Telford United","Southport","2-0",2,0,5,5,2,2,"H"
"2002-09-14",2001,"Telford United","Barnet","1-2",1,2,5,5,3,-1,"A"
"2002-09-14",2002,"Woking","Northwich Victoria","2-3",2,3,5,5,5,-1,"A"
"2002-09-14",2001,"Woking","Northwich Victoria","3-1",3,1,5,5,4,2,"H"
"2002-09-14",2001,"Yeovil","Scarborough","2-2",2,2,5,5,4,0,"D"
"2002-09-16",2002,"Telford United","Scarborough","0-2",0,2,5,5,2,-2,"A"
"2002-09-17",2002,"Barnet","Farnborough Town","1-2",1,2,5,5,3,-1,"A"
"2002-09-17",2001,"Barnet","Hayes & Yeading","3-1",3,1,5,5,4,2,"H"
"2002-09-17",2002,"Burton Albion","Ebbsfleet United","1-1",1,1,5,5,2,0,"D"
"2002-09-17",2002,"Dagenham and Redbridge","Kettering Town","3-1",3,1,5,5,4,2,"H"
"2002-09-17",2002,"Doncaster Rovers","Southport","0-0",0,0,5,5,0,0,"D"
"2002-09-17",2001,"Doncaster Rovers","Nuneaton Town","2-2",2,2,5,5,4,0,"D"
"2002-09-17",2001,"Farnborough Town","Dover Athletic","1-0",1,0,5,5,1,1,"H"
"2002-09-17",2002,"Forest Green Rovers","Stevenage Borough","0-3",0,3,5,5,3,-3,"A"
"2002-09-17",2002,"Halifax Town","Chester","0-0",0,0,5,5,0,0,"D"
"2002-09-17",2002,"Hereford United","Yeovil","0-0",0,0,5,5,0,0,"D"
"2002-09-17",2001,"Hereford United","Yeovil","0-2",0,2,5,5,2,-2,"A"
"2002-09-17",2002,"Leigh Genesis","Nuneaton Town","1-1",1,1,5,5,2,0,"D"
"2002-09-17",2001,"Leigh Genesis","Chester","3-0",3,0,5,5,3,3,"H"
"2002-09-17",2001,"Margate","Stevenage Borough","2-1",2,1,5,5,3,1,"H"
"2002-09-17",2001,"Scarborough","Morecambe","0-2",0,2,5,5,2,-2,"A"
"2002-09-17",2001,"Stalybridge Celtic","Southport","0-0",0,0,5,5,0,0,"D"
"2002-09-17",2002,"Woking","Margate","1-5",1,5,5,5,6,-4,"A"
"2002-09-18",2001,"Boston United","Dagenham and Redbridge","1-2",1,2,5,5,3,-1,"A"
"2002-09-18",2001,"Forest Green Rovers","Woking","2-1",2,1,5,5,3,1,"H"
"2002-09-18",2002,"Northwich Victoria","Morecambe","3-2",3,2,5,5,5,1,"H"
"2002-09-21",2002,"Chester","Dagenham and Redbridge","5-2",5,2,5,5,7,3,"H"
"2002-09-21",2002,"Ebbsfleet United","Telford United","0-2",0,2,5,5,2,-2,"A"
"2002-09-21",2002,"Farnborough Town","Leigh Genesis","1-0",1,0,5,5,1,1,"H"
"2002-09-21",2002,"Kettering Town","Northwich Victoria","2-2",2,2,5,5,4,0,"D"
"2002-09-21",2002,"Margate","Doncaster Rovers","2-1",2,1,5,5,3,1,"H"
"2002-09-21",2002,"Morecambe","Woking","5-0",5,0,5,5,5,5,"H"
"2002-09-21",2002,"Nuneaton Town","Forest Green Rovers","3-2",3,2,5,5,5,1,"H"
"2002-09-21",2002,"Scarborough","Barnet","1-1",1,1,5,5,2,0,"D"
"2002-09-21",2002,"Southport","Burton Albion","2-2",2,2,5,5,4,0,"D"
"2002-09-21",2002,"Stevenage Borough","Hereford United","0-2",0,2,5,5,2,-2,"A"
"2002-09-21",2002,"Yeovil","Halifax Town","3-0",3,0,5,5,3,3,"H"
"2002-09-22",2001,"Barnet","Northwich Victoria","1-0",1,0,5,5,1,1,"H"
"2002-09-22",2001,"Boston United","Hayes & Yeading","4-1",4,1,5,5,5,3,"H"
"2002-09-22",2001,"Chester","Dagenham and Redbridge","0-1",0,1,5,5,1,-1,"A"
"2002-09-22",2001,"Doncaster Rovers","Morecambe","3-3",3,3,5,5,6,0,"D"
"2002-09-22",2001,"Dover Athletic","Yeovil","1-2",1,2,5,5,3,-1,"A"
"2002-09-22",2001,"Forest Green Rovers","Southport","2-1",2,1,5,5,3,1,"H"
"2002-09-22",2001,"Hereford United","Stevenage Borough","1-1",1,1,5,5,2,0,"D"
"2002-09-22",2001,"Leigh Genesis","Farnborough Town","3-0",3,0,5,5,3,3,"H"
"2002-09-22",2001,"Scarborough","Nuneaton Town","1-2",1,2,5,5,3,-1,"A"
"2002-09-22",2001,"Stalybridge Celtic","Margate","2-2",2,2,5,5,4,0,"D"
"2002-09-22",2001,"Woking","Telford United","1-1",1,1,5,5,2,0,"D"
"2002-09-23",2002,"Stevenage Borough","Barnet","1-2",1,2,5,5,3,-1,"A"
"2002-09-24",2002,"Chester","Burton Albion","2-1",2,1,5,5,3,1,"H"
"2002-09-24",2002,"Ebbsfleet United","Doncaster Rovers","2-2",2,2,5,5,4,0,"D"
"2002-09-24",2002,"Farnborough Town","Forest Green Rovers","0-3",0,3,5,5,3,-3,"A"
"2002-09-24",2002,"Kettering Town","Hereford United","2-3",2,3,5,5,5,-1,"A"
"2002-09-24",2002,"Margate","Dagenham and Redbridge","0-1",0,1,5,5,1,-1,"A"
"2002-09-24",2002,"Morecambe","Telford United","1-0",1,0,5,5,1,1,"H"
"2002-09-24",2002,"Nuneaton Town","Northwich Victoria","1-4",1,4,5,5,5,-3,"A"
"2002-09-24",2002,"Scarborough","Leigh Genesis","2-0",2,0,5,5,2,2,"H"
"2002-09-24",2002,"Southport","Halifax Town","2-0",2,0,5,5,2,2,"H"
"2002-09-24",2002,"Yeovil","Woking","4-0",4,0,5,5,4,4,"H"
"2002-09-25",2001,"Northwich Victoria","Telford United","2-2",2,2,5,5,4,0,"D"
"2002-09-28",2002,"Barnet","Morecambe","1-1",1,1,5,5,2,0,"D"
"2002-09-28",2002,"Burton Albion","Margate","0-1",0,1,5,5,1,-1,"A"
"2002-09-28",2002,"Dagenham and Redbridge","Southport","0-3",0,3,5,5,3,-3,"A"
"2002-09-28",2002,"Doncaster Rovers","Chester","0-0",0,0,5,5,0,0,"D"
"2002-09-28",2002,"Forest Green Rovers","Kettering Town","1-0",1,0,5,5,1,1,"H"
"2002-09-28",2002,"Halifax Town","Nuneaton Town","3-1",3,1,5,5,4,2,"H"
"2002-09-28",2002,"Hereford United","Scarborough","0-1",0,1,5,5,1,-1,"A"
"2002-09-28",2002,"Leigh Genesis","Yeovil","2-4",2,4,5,5,6,-2,"A"
"2002-09-28",2002,"Northwich Victoria","Ebbsfleet United","1-2",1,2,5,5,3,-1,"A"
"2002-09-28",2002,"Telford United","Farnborough Town","0-2",0,2,5,5,2,-2,"A"
"2002-09-28",2002,"Woking","Stevenage Borough","1-5",1,5,5,5,6,-4,"A"
"2002-09-29",2001,"Dagenham and Redbridge","Scarborough","4-2",4,2,5,5,6,2,"H"
"2002-09-29",2001,"Farnborough Town","Boston United","0-2",0,2,5,5,2,-2,"A"
"2002-09-29",2001,"Hayes & Yeading","Hereford United","4-1",4,1,5,5,5,3,"H"
"2002-09-29",2001,"Margate","Barnet","0-1",0,1,5,5,1,-1,"A"
"2002-09-29",2001,"Morecambe","Dover Athletic","2-1",2,1,5,5,3,1,"H"
"2002-09-29",2001,"Northwich Victoria","Forest Green Rovers","2-2",2,2,5,5,4,0,"D"
"2002-09-29",2001,"Nuneaton Town","Woking","2-0",2,0,5,5,2,2,"H"
"2002-09-29",2001,"Southport","Doncaster Rovers","1-0",1,0,5,5,1,1,"H"
"2002-09-29",2001,"Stevenage Borough","Chester","2-1",2,1,5,5,3,1,"H"
"2002-09-29",2001,"Telford United","Stalybridge Celtic","3-1",3,1,5,5,4,2,"H"
"2002-09-29",2001,"Yeovil","Leigh Genesis","2-1",2,1,5,5,3,1,"H"
"2002-10-02",2001,"Barnet","Yeovil","2-3",2,3,5,5,5,-1,"A"
"2002-10-02",2001,"Dagenham and Redbridge","Stevenage Borough","1-0",1,0,5,5,1,1,"H"
"2002-10-02",2001,"Forest Green Rovers","Stalybridge Celtic","0-2",0,2,5,5,2,-2,"A"
"2002-10-02",2001,"Hereford United","Farnborough Town","4-2",4,2,5,5,6,2,"H"
"2002-10-02",2001,"Margate","Hayes & Yeading","1-0",1,0,5,5,1,1,"H"
"2002-10-02",2001,"Morecambe","Leigh Genesis","1-3",1,3,5,5,4,-2,"A"
"2002-10-02",2001,"Northwich Victoria","Doncaster Rovers","2-3",2,3,5,5,5,-1,"A"
"2002-10-02",2001,"Nuneaton Town","Southport","3-0",3,0,5,5,3,3,"H"
"2002-10-02",2001,"Scarborough","Chester","2-1",2,1,5,5,3,1,"H"
"2002-10-02",2001,"Telford United","Boston United","2-2",2,2,5,5,4,0,"D"
"2002-10-02",2001,"Woking","Dover Athletic","4-0",4,0,5,5,4,4,"H"
"2002-10-05",2001,"Doncaster Rovers","Forest Green Rovers","5-1",5,1,5,5,6,4,"H"
"2002-10-05",2002,"Ebbsfleet United","Scarborough","5-2",5,2,5,5,7,3,"H"
"2002-10-05",2002,"Forest Green Rovers","Barnet","4-4",4,4,5,5,8,0,"D"
"2002-10-05",2002,"Hereford United","Dagenham and Redbridge","2-1",2,1,5,5,3,1,"H"
"2002-10-05",2002,"Kettering Town","Telford United","2-4",2,4,5,5,6,-2,"A"
"2002-10-05",2001,"Leigh Genesis","Hereford United","0-1",0,1,5,5,1,-1,"A"
"2002-10-05",2002,"Margate","Chester","0-1",0,1,5,5,1,-1,"A"
"2002-10-05",2002,"Morecambe","Leigh Genesis","2-1",2,1,5,5,3,1,"H"
"2002-10-05",2002,"Northwich Victoria","Farnborough Town","2-2",2,2,5,5,4,0,"D"
"2002-10-05",2002,"Nuneaton Town","Doncaster Rovers","0-3",0,3,5,5,3,-3,"A"
"2002-10-05",2002,"Stevenage Borough","Halifax Town","0-1",0,1,5,5,1,-1,"A"
"2002-10-05",2002,"Woking","Burton Albion","2-2",2,2,5,5,4,0,"D"
"2002-10-05",2001,"Woking","Stevenage Borough","1-1",1,1,5,5,2,0,"D"
"2002-10-05",2002,"Yeovil","Southport","6-0",6,0,5,5,6,6,"H"
"2002-10-06",2001,"Boston United","Scarborough","2-2",2,2,5,5,4,0,"D"
"2002-10-06",2001,"Chester","Margate","0-3",0,3,5,5,3,-3,"A"
"2002-10-06",2001,"Dover Athletic","Northwich Victoria","2-1",2,1,5,5,3,1,"H"
"2002-10-06",2001,"Farnborough Town","Dagenham and Redbridge","1-2",1,2,5,5,3,-1,"A"
"2002-10-06",2001,"Hayes & Yeading","Nuneaton Town","1-2",1,2,5,5,3,-1,"A"
"2002-10-06",2001,"Southport","Telford United","0-0",0,0,5,5,0,0,"D"
"2002-10-06",2001,"Stalybridge Celtic","Barnet","1-1",1,1,5,5,2,0,"D"
"2002-10-06",2001,"Yeovil","Morecambe","1-1",1,1,5,5,2,0,"D"
"2002-10-07",2002,"Telford United","Forest Green Rovers","0-1",0,1,5,5,1,-1,"A"
"2002-10-08",2002,"Barnet","Ebbsfleet United","1-4",1,4,5,5,5,-3,"A"
"2002-10-08",2002,"Burton Albion","Yeovil","1-1",1,1,5,5,2,0,"D"
"2002-10-08",2002,"Chester","Nuneaton Town","1-2",1,2,5,5,3,-1,"A"
"2002-10-08",2002,"Dagenham and Redbridge","Woking","1-1",1,1,5,5,2,0,"D"
"2002-10-08",2002,"Doncaster Rovers","Stevenage Borough","0-0",0,0,5,5,0,0,"D"
"2002-10-08",2001,"Dover Athletic","Dagenham and Redbridge","0-1",0,1,5,5,1,-1,"A"
"2002-10-08",2002,"Farnborough Town","Margate","4-1",4,1,5,5,5,3,"H"
"2002-10-08",2002,"Halifax Town","Kettering Town","4-0",4,0,5,5,4,4,"H"
"2002-10-08",2002,"Leigh Genesis","Hereford United","0-2",0,2,5,5,2,-2,"A"
"2002-10-08",2002,"Scarborough","Morecambe","1-0",1,0,5,5,1,1,"H"
"2002-10-08",2002,"Southport","Northwich Victoria","1-1",1,1,5,5,2,0,"D"
"2002-10-08",2001,"Stevenage Borough","Telford United","1-1",1,1,5,5,2,0,"D"
"2002-10-09",2001,"Chester","Hereford United","2-0",2,0,5,5,2,2,"H"
"2002-10-09",2001,"Doncaster Rovers","Barnet","2-3",2,3,5,5,5,-1,"A"
"2002-10-09",2001,"Farnborough Town","Nuneaton Town","2-1",2,1,5,5,3,1,"H"
"2002-10-09",2001,"Hayes & Yeading","Woking","4-1",4,1,5,5,5,3,"H"
"2002-10-09",2001,"Leigh Genesis","Forest Green Rovers","1-2",1,2,5,5,3,-1,"A"
"2002-10-09",2001,"Southport","Scarborough","1-0",1,0,5,5,1,1,"H"
"2002-10-09",2001,"Yeovil","Margate","1-2",1,2,5,5,3,-1,"A"
"2002-10-10",2001,"Boston United","Morecambe","2-1",2,1,5,5,3,1,"H"
"2002-10-10",2001,"Stalybridge Celtic","Northwich Victoria","1-1",1,1,5,5,2,0,"D"
"2002-10-11",2002,"Burton Albion","Hereford United","2-0",2,0,5,5,2,2,"H"
"2002-10-11",2002,"Doncaster Rovers","Forest Green Rovers","1-0",1,0,5,5,1,1,"H"
"2002-10-12",2002,"Barnet","Nuneaton Town","2-1",2,1,5,5,3,1,"H"
"2002-10-12",2002,"Dagenham and Redbridge","Morecambe","1-1",1,1,5,5,2,0,"D"
"2002-10-12",2002,"Farnborough Town","Kettering Town","0-1",0,1,5,5,1,-1,"A"
"2002-10-12",2002,"Halifax Town","Margate","2-2",2,2,5,5,4,0,"D"
"2002-10-12",2002,"Leigh Genesis","Stevenage Borough","2-1",2,1,5,5,3,1,"H"
"2002-10-12",2002,"Southport","Woking","5-1",5,1,5,5,6,4,"H"
"2002-10-13",2001,"Barnet","Leigh Genesis","1-1",1,1,5,5,2,0,"D"
"2002-10-13",2002,"Chester","Ebbsfleet United","1-1",1,1,5,5,2,0,"D"
"2002-10-13",2001,"Dagenham and Redbridge","Yeovil","1-1",1,1,5,5,2,0,"D"
"2002-10-13",2001,"Forest Green Rovers","Stevenage Borough","0-0",0,0,5,5,0,0,"D"
"2002-10-13",2001,"Hereford United","Boston United","0-1",0,1,5,5,1,-1,"A"
"2002-10-13",2001,"Margate","Doncaster Rovers","1-1",1,1,5,5,2,0,"D"
"2002-10-13",2001,"Morecambe","Chester","0-3",0,3,5,5,3,-3,"A"
"2002-10-13",2001,"Northwich Victoria","Hayes & Yeading","1-0",1,0,5,5,1,1,"H"
"2002-10-13",2001,"Nuneaton Town","Stalybridge Celtic","3-1",3,1,5,5,4,2,"H"
"2002-10-13",2002,"Scarborough","Northwich Victoria","4-1",4,1,5,5,5,3,"H"
"2002-10-13",2001,"Scarborough","Dover Athletic","1-1",1,1,5,5,2,0,"D"
"2002-10-13",2002,"Telford United","Yeovil","0-5",0,5,5,5,5,-5,"A"
"2002-10-13",2001,"Telford United","Farnborough Town","0-1",0,1,5,5,1,-1,"A"
"2002-10-13",2001,"Woking","Southport","2-0",2,0,5,5,2,2,"H"
"2002-10-15",2002,"Hereford United","Northwich Victoria","1-2",1,2,5,5,3,-1,"A"
"2002-10-19",2002,"Ebbsfleet United","Leigh Genesis","1-3",1,3,5,5,4,-2,"A"
"2002-10-19",2002,"Forest Green Rovers","Scarborough","0-0",0,0,5,5,0,0,"D"
"2002-10-19",2002,"Hereford United","Halifax Town","1-1",1,1,5,5,2,0,"D"
"2002-10-19",2002,"Kettering Town","Barnet","1-2",1,2,5,5,3,-1,"A"
"2002-10-19",2002,"Margate","Southport","1-0",1,0,5,5,1,1,"H"
"2002-10-19",2002,"Morecambe","Farnborough Town","1-1",1,1,5,5,2,0,"D"
"2002-10-19",2002,"Northwich Victoria","Dagenham and Redbridge","0-2",0,2,5,5,2,-2,"A"
"2002-10-19",2002,"Nuneaton Town","Telford United","1-0",1,0,5,5,1,1,"H"
"2002-10-19",2002,"Stevenage Borough","Burton Albion","0-1",0,1,5,5,1,-1,"A"
"2002-10-19",2002,"Woking","Chester","1-0",1,0,5,5,1,1,"H"
"2002-10-19",2002,"Yeovil","Doncaster Rovers","1-1",1,1,5,5,2,0,"D"
"2002-10-20",2001,"Barnet","Boston United","0-1",0,1,5,5,1,-1,"A"
"2002-10-20",2001,"Chester","Doncaster Rovers","1-1",1,1,5,5,2,0,"D"
"2002-10-20",2001,"Dagenham and Redbridge","Nuneaton Town","2-0",2,0,5,5,2,2,"H"
"2002-10-20",2001,"Farnborough Town","Hayes & Yeading","1-2",1,2,5,5,3,-1,"A"
"2002-10-20",2001,"Hereford United","Scarborough","6-0",6,0,5,5,6,6,"H"
"2002-10-20",2001,"Leigh Genesis","Woking","3-1",3,1,5,5,4,2,"H"
"2002-10-20",2001,"Margate","Northwich Victoria","1-2",1,2,5,5,3,-1,"A"
"2002-10-20",2001,"Southport","Dover Athletic","0-2",0,2,5,5,2,-2,"A"
"2002-10-20",2001,"Stalybridge Celtic","Yeovil","1-1",1,1,5,5,2,0,"D"
"2002-10-20",2001,"Stevenage Borough","Morecambe","3-1",3,1,5,5,4,2,"H"
"2002-10-20",2001,"Telford United","Forest Green Rovers","0-0",0,0,5,5,0,0,"D"
"2002-11-02",2002,"Barnet","Northwich Victoria","3-4",3,4,5,5,7,-1,"A"
"2002-11-02",2002,"Burton Albion","Morecambe","1-4",1,4,5,5,5,-3,"A"
"2002-11-02",2002,"Chester","Yeovil","2-2",2,2,5,5,4,0,"D"
"2002-11-02",2002,"Dagenham and Redbridge","Forest Green Rovers","3-1",3,1,5,5,4,2,"H"
"2002-11-02",2002,"Doncaster Rovers","Hereford United","2-0",2,0,5,5,2,2,"H"
"2002-11-02",2001,"Dover Athletic","Stevenage Borough","0-1",0,1,5,5,1,-1,"A"
"2002-11-02",2002,"Farnborough Town","Nuneaton Town","0-2",0,2,5,5,2,-2,"A"
"2002-11-02",2001,"Forest Green Rovers","Margate","3-3",3,3,5,5,6,0,"D"
"2002-11-02",2002,"Halifax Town","Ebbsfleet United","2-1",2,1,5,5,3,1,"H"
"2002-11-02",2001,"Hayes & Yeading","Telford United","1-4",1,4,5,5,5,-3,"A"
"2002-11-02",2002,"Leigh Genesis","Kettering Town","2-2",2,2,5,5,4,0,"D"
"2002-11-02",2001,"Northwich Victoria","Farnborough Town","1-2",1,2,5,5,3,-1,"A"
"2002-11-02",2002,"Scarborough","Margate","3-2",3,2,5,5,5,1,"H"
"2002-11-02",2001,"Scarborough","Leigh Genesis","2-5",2,5,5,5,7,-3,"A"
"2002-11-02",2002,"Southport","Stevenage Borough","3-2",3,2,5,5,5,1,"H"
"2002-11-02",2002,"Telford United","Woking","1-0",1,0,5,5,1,1,"H"
"2002-11-02",2001,"Woking","Hereford United","1-0",1,0,5,5,1,1,"H"
"2002-11-03",2001,"Boston United","Southport","0-0",0,0,5,5,0,0,"D"
"2002-11-03",2001,"Doncaster Rovers","Stalybridge Celtic","0-1",0,1,5,5,1,-1,"A"
"2002-11-03",2001,"Nuneaton Town","Barnet","2-3",2,3,5,5,5,-1,"A"
"2002-11-03",2001,"Yeovil","Chester","0-1",0,1,5,5,1,-1,"A"
"2002-11-08",2001,"Southport","Yeovil","3-0",3,0,5,5,3,3,"H"
"2002-11-09",2001,"Chester","Forest Green Rovers","2-3",2,3,5,5,5,-1,"A"
"2002-11-09",2002,"Ebbsfleet United","Farnborough Town","0-0",0,0,5,5,0,0,"D"
"2002-11-09",2002,"Forest Green Rovers","Halifax Town","0-2",0,2,5,5,2,-2,"A"
"2002-11-09",2002,"Hereford United","Southport","0-2",0,2,5,5,2,-2,"A"
"2002-11-09",2001,"Hereford United","Doncaster Rovers","0-0",0,0,5,5,0,0,"D"
"2002-11-09",2002,"Kettering Town","Burton Albion","1-2",1,2,5,5,3,-1,"A"
"2002-11-09",2002,"Margate","Telford United","1-1",1,1,5,5,2,0,"D"
"2002-11-09",2002,"Morecambe","Doncaster Rovers","3-0",3,0,5,5,3,3,"H"
"2002-11-09",2002,"Northwich Victoria","Leigh Genesis","0-1",0,1,5,5,1,-1,"A"
"2002-11-09",2002,"Nuneaton Town","Scarborough","1-1",1,1,5,5,2,0,"D"
"2002-11-09",2002,"Stevenage Borough","Chester","0-1",0,1,5,5,1,-1,"A"
"2002-11-09",2001,"Stevenage Borough","Boston United","1-2",1,2,5,5,3,-1,"A"
"2002-11-09",2001,"Telford United","Scarborough","3-0",3,0,5,5,3,3,"H"
"2002-11-09",2002,"Woking","Barnet","0-0",0,0,5,5,0,0,"D"
"2002-11-09",2002,"Yeovil","Dagenham and Redbridge","2-2",2,2,5,5,4,0,"D"
"2002-11-10",2001,"Barnet","Woking","3-0",3,0,5,5,3,3,"H"
"2002-11-10",2001,"Dagenham and Redbridge","Northwich Victoria","1-1",1,1,5,5,2,0,"D"
"2002-11-10",2001,"Farnborough Town","Morecambe","2-1",2,1,5,5,3,1,"H"
"2002-11-10",2001,"Leigh Genesis","Dover Athletic","1-2",1,2,5,5,3,-1,"A"
"2002-11-10",2001,"Margate","Nuneaton Town","1-1",1,1,5,5,2,0,"D"
"2002-11-10",2001,"Stalybridge Celtic","Hayes & Yeading","1-0",1,0,5,5,1,1,"H"
"2002-11-16",2002,"Barnet","Leigh Genesis","4-0",4,0,5,5,4,4,"H"
"2002-11-16",2001,"Dover Athletic","Nuneaton Town","1-2",1,2,5,5,3,-1,"A"
"2002-11-16",2001,"Telford United","Stevenage Borough","2-1",2,1,5,5,3,1,"H"
"2002-11-17",2001,"Margate","Yeovil","0-1",0,1,5,5,1,-1,"A"
"2002-11-23",2002,"Barnet","Forest Green Rovers","2-0",2,0,5,5,2,2,"H"
"2002-11-23",2002,"Burton Albion","Woking","0-2",0,2,5,5,2,-2,"A"
"2002-11-23",2002,"Chester","Margate","5-0",5,0,5,5,5,5,"H"
"2002-11-23",2002,"Dagenham and Redbridge","Hereford United","1-0",1,0,5,5,1,1,"H"
"2002-11-23",2002,"Doncaster Rovers","Nuneaton Town","1-1",1,1,5,5,2,0,"D"
"2002-11-23",2001,"Doncaster Rovers","Dagenham and Redbridge","0-0",0,0,5,5,0,0,"D"
"2002-11-23",2002,"Farnborough Town","Northwich Victoria","3-2",3,2,5,5,5,1,"H"
"2002-11-23",2001,"Forest Green Rovers","Barnet","2-2",2,2,5,5,4,0,"D"
"2002-11-23",2002,"Halifax Town","Stevenage Borough","1-0",1,0,5,5,1,1,"H"
"2002-11-23",2001,"Hayes & Yeading","Southport","1-0",1,0,5,5,1,1,"H"
"2002-11-23",2002,"Leigh Genesis","Morecambe","1-0",1,0,5,5,1,1,"H"
"2002-11-23",2001,"Morecambe","Margate","2-1",2,1,5,5,3,1,"H"
"2002-11-23",2002,"Scarborough","Ebbsfleet United","3-2",3,2,5,5,5,1,"H"
"2002-11-23",2002,"Southport","Yeovil","0-1",0,1,5,5,1,-1,"A"
"2002-11-23",2002,"Telford United","Kettering Town","2-0",2,0,5,5,2,2,"H"
"2002-11-24",2001,"Boston United","Leigh Genesis","2-1",2,1,5,5,3,1,"H"
"2002-11-24",2001,"Dover Athletic","Chester","1-0",1,0,5,5,1,1,"H"
"2002-11-24",2001,"Northwich Victoria","Hereford United","1-0",1,0,5,5,1,1,"H"
"2002-11-24",2001,"Nuneaton Town","Telford United","1-2",1,2,5,5,3,-1,"A"
"2002-11-24",2001,"Scarborough","Farnborough Town","1-0",1,0,5,5,1,1,"H"
"2002-11-24",2001,"Woking","Stalybridge Celtic","1-1",1,1,5,5,2,0,"D"
"2002-11-24",2001,"Yeovil","Stevenage Borough","2-1",2,1,5,5,3,1,"H"
"2002-11-30",2002,"Farnborough Town","Burton Albion","5-1",5,1,5,5,6,4,"H"
"2002-11-30",2002,"Halifax Town","Dagenham and Redbridge","3-3",3,3,5,5,6,0,"D"
"2002-11-30",2002,"Hereford United","Barnet","4-0",4,0,5,5,4,4,"H"
"2002-11-30",2002,"Kettering Town","Nuneaton Town","3-0",3,0,5,5,3,3,"H"
"2002-11-30",2002,"Leigh Genesis","Telford United","0-3",0,3,5,5,3,-3,"A"
"2002-11-30",2002,"Morecambe","Ebbsfleet United","2-0",2,0,5,5,2,2,"H"
"2002-11-30",2002,"Northwich Victoria","Forest Green Rovers","2-1",2,1,5,5,3,1,"H"
"2002-11-30",2002,"Southport","Chester","1-3",1,3,5,5,4,-2,"A"
"2002-11-30",2002,"Stevenage Borough","Scarborough","1-1",1,1,5,5,2,0,"D"
"2002-11-30",2002,"Yeovil","Margate","2-1",2,1,5,5,3,1,"H"
"2002-12-01",2001,"Barnet","Hereford United","2-0",2,0,5,5,2,2,"H"
"2002-12-01",2002,"Doncaster Rovers","Woking","3-1",3,1,5,5,4,2,"H"
"2002-12-01",2001,"Doncaster Rovers","Farnborough Town","1-1",1,1,5,5,2,0,"D"
"2002-12-01",2001,"Forest Green Rovers","Scarborough","2-2",2,2,5,5,4,0,"D"
"2002-12-01",2001,"Hayes & Yeading","Leigh Genesis","2-1",2,1,5,5,3,1,"H"
"2002-12-01",2001,"Margate","Boston United","1-1",1,1,5,5,2,0,"D"
"2002-12-01",2001,"Northwich Victoria","Yeovil","1-3",1,3,5,5,4,-2,"A"
"2002-12-01",2001,"Nuneaton Town","Morecambe","2-3",2,3,5,5,5,-1,"A"
"2002-12-01",2001,"Southport","Dagenham and Redbridge","2-2",2,2,5,5,4,0,"D"
"2002-12-01",2001,"Stalybridge Celtic","Stevenage Borough","2-0",2,0,5,5,2,2,"H"
"2002-12-01",2001,"Telford United","Dover Athletic","4-3",4,3,5,5,7,1,"H"
"2002-12-01",2001,"Woking","Chester","2-1",2,1,5,5,3,1,"H"
"2002-12-06",2002,"Burton Albion","Doncaster Rovers","1-2",1,2,5,5,3,-1,"A"
"2002-12-07",2001,"Chester","Morecambe","1-1",1,1,5,5,2,0,"D"
"2002-12-07",2001,"Dover Athletic","Southport","0-1",0,1,5,5,1,-1,"A"
"2002-12-07",2002,"Ebbsfleet United","Kettering Town","0-2",0,2,5,5,2,-2,"A"
"2002-12-07",2002,"Forest Green Rovers","Leigh Genesis","4-1",4,1,5,5,5,3,"H"
"2002-12-07",2001,"Leigh Genesis","Margate","2-2",2,2,5,5,4,0,"D"
"2002-12-07",2002,"Nuneaton Town","Barnet","3-2",3,2,5,5,5,1,"H"
"2002-12-07",2002,"Scarborough","Yeovil","2-1",2,1,5,5,3,1,"H"
"2002-12-07",2002,"Telford United","Northwich Victoria","1-0",1,0,5,5,1,1,"H"
"2002-12-07",2002,"Woking","Halifax Town","2-1",2,1,5,5,3,1,"H"
"2002-12-08",2001,"Nuneaton Town","Hayes & Yeading","0-2",0,2,5,5,2,-2,"A"
"2002-12-08",2001,"Yeovil","Doncaster Rovers","1-1",1,1,5,5,2,0,"D"
"2002-12-14",2001,"Chester","Southport","0-2",0,2,5,5,2,-2,"A"
"2002-12-14",2002,"Dagenham and Redbridge","Doncaster Rovers","3-3",3,3,5,5,6,0,"D"
"2002-12-14",2001,"Dover Athletic","Barnet","2-2",2,2,5,5,4,0,"D"
"2002-12-14",2002,"Farnborough Town","Southport","2-1",2,1,5,5,3,1,"H"
"2002-12-14",2002,"Forest Green Rovers","Morecambe","1-0",1,0,5,5,1,1,"H"
"2002-12-14",2002,"Halifax Town","Burton Albion","0-1",0,1,5,5,1,-1,"A"
"2002-12-14",2002,"Hereford United","Woking","5-0",5,0,5,5,5,5,"H"
"2002-12-14",2001,"Hereford United","Nuneaton Town","1-1",1,1,5,5,2,0,"D"
"2002-12-14",2002,"Kettering Town","Scarborough","1-3",1,3,5,5,4,-2,"A"
"2002-12-14",2002,"Leigh Genesis","Chester","0-4",0,4,5,5,4,-4,"A"
"2002-12-14",2001,"Leigh Genesis","Doncaster Rovers","1-4",1,4,5,5,5,-3,"A"
"2002-12-14",2002,"Northwich Victoria","Yeovil","1-2",1,2,5,5,3,-1,"A"
"2002-12-14",2002,"Nuneaton Town","Ebbsfleet United","0-1",0,1,5,5,1,-1,"A"
"2002-12-14",2001,"Scarborough","Northwich Victoria","1-2",1,2,5,5,3,-1,"A"
"2002-12-14",2002,"Stevenage Borough","Margate","1-3",1,3,5,5,4,-2,"A"
"2002-12-14",2002,"Telford United","Barnet","2-1",2,1,5,5,3,1,"H"
"2002-12-15",2001,"Boston United","Woking","4-0",4,0,5,5,4,4,"H"
"2002-12-15",2001,"Dagenham and Redbridge","Margate","4-1",4,1,5,5,5,3,"H"
"2002-12-15",2001,"Farnborough Town","Forest Green Rovers","3-0",3,0,5,5,3,3,"H"
"2002-12-15",2001,"Morecambe","Stalybridge Celtic","1-0",1,0,5,5,1,1,"H"
"2002-12-15",2001,"Stevenage Borough","Hayes & Yeading","1-1",1,1,5,5,2,0,"D"
"2002-12-15",2001,"Yeovil","Telford United","1-1",1,1,5,5,2,0,"D"
"2002-12-20",2002,"Chester","Hereford United","0-1",0,1,5,5,1,-1,"A"
"2002-12-20",2002,"Doncaster Rovers","Halifax Town","0-0",0,0,5,5,0,0,"D"
"2002-12-21",2002,"Burton Albion","Dagenham and Redbridge","0-0",0,0,5,5,0,0,"D"
"2002-12-21",2002,"Ebbsfleet United","Forest Green Rovers","1-1",1,1,5,5,2,0,"D"
"2002-12-21",2002,"Margate","Nuneaton Town","1-1",1,1,5,5,2,0,"D"
"2002-12-21",2002,"Morecambe","Kettering Town","1-0",1,0,5,5,1,1,"H"
"2002-12-21",2002,"Northwich Victoria","Woking","1-3",1,3,5,5,4,-2,"A"
"2002-12-21",2002,"Scarborough","Farnborough Town","1-0",1,0,5,5,1,1,"H"
"2002-12-21",2002,"Southport","Telford United","1-1",1,1,5,5,2,0,"D"
"2002-12-21",2002,"Yeovil","Stevenage Borough","2-1",2,1,5,5,3,1,"H"
"2002-12-22",2001,"Dagenham and Redbridge","Telford United","1-5",1,5,5,5,6,-4,"A"
"2002-12-25",2001,"Forest Green Rovers","Yeovil","1-1",1,1,5,5,2,0,"D"
"2002-12-25",2001,"Hayes & Yeading","Dagenham and Redbridge","2-4",2,4,5,5,6,-2,"A"
"2002-12-25",2001,"Nuneaton Town","Boston United","1-1",1,1,5,5,2,0,"D"
"2002-12-25",2001,"Woking","Farnborough Town","3-2",3,2,5,5,5,1,"H"
"2002-12-26",2002,"Barnet","Dagenham and Redbridge","2-1",2,1,5,5,3,1,"H"
"2002-12-26",2001,"Barnet","Stevenage Borough","0-3",0,3,5,5,3,-3,"A"
"2002-12-26",2001,"Doncaster Rovers","Scarborough","4-3",4,3,5,5,7,1,"H"
"2002-12-26",2002,"Farnborough Town","Woking","5-0",5,0,5,5,5,5,"H"
"2002-12-26",2002,"Forest Green Rovers","Yeovil","2-1",2,1,5,5,3,1,"H"
"2002-12-26",2002,"Kettering Town","Stevenage Borough","1-0",1,0,5,5,1,1,"H"
"2002-12-26",2002,"Leigh Genesis","Halifax Town","0-2",0,2,5,5,2,-2,"A"
"2002-12-26",2001,"Margate","Dover Athletic","0-1",0,1,5,5,1,-1,"A"
"2002-12-26",2002,"Morecambe","Southport","3-0",3,0,5,5,3,3,"H"
"2002-12-26",2002,"Northwich Victoria","Chester","1-1",1,1,5,5,2,0,"D"
"2002-12-26",2001,"Northwich Victoria","Chester","3-1",3,1,5,5,4,2,"H"
"2002-12-26",2002,"Nuneaton Town","Burton Albion","1-2",1,2,5,5,3,-1,"A"
"2002-12-26",2002,"Scarborough","Doncaster Rovers","2-5",2,5,5,5,7,-3,"A"
"2002-12-26",2001,"Southport","Morecambe","1-1",1,1,5,5,2,0,"D"
"2002-12-26",2002,"Telford United","Hereford United","0-1",0,1,5,5,1,-1,"A"
"2002-12-26",2001,"Telford United","Hereford United","0-1",0,1,5,5,1,-1,"A"
"2002-12-28",2002,"Burton Albion","Northwich Victoria","1-1",1,1,5,5,2,0,"D"
"2002-12-28",2002,"Chester","Telford United","4-1",4,1,5,5,5,3,"H"
"2002-12-28",2001,"Chester","Hayes & Yeading","3-1",3,1,5,5,4,2,"H"
"2002-12-28",2002,"Dagenham and Redbridge","Ebbsfleet United","4-0",4,0,5,5,4,4,"H"
"2002-12-28",2002,"Doncaster Rovers","Leigh Genesis","1-0",1,0,5,5,1,1,"H"
"2002-12-28",2002,"Halifax Town","Morecambe","1-0",1,0,5,5,1,1,"H"
"2002-12-28",2002,"Hereford United","Forest Green Rovers","1-1",1,1,5,5,2,0,"D"
"2002-12-28",2002,"Margate","Kettering Town","2-2",2,2,5,5,4,0,"D"
"2002-12-28",2002,"Southport","Scarborough","1-1",1,1,5,5,2,0,"D"
"2002-12-28",2002,"Stevenage Borough","Farnborough Town","5-0",5,0,5,5,5,5,"H"
"2002-12-28",2002,"Woking","Nuneaton Town","2-1",2,1,5,5,3,1,"H"
"2002-12-28",2002,"Yeovil","Barnet","0-0",0,0,5,5,0,0,"D"
"2002-12-29",2001,"Boston United","Forest Green Rovers","6-1",6,1,5,5,7,5,"H"
"2002-12-29",2001,"Farnborough Town","Southport","0-1",0,1,5,5,1,-1,"A"
"2002-12-29",2001,"Hereford United","Stalybridge Celtic","3-0",3,0,5,5,3,3,"H"
"2002-12-29",2001,"Morecambe","Woking","3-1",3,1,5,5,4,2,"H"
"2002-12-29",2001,"Scarborough","Barnet","3-0",3,0,5,5,3,3,"H"
"2003-01-01",2002,"Burton Albion","Nuneaton Town","1-0",1,0,5,5,1,1,"H"
"2003-01-01",2002,"Chester","Northwich Victoria","2-3",2,3,5,5,5,-1,"A"
"2003-01-01",2002,"Halifax Town","Leigh Genesis","1-0",1,0,5,5,1,1,"H"
"2003-01-01",2002,"Hereford United","Telford United","2-0",2,0,5,5,2,2,"H"
"2003-01-01",2002,"Margate","Ebbsfleet United","4-2",4,2,5,5,6,2,"H"
"2003-01-01",2002,"Southport","Morecambe","2-3",2,3,5,5,5,-1,"A"
"2003-01-01",2002,"Yeovil","Forest Green Rovers","1-0",1,0,5,5,1,1,"H"
"2003-01-04",2002,"Barnet","Doncaster Rovers","1-2",1,2,5,5,3,-1,"A"
"2003-01-04",2002,"Ebbsfleet United","Yeovil","2-4",2,4,5,5,6,-2,"A"
"2003-01-04",2002,"Forest Green Rovers","Woking","3-2",3,2,5,5,5,1,"H"
"2003-01-04",2002,"Kettering Town","Chester","0-1",0,1,5,5,1,-1,"A"
"2003-01-04",2002,"Northwich Victoria","Stevenage Borough","1-1",1,1,5,5,2,0,"D"
"2003-01-04",2002,"Scarborough","Burton Albion","4-1",4,1,5,5,5,3,"H"
"2003-01-04",2002,"Telford United","Halifax Town","1-2",1,2,5,5,3,-1,"A"
"2003-01-18",2002,"Burton Albion","Leigh Genesis","0-1",0,1,5,5,1,-1,"A"
"2003-01-18",2002,"Chester","Barnet","1-1",1,1,5,5,2,0,"D"
"2003-01-18",2002,"Dagenham and Redbridge","Scarborough","1-0",1,0,5,5,1,1,"H"
"2003-01-18",2002,"Doncaster Rovers","Telford United","1-3",1,3,5,5,4,-2,"A"
"2003-01-18",2002,"Halifax Town","Farnborough Town","1-0",1,0,5,5,1,1,"H"
"2003-01-18",2002,"Hereford United","Ebbsfleet United","3-0",3,0,5,5,3,3,"H"
"2003-01-18",2002,"Margate","Northwich Victoria","4-4",4,4,5,5,8,0,"D"
"2003-01-18",2002,"Southport","Forest Green Rovers","2-2",2,2,5,5,4,0,"D"
"2003-01-18",2002,"Stevenage Borough","Nuneaton Town","3-1",3,1,5,5,4,2,"H"
"2003-01-18",2002,"Woking","Kettering Town","2-1",2,1,5,5,3,1,"H"
"2003-01-18",2002,"Yeovil","Morecambe","2-0",2,0,5,5,2,2,"H"
"2003-01-21",2002,"Ebbsfleet United","Margate","1-2",1,2,5,5,3,-1,"A"
"2003-01-21",2002,"Nuneaton Town","Morecambe","1-1",1,1,5,5,2,0,"D"
"2003-01-25",2002,"Barnet","Burton Albion","2-2",2,2,5,5,4,0,"D"
"2003-01-25",2002,"Ebbsfleet United","Stevenage Borough","2-1",2,1,5,5,3,1,"H"
"2003-01-25",2002,"Forest Green Rovers","Margate","4-1",4,1,5,5,5,3,"H"
"2003-01-25",2002,"Kettering Town","Southport","1-0",1,0,5,5,1,1,"H"
"2003-01-25",2002,"Leigh Genesis","Woking","1-0",1,0,5,5,1,1,"H"
"2003-01-25",2002,"Morecambe","Hereford United","3-1",3,1,5,5,4,2,"H"
"2003-01-25",2002,"Northwich Victoria","Halifax Town","0-2",0,2,5,5,2,-2,"A"
"2003-01-25",2002,"Nuneaton Town","Yeovil","1-1",1,1,5,5,2,0,"D"
"2003-01-25",2002,"Scarborough","Chester","0-1",0,1,5,5,1,-1,"A"
"2003-01-28",2002,"Dagenham and Redbridge","Barnet","5-1",5,1,5,5,6,4,"H"
"2003-02-04",2002,"Farnborough Town","Hereford United","2-2",2,2,5,5,4,0,"D"
"2003-02-08",2002,"Burton Albion","Telford United","4-7",4,7,5,5,11,-3,"A"
"2003-02-08",2002,"Chester","Forest Green Rovers","0-1",0,1,5,5,1,-1,"A"
"2003-02-08",2002,"Dagenham and Redbridge","Farnborough Town","1-0",1,0,5,5,1,1,"H"
"2003-02-08",2002,"Doncaster Rovers","Northwich Victoria","1-2",1,2,5,5,3,-1,"A"
"2003-02-08",2002,"Halifax Town","Barnet","2-4",2,4,5,5,6,-2,"A"
"2003-02-08",2002,"Hereford United","Nuneaton Town","2-1",2,1,5,5,3,1,"H"
"2003-02-08",2002,"Margate","Leigh Genesis","2-0",2,0,5,5,2,2,"H"
"2003-02-08",2002,"Southport","Ebbsfleet United","1-1",1,1,5,5,2,0,"D"
"2003-02-08",2002,"Stevenage Borough","Morecambe","1-1",1,1,5,5,2,0,"D"
"2003-02-08",2002,"Woking","Scarborough","2-1",2,1,5,5,3,1,"H"
"2003-02-08",2002,"Yeovil","Kettering Town","4-0",4,0,5,5,4,4,"H"
"2003-02-11",2002,"Margate","Hereford United","0-2",0,2,5,5,2,-2,"A"
"2003-02-11",2002,"Telford United","Dagenham and Redbridge","1-2",1,2,5,5,3,-1,"A"
"2003-02-15",2002,"Barnet","Margate","0-1",0,1,5,5,1,-1,"A"
"2003-02-15",2002,"Ebbsfleet United","Woking","4-2",4,2,5,5,6,2,"H"
"2003-02-15",2002,"Farnborough Town","Yeovil","2-4",2,4,5,5,6,-2,"A"
"2003-02-15",2002,"Forest Green Rovers","Burton Albion","2-0",2,0,5,5,2,2,"H"
"2003-02-15",2002,"Kettering Town","Doncaster Rovers","0-2",0,2,5,5,2,-2,"A"
"2003-02-15",2002,"Leigh Genesis","Southport","1-1",1,1,5,5,2,0,"D"
"2003-02-15",2002,"Morecambe","Chester","1-1",1,1,5,5,2,0,"D"
"2003-02-15",2002,"Northwich Victoria","Hereford United","2-2",2,2,5,5,4,0,"D"
"2003-02-15",2002,"Nuneaton Town","Dagenham and Redbridge","1-3",1,3,5,5,4,-2,"A"
"2003-02-15",2002,"Scarborough","Halifax Town","0-1",0,1,5,5,1,-1,"A"
"2003-02-22",2002,"Barnet","Scarborough","3-0",3,0,5,5,3,3,"H"
"2003-02-22",2002,"Dagenham and Redbridge","Chester","1-0",1,0,5,5,1,1,"H"
"2003-02-22",2002,"Doncaster Rovers","Burton Albion","1-0",1,0,5,5,1,1,"H"
"2003-02-22",2002,"Hereford United","Stevenage Borough","2-2",2,2,5,5,4,0,"D"
"2003-02-22",2002,"Telford United","Ebbsfleet United","2-1",2,1,5,5,3,1,"H"
"2003-02-22",2002,"Woking","Morecambe","0-6",0,6,5,5,6,-6,"A"
"2003-02-25",2002,"Farnborough Town","Doncaster Rovers","0-0",0,0,5,5,0,0,"D"
"2003-03-01",2002,"Chester","Halifax Town","2-0",2,0,5,5,2,2,"H"
"2003-03-01",2002,"Ebbsfleet United","Burton Albion","3-2",3,2,5,5,5,1,"H"
"2003-03-01",2002,"Farnborough Town","Barnet","2-2",2,2,5,5,4,0,"D"
"2003-03-01",2002,"Kettering Town","Dagenham and Redbridge","1-3",1,3,5,5,4,-2,"A"
"2003-03-01",2002,"Margate","Woking","2-1",2,1,5,5,3,1,"H"
"2003-03-01",2002,"Morecambe","Northwich Victoria","3-1",3,1,5,5,4,2,"H"
"2003-03-01",2002,"Nuneaton Town","Leigh Genesis","0-2",0,2,5,5,2,-2,"A"
"2003-03-01",2002,"Scarborough","Telford United","1-4",1,4,5,5,5,-3,"A"
"2003-03-01",2002,"Southport","Doncaster Rovers","0-4",0,4,5,5,4,-4,"A"
"2003-03-01",2002,"Stevenage Borough","Forest Green Rovers","0-0",0,0,5,5,0,0,"D"
"2003-03-01",2002,"Yeovil","Hereford United","4-0",4,0,5,5,4,4,"H"
"2003-03-04",2002,"Dagenham and Redbridge","Stevenage Borough","3-2",3,2,5,5,5,1,"H"
"2003-03-04",2002,"Halifax Town","Yeovil","2-3",2,3,5,5,5,-1,"A"
"2003-03-04",2002,"Leigh Genesis","Farnborough Town","3-2",3,2,5,5,5,1,"H"
"2003-03-04",2002,"Nuneaton Town","Southport","3-2",3,2,5,5,5,1,"H"
"2003-03-08",2002,"Barnet","Stevenage Borough","0-2",0,2,5,5,2,-2,"A"
"2003-03-08",2002,"Burton Albion","Chester","2-0",2,0,5,5,2,2,"H"
"2003-03-08",2002,"Dagenham and Redbridge","Margate","3-0",3,0,5,5,3,3,"H"
"2003-03-08",2002,"Doncaster Rovers","Ebbsfleet United","4-1",4,1,5,5,5,3,"H"
"2003-03-08",2002,"Forest Green Rovers","Farnborough Town","3-1",3,1,5,5,4,2,"H"
"2003-03-08",2002,"Halifax Town","Southport","3-4",3,4,5,5,7,-1,"A"
"2003-03-08",2002,"Hereford United","Kettering Town","2-0",2,0,5,5,2,2,"H"
"2003-03-08",2002,"Leigh Genesis","Scarborough","0-2",0,2,5,5,2,-2,"A"
"2003-03-08",2002,"Northwich Victoria","Nuneaton Town","3-1",3,1,5,5,4,2,"H"
"2003-03-08",2002,"Telford United","Morecambe","0-3",0,3,5,5,3,-3,"A"
"2003-03-08",2002,"Woking","Yeovil","1-1",1,1,5,5,2,0,"D"
"2003-03-11",2002,"Morecambe","Margate","3-0",3,0,5,5,3,3,"H"
"2003-03-11",2002,"Woking","Farnborough Town","1-1",1,1,5,5,2,0,"D"
"2003-03-11",2002,"Yeovil","Leigh Genesis","3-1",3,1,5,5,4,2,"H"
"2003-03-15",2002,"Ebbsfleet United","Northwich Victoria","1-1",1,1,5,5,2,0,"D"
"2003-03-15",2002,"Margate","Burton Albion","0-0",0,0,5,5,0,0,"D"
"2003-03-15",2002,"Morecambe","Barnet","1-1",1,1,5,5,2,0,"D"
"2003-03-15",2002,"Nuneaton Town","Halifax Town","2-0",2,0,5,5,2,2,"H"
"2003-03-15",2002,"Scarborough","Hereford United","2-1",2,1,5,5,3,1,"H"
"2003-03-15",2002,"Southport","Dagenham and Redbridge","2-3",2,3,5,5,5,-1,"A"
"2003-03-15",2002,"Stevenage Borough","Woking","1-1",1,1,5,5,2,0,"D"
"2003-03-17",2002,"Chester","Doncaster Rovers","1-0",1,0,5,5,1,1,"H"
"2003-03-18",2002,"Barnet","Southport","3-1",3,1,5,5,4,2,"H"
"2003-03-18",2002,"Northwich Victoria","Kettering Town","1-2",1,2,5,5,3,-1,"A"
"2003-03-22",2002,"Barnet","Hereford United","2-1",2,1,5,5,3,1,"H"
"2003-03-22",2002,"Burton Albion","Farnborough Town","2-0",2,0,5,5,2,2,"H"
"2003-03-22",2002,"Chester","Southport","2-0",2,0,5,5,2,2,"H"
"2003-03-22",2002,"Dagenham and Redbridge","Halifax Town","0-0",0,0,5,5,0,0,"D"
"2003-03-22",2002,"Ebbsfleet United","Morecambe","3-2",3,2,5,5,5,1,"H"
"2003-03-22",2002,"Forest Green Rovers","Northwich Victoria","1-0",1,0,5,5,1,1,"H"
"2003-03-22",2002,"Margate","Yeovil","1-2",1,2,5,5,3,-1,"A"
"2003-03-22",2002,"Nuneaton Town","Kettering Town","1-0",1,0,5,5,1,1,"H"
"2003-03-22",2002,"Scarborough","Stevenage Borough","1-2",1,2,5,5,3,-1,"A"
"2003-03-22",2002,"Telford United","Leigh Genesis","1-1",1,1,5,5,2,0,"D"
"2003-03-22",2002,"Woking","Doncaster Rovers","2-2",2,2,5,5,4,0,"D"
"2003-03-25",2002,"Burton Albion","Southport","1-0",1,0,5,5,1,1,"H"
"2003-03-25",2002,"Doncaster Rovers","Margate","3-1",3,1,5,5,4,2,"H"
"2003-03-25",2002,"Farnborough Town","Telford United","2-2",2,2,5,5,4,0,"D"
"2003-03-25",2002,"Forest Green Rovers","Nuneaton Town","6-1",6,1,5,5,7,5,"H"
"2003-03-25",2002,"Stevenage Borough","Kettering Town","2-0",2,0,5,5,2,2,"H"
"2003-03-28",2002,"Northwich Victoria","Telford United","2-1",2,1,5,5,3,1,"H"
"2003-03-28",2002,"Yeovil","Scarborough","1-0",1,0,5,5,1,1,"H"
"2003-03-29",2002,"Farnborough Town","Chester","1-2",1,2,5,5,3,-1,"A"
"2003-03-29",2002,"Halifax Town","Woking","1-1",1,1,5,5,2,0,"D"
"2003-03-29",2002,"Hereford United","Margate","2-3",2,3,5,5,5,-1,"A"
"2003-03-29",2002,"Kettering Town","Ebbsfleet United","1-1",1,1,5,5,2,0,"D"
"2003-03-29",2002,"Leigh Genesis","Forest Green Rovers","1-0",1,0,5,5,1,1,"H"
"2003-03-29",2002,"Morecambe","Nuneaton Town","3-2",3,2,5,5,5,1,"H"
"2003-03-29",2002,"Southport","Barnet","2-1",2,1,5,5,3,1,"H"
"2003-03-29",2002,"Stevenage Borough","Dagenham and Redbridge","2-0",2,0,5,5,2,2,"H"
"2003-04-01",2002,"Doncaster Rovers","Scarborough","0-1",0,1,5,5,1,-1,"A"
"2003-04-05",2002,"Ebbsfleet United","Chester","0-1",0,1,5,5,1,-1,"A"
"2003-04-05",2002,"Forest Green Rovers","Doncaster Rovers","1-2",1,2,5,5,3,-1,"A"
"2003-04-05",2002,"Hereford United","Burton Albion","4-0",4,0,5,5,4,4,"H"
"2003-04-05",2002,"Kettering Town","Farnborough Town","1-4",1,4,5,5,5,-3,"A"
"2003-04-05",2002,"Margate","Halifax Town","2-1",2,1,5,5,3,1,"H"
"2003-04-05",2002,"Morecambe","Dagenham and Redbridge","2-1",2,1,5,5,3,1,"H"
"2003-04-05",2002,"Northwich Victoria","Scarborough","0-2",0,2,5,5,2,-2,"A"
"2003-04-05",2002,"Stevenage Borough","Leigh Genesis","3-1",3,1,5,5,4,2,"H"
"2003-04-05",2002,"Woking","Southport","1-1",1,1,5,5,2,0,"D"
"2003-04-05",2002,"Yeovil","Telford United","3-0",3,0,5,5,3,3,"H"
"2003-04-07",2002,"Leigh Genesis","Dagenham and Redbridge","1-3",1,3,5,5,4,-2,"A"
"2003-04-07",2002,"Telford United","Stevenage Borough","1-3",1,3,5,5,4,-2,"A"
"2003-04-08",2002,"Kettering Town","Forest Green Rovers","2-3",2,3,5,5,5,-1,"A"
"2003-04-12",2002,"Barnet","Kettering Town","0-2",0,2,5,5,2,-2,"A"
"2003-04-12",2002,"Burton Albion","Stevenage Borough","1-2",1,2,5,5,3,-1,"A"
"2003-04-12",2002,"Chester","Woking","2-2",2,2,5,5,4,0,"D"
"2003-04-12",2002,"Dagenham and Redbridge","Northwich Victoria","2-0",2,0,5,5,2,2,"H"
"2003-04-12",2002,"Doncaster Rovers","Yeovil","0-4",0,4,5,5,4,-4,"A"
"2003-04-12",2002,"Farnborough Town","Morecambe","2-3",2,3,5,5,5,-1,"A"
"2003-04-12",2002,"Halifax Town","Hereford United","1-0",1,0,5,5,1,1,"H"
"2003-04-12",2002,"Leigh Genesis","Ebbsfleet United","0-0",0,0,5,5,0,0,"D"
"2003-04-12",2002,"Scarborough","Forest Green Rovers","3-0",3,0,5,5,3,3,"H"
"2003-04-12",2002,"Southport","Margate","0-2",0,2,5,5,2,-2,"A"
"2003-04-12",2002,"Telford United","Nuneaton Town","1-2",1,2,5,5,3,-1,"A"
"2003-04-15",2002,"Chester","Farnborough Town","0-2",0,2,5,5,2,-2,"A"
"2003-04-19",2002,"Ebbsfleet United","Barnet","2-2",2,2,5,5,4,0,"D"
"2003-04-19",2002,"Forest Green Rovers","Telford United","1-1",1,1,5,5,2,0,"D"
"2003-04-19",2002,"Hereford United","Leigh Genesis","0-1",0,1,5,5,1,-1,"A"
"2003-04-19",2002,"Kettering Town","Halifax Town","0-1",0,1,5,5,1,-1,"A"
"2003-04-19",2002,"Margate","Farnborough Town","0-0",0,0,5,5,0,0,"D"
"2003-04-19",2002,"Morecambe","Scarborough","3-1",3,1,5,5,4,2,"H"
"2003-04-19",2002,"Northwich Victoria","Southport","2-1",2,1,5,5,3,1,"H"
"2003-04-19",2002,"Nuneaton Town","Chester","1-0",1,0,5,5,1,1,"H"
"2003-04-19",2002,"Stevenage Borough","Doncaster Rovers","2-3",2,3,5,5,5,-1,"A"
"2003-04-19",2002,"Woking","Dagenham and Redbridge","0-0",0,0,5,5,0,0,"D"
"2003-04-19",2002,"Yeovil","Burton Albion","6-1",6,1,5,5,7,5,"H"
"2003-04-21",2002,"Barnet","Woking","0-0",0,0,5,5,0,0,"D"
"2003-04-21",2002,"Burton Albion","Kettering Town","2-0",2,0,5,5,2,2,"H"
"2003-04-21",2002,"Chester","Stevenage Borough","2-0",2,0,5,5,2,2,"H"
"2003-04-21",2002,"Dagenham and Redbridge","Yeovil","0-4",0,4,5,5,4,-4,"A"
"2003-04-21",2002,"Doncaster Rovers","Morecambe","1-1",1,1,5,5,2,0,"D"
"2003-04-21",2002,"Farnborough Town","Ebbsfleet United","1-1",1,1,5,5,2,0,"D"
"2003-04-21",2002,"Halifax Town","Forest Green Rovers","1-1",1,1,5,5,2,0,"D"
"2003-04-21",2002,"Leigh Genesis","Northwich Victoria","1-1",1,1,5,5,2,0,"D"
"2003-04-21",2002,"Scarborough","Nuneaton Town","4-1",4,1,5,5,5,3,"H"
"2003-04-21",2002,"Southport","Hereford United","1-2",1,2,5,5,3,-1,"A"
"2003-04-21",2002,"Telford United","Margate","1-0",1,0,5,5,1,1,"H"
"2003-04-26",2002,"Ebbsfleet United","Halifax Town","1-0",1,0,5,5,1,1,"H"
"2003-04-26",2002,"Forest Green Rovers","Dagenham and Redbridge","5-2",5,2,5,5,7,3,"H"
"2003-04-26",2002,"Hereford United","Doncaster Rovers","2-4",2,4,5,5,6,-2,"A"
"2003-04-26",2002,"Kettering Town","Leigh Genesis","0-1",0,1,5,5,1,-1,"A"
"2003-04-26",2002,"Margate","Scarborough","3-1",3,1,5,5,4,2,"H"
"2003-04-26",2002,"Morecambe","Burton Albion","5-0",5,0,5,5,5,5,"H"
"2003-04-26",2002,"Northwich Victoria","Barnet","1-1",1,1,5,5,2,0,"D"
"2003-04-26",2002,"Nuneaton Town","Farnborough Town","0-2",0,2,5,5,2,-2,"A"
"2003-04-26",2002,"Stevenage Borough","Southport","3-0",3,0,5,5,3,3,"H"
"2003-04-26",2002,"Woking","Telford United","3-0",3,0,5,5,3,3,"H"
"2003-04-26",2002,"Yeovil","Chester","1-1",1,1,5,5,2,0,"D"
"2003-08-09",2003,"Barnet","Telford United","2-0",2,0,5,5,2,2,"H"
"2003-08-09",2003,"Ebbsfleet United","Burton Albion","1-2",1,2,5,5,3,-1,"A"
"2003-08-09",2003,"Exeter City","Halifax Town","1-1",1,1,5,5,2,0,"D"
"2003-08-09",2003,"Forest Green Rovers","Northwich Victoria","0-0",0,0,5,5,0,0,"D"
"2003-08-09",2003,"Leigh Genesis","Dagenham and Redbridge","2-1",2,1,5,5,3,1,"H"
"2003-08-09",2003,"Morecambe","Woking","2-1",2,1,5,5,3,1,"H"
"2003-08-09",2003,"Scarborough","Farnborough Town","2-1",2,1,5,5,3,1,"H"
"2003-08-09",2003,"Shrewsbury Town","Margate","1-1",1,1,5,5,2,0,"D"
"2003-08-09",2003,"Stevenage Borough","Chester","0-0",0,0,5,5,0,0,"D"
"2003-08-09",2003,"Tamworth","Hereford United","1-3",1,3,5,5,4,-2,"A"
"2003-08-10",2003,"Aldershot","Accrington","2-1",2,1,5,5,3,1,"H"
"2003-08-12",2003,"Burton Albion","Shrewsbury Town","0-1",0,1,5,5,1,-1,"A"
"2003-08-12",2003,"Chester","Tamworth","1-0",1,0,5,5,1,1,"H"
"2003-08-12",2003,"Dagenham and Redbridge","Stevenage Borough","1-2",1,2,5,5,3,-1,"A"
"2003-08-12",2003,"Farnborough Town","Barnet","1-1",1,1,5,5,2,0,"D"
"2003-08-12",2003,"Halifax Town","Morecambe","1-0",1,0,5,5,1,1,"H"
"2003-08-12",2003,"Hereford United","Forest Green Rovers","5-1",5,1,5,5,6,4,"H"
"2003-08-12",2003,"Margate","Aldershot","1-2",1,2,5,5,3,-1,"A"
"2003-08-12",2003,"Northwich Victoria","Scarborough","1-1",1,1,5,5,2,0,"D"
"2003-08-12",2003,"Telford United","Exeter City","2-0",2,0,5,5,2,2,"H"
"2003-08-12",2003,"Woking","Ebbsfleet United","3-2",3,2,5,5,5,1,"H"
"2003-08-13",2003,"Accrington","Leigh Genesis","4-1",4,1,5,5,5,3,"H"
"2003-08-16",2003,"Accrington","Shrewsbury Town","0-1",0,1,5,5,1,-1,"A"
"2003-08-16",2003,"Burton Albion","Stevenage Borough","1-1",1,1,5,5,2,0,"D"
"2003-08-16",2003,"Chester","Forest Green Rovers","1-0",1,0,5,5,1,1,"H"
"2003-08-16",2003,"Dagenham and Redbridge","Barnet","5-2",5,2,5,5,7,3,"H"
"2003-08-16",2003,"Farnborough Town","Leigh Genesis","1-1",1,1,5,5,2,0,"D"
"2003-08-16",2003,"Halifax Town","Ebbsfleet United","1-0",1,0,5,5,1,1,"H"
"2003-08-16",2003,"Hereford United","Morecambe","3-0",3,0,5,5,3,3,"H"
"2003-08-16",2003,"Margate","Exeter City","0-1",0,1,5,5,1,-1,"A"
"2003-08-16",2003,"Northwich Victoria","Tamworth","1-0",1,0,5,5,1,1,"H"
"2003-08-16",2003,"Telford United","Aldershot","2-5",2,5,5,5,7,-3,"A"
"2003-08-16",2003,"Woking","Scarborough","2-1",2,1,5,5,3,1,"H"
"2003-08-23",2003,"Aldershot","Woking","2-1",2,1,5,5,3,1,"H"
"2003-08-23",2003,"Barnet","Hereford United","1-1",1,1,5,5,2,0,"D"
"2003-08-23",2003,"Ebbsfleet United","Telford United","1-2",1,2,5,5,3,-1,"A"
"2003-08-23",2003,"Exeter City","Chester","2-1",2,1,5,5,3,1,"H"
"2003-08-23",2003,"Forest Green Rovers","Accrington","2-1",2,1,5,5,3,1,"H"
"2003-08-23",2003,"Leigh Genesis","Halifax Town","1-1",1,1,5,5,2,0,"D"
"2003-08-23",2003,"Morecambe","Dagenham and Redbridge","3-2",3,2,5,5,5,1,"H"
"2003-08-23",2003,"Scarborough","Burton Albion","1-2",1,2,5,5,3,-1,"A"
"2003-08-23",2003,"Shrewsbury Town","Farnborough Town","3-0",3,0,5,5,3,3,"H"
"2003-08-23",2003,"Stevenage Borough","Northwich Victoria","1-0",1,0,5,5,1,1,"H"
"2003-08-23",2003,"Tamworth","Margate","1-1",1,1,5,5,2,0,"D"
"2003-08-25",2003,"Accrington","Scarborough","1-0",1,0,5,5,1,1,"H"
"2003-08-25",2003,"Burton Albion","Barnet","2-3",2,3,5,5,5,-1,"A"
"2003-08-25",2003,"Dagenham and Redbridge","Forest Green Rovers","5-2",5,2,5,5,7,3,"H"
"2003-08-25",2003,"Farnborough Town","Ebbsfleet United","1-2",1,2,5,5,3,-1,"A"
"2003-08-25",2003,"Halifax Town","Tamworth","1-2",1,2,5,5,3,-1,"A"
"2003-08-25",2003,"Hereford United","Aldershot","4-3",4,3,5,5,7,1,"H"
"2003-08-25",2003,"Margate","Stevenage Borough","1-4",1,4,5,5,5,-3,"A"
"2003-08-25",2003,"Northwich Victoria","Leigh Genesis","0-1",0,1,5,5,1,-1,"A"
"2003-08-25",2003,"Telford United","Morecambe","2-1",2,1,5,5,3,1,"H"
"2003-08-25",2003,"Woking","Exeter City","1-0",1,0,5,5,1,1,"H"
"2003-08-26",2003,"Chester","Shrewsbury Town","2-1",2,1,5,5,3,1,"H"
"2003-08-30",2003,"Aldershot","Northwich Victoria","4-3",4,3,5,5,7,1,"H"
"2003-08-30",2003,"Barnet","Halifax Town","4-1",4,1,5,5,5,3,"H"
"2003-08-30",2003,"Ebbsfleet United","Chester","0-4",0,4,5,5,4,-4,"A"
"2003-08-30",2003,"Exeter City","Farnborough Town","1-1",1,1,5,5,2,0,"D"
"2003-08-30",2003,"Forest Green Rovers","Margate","1-2",1,2,5,5,3,-1,"A"
"2003-08-30",2003,"Leigh Genesis","Woking","0-1",0,1,5,5,1,-1,"A"
"2003-08-30",2003,"Morecambe","Burton Albion","2-1",2,1,5,5,3,1,"H"
"2003-08-30",2003,"Scarborough","Telford United","1-1",1,1,5,5,2,0,"D"
"2003-08-30",2003,"Shrewsbury Town","Dagenham and Redbridge","2-1",2,1,5,5,3,1,"H"
"2003-08-30",2003,"Stevenage Borough","Hereford United","0-2",0,2,5,5,2,-2,"A"
"2003-08-30",2003,"Tamworth","Accrington","1-1",1,1,5,5,2,0,"D"
"2003-09-06",2003,"Barnet","Accrington","0-0",0,0,5,5,0,0,"D"
"2003-09-06",2003,"Burton Albion","Woking","2-0",2,0,5,5,2,2,"H"
"2003-09-06",2003,"Dagenham and Redbridge","Telford United","1-1",1,1,5,5,2,0,"D"
"2003-09-06",2003,"Exeter City","Stevenage Borough","1-0",1,0,5,5,1,1,"H"
"2003-09-06",2003,"Farnborough Town","Hereford United","0-5",0,5,5,5,5,-5,"A"
"2003-09-06",2003,"Halifax Town","Northwich Victoria","5-3",5,3,5,5,8,2,"H"
"2003-09-06",2003,"Leigh Genesis","Forest Green Rovers","1-2",1,2,5,5,3,-1,"A"
"2003-09-06",2003,"Margate","Chester","1-2",1,2,5,5,3,-1,"A"
"2003-09-06",2003,"Morecambe","Aldershot","2-0",2,0,5,5,2,2,"H"
"2003-09-06",2003,"Scarborough","Ebbsfleet United","2-0",2,0,5,5,2,2,"H"
"2003-09-07",2003,"Shrewsbury Town","Tamworth","3-1",3,1,5,5,4,2,"H"
"2003-09-13",2003,"Accrington","Margate","3-2",3,2,5,5,5,1,"H"
"2003-09-13",2003,"Aldershot","Shrewsbury Town","1-1",1,1,5,5,2,0,"D"
"2003-09-13",2003,"Chester","Halifax Town","2-0",2,0,5,5,2,2,"H"
"2003-09-13",2003,"Ebbsfleet United","Leigh Genesis","3-1",3,1,5,5,4,2,"H"
"2003-09-13",2003,"Forest Green Rovers","Exeter City","2-5",2,5,5,5,7,-3,"A"
"2003-09-13",2003,"Hereford United","Scarborough","2-1",2,1,5,5,3,1,"H"
"2003-09-13",2003,"Northwich Victoria","Dagenham and Redbridge","0-1",0,1,5,5,1,-1,"A"
"2003-09-13",2003,"Stevenage Borough","Barnet","1-2",1,2,5,5,3,-1,"A"
"2003-09-13",2003,"Tamworth","Morecambe","2-3",2,3,5,5,5,-1,"A"
"2003-09-13",2003,"Telford United","Burton Albion","2-2",2,2,5,5,4,0,"D"
"2003-09-13",2003,"Woking","Farnborough Town","3-2",3,2,5,5,5,1,"H"
"2003-09-19",2003,"Burton Albion","Hereford United","4-1",4,1,5,5,5,3,"H"
"2003-09-20",2003,"Barnet","Aldershot","2-1",2,1,5,5,3,1,"H"
"2003-09-20",2003,"Dagenham and Redbridge","Accrington","0-1",0,1,5,5,1,-1,"A"
"2003-09-20",2003,"Ebbsfleet United","Exeter City","3-2",3,2,5,5,5,1,"H"
"2003-09-20",2003,"Farnborough Town","Chester","1-2",1,2,5,5,3,-1,"A"
"2003-09-20",2003,"Halifax Town","Margate","0-1",0,1,5,5,1,-1,"A"
"2003-09-20",2003,"Leigh Genesis","Tamworth","1-1",1,1,5,5,2,0,"D"
"2003-09-20",2003,"Northwich Victoria","Morecambe","1-1",1,1,5,5,2,0,"D"
"2003-09-20",2003,"Scarborough","Forest Green Rovers","2-2",2,2,5,5,4,0,"D"
"2003-09-20",2003,"Telford United","Stevenage Borough","0-2",0,2,5,5,2,-2,"A"
"2003-09-20",2003,"Woking","Shrewsbury Town","3-3",3,3,5,5,6,0,"D"
"2003-09-22",2003,"Exeter City","Dagenham and Redbridge","1-1",1,1,5,5,2,0,"D"
"2003-09-23",2003,"Accrington","Burton Albion","3-1",3,1,5,5,4,2,"H"
"2003-09-23",2003,"Aldershot","Farnborough Town","2-0",2,0,5,5,2,2,"H"
"2003-09-23",2003,"Chester","Northwich Victoria","4-0",4,0,5,5,4,4,"H"
"2003-09-23",2003,"Forest Green Rovers","Woking","2-2",2,2,5,5,4,0,"D"
"2003-09-23",2003,"Hereford United","Telford United","2-1",2,1,5,5,3,1,"H"
"2003-09-23",2003,"Margate","Barnet","0-1",0,1,5,5,1,-1,"A"
"2003-09-23",2003,"Morecambe","Leigh Genesis","1-0",1,0,5,5,1,1,"H"
"2003-09-23",2003,"Shrewsbury Town","Halifax Town","2-0",2,0,5,5,2,2,"H"
"2003-09-23",2003,"Stevenage Borough","Ebbsfleet United","2-2",2,2,5,5,4,0,"D"
"2003-09-23",2003,"Tamworth","Scarborough","0-0",0,0,5,5,0,0,"D"
"2003-09-27",2003,"Accrington","Woking","3-3",3,3,5,5,6,0,"D"
"2003-09-27",2003,"Aldershot","Burton Albion","3-1",3,1,5,5,4,2,"H"
"2003-09-27",2003,"Chester","Telford United","0-0",0,0,5,5,0,0,"D"
"2003-09-27",2003,"Exeter City","Scarborough","0-0",0,0,5,5,0,0,"D"
"2003-09-27",2003,"Forest Green Rovers","Halifax Town","1-2",1,2,5,5,3,-1,"A"
"2003-09-27",2003,"Hereford United","Ebbsfleet United","3-3",3,3,5,5,6,0,"D"
"2003-09-27",2003,"Margate","Northwich Victoria","3-1",3,1,5,5,4,2,"H"
"2003-09-27",2003,"Morecambe","Farnborough Town","3-2",3,2,5,5,5,1,"H"
"2003-09-27",2003,"Shrewsbury Town","Barnet","0-1",0,1,5,5,1,-1,"A"
"2003-09-27",2003,"Stevenage Borough","Leigh Genesis","4-0",4,0,5,5,4,4,"H"
"2003-09-27",2003,"Tamworth","Dagenham and Redbridge","2-0",2,0,5,5,2,2,"H"
"2003-10-03",2003,"Burton Albion","Exeter City","3-4",3,4,5,5,7,-1,"A"
"2003-10-04",2003,"Barnet","Morecambe","2-1",2,1,5,5,3,1,"H"
"2003-10-04",2003,"Dagenham and Redbridge","Chester","0-0",0,0,5,5,0,0,"D"
"2003-10-04",2003,"Ebbsfleet United","Forest Green Rovers","1-1",1,1,5,5,2,0,"D"
"2003-10-04",2003,"Farnborough Town","Tamworth","3-3",3,3,5,5,6,0,"D"
"2003-10-04",2003,"Halifax Town","Stevenage Borough","2-1",2,1,5,5,3,1,"H"
"2003-10-04",2003,"Leigh Genesis","Aldershot","2-2",2,2,5,5,4,0,"D"
"2003-10-04",2003,"Northwich Victoria","Accrington","3-3",3,3,5,5,6,0,"D"
"2003-10-04",2003,"Scarborough","Shrewsbury Town","1-1",1,1,5,5,2,0,"D"
"2003-10-04",2003,"Telford United","Margate","1-1",1,1,5,5,2,0,"D"
"2003-10-04",2003,"Woking","Hereford United","0-1",0,1,5,5,1,-1,"A"
"2003-10-07",2003,"Barnet","Exeter City","2-3",2,3,5,5,5,-1,"A"
"2003-10-07",2003,"Dagenham and Redbridge","Margate","4-0",4,0,5,5,4,4,"H"
"2003-10-07",2003,"Ebbsfleet United","Aldershot","1-3",1,3,5,5,4,-2,"A"
"2003-10-07",2003,"Farnborough Town","Forest Green Rovers","1-3",1,3,5,5,4,-2,"A"
"2003-10-07",2003,"Halifax Town","Accrington","1-1",1,1,5,5,2,0,"D"
"2003-10-07",2003,"Northwich Victoria","Hereford United","1-5",1,5,5,5,6,-4,"A"
"2003-10-07",2003,"Scarborough","Morecambe","1-0",1,0,5,5,1,1,"H"
"2003-10-07",2003,"Telford United","Tamworth","2-0",2,0,5,5,2,2,"H"
"2003-10-07",2003,"Woking","Stevenage Borough","1-1",1,1,5,5,2,0,"D"
"2003-10-08",2003,"Burton Albion","Chester","1-1",1,1,5,5,2,0,"D"
"2003-10-11",2003,"Accrington","Farnborough Town","3-1",3,1,5,5,4,2,"H"
"2003-10-11",2003,"Aldershot","Halifax Town","3-1",3,1,5,5,4,2,"H"
"2003-10-11",2003,"Chester","Woking","2-1",2,1,5,5,3,1,"H"
"2003-10-11",2003,"Exeter City","Northwich Victoria","2-0",2,0,5,5,2,2,"H"
"2003-10-11",2003,"Forest Green Rovers","Burton Albion","1-1",1,1,5,5,2,0,"D"
"2003-10-11",2003,"Margate","Leigh Genesis","2-0",2,0,5,5,2,2,"H"
"2003-10-11",2003,"Morecambe","Ebbsfleet United","2-2",2,2,5,5,4,0,"D"
"2003-10-11",2003,"Stevenage Borough","Scarborough","2-2",2,2,5,5,4,0,"D"
"2003-10-11",2003,"Tamworth","Barnet","2-0",2,0,5,5,2,2,"H"
"2003-10-13",2003,"Hereford United","Dagenham and Redbridge","1-1",1,1,5,5,2,0,"D"
"2003-10-18",2003,"Accrington","Exeter City","1-2",1,2,5,5,3,-1,"A"
"2003-10-18",2003,"Chester","Hereford United","0-0",0,0,5,5,0,0,"D"
"2003-10-18",2003,"Dagenham and Redbridge","Burton Albion","0-2",0,2,5,5,2,-2,"A"
"2003-10-18",2003,"Farnborough Town","Telford United","2-1",2,1,5,5,3,1,"H"
"2003-10-18",2003,"Forest Green Rovers","Stevenage Borough","3-1",3,1,5,5,4,2,"H"
"2003-10-18",2003,"Leigh Genesis","Barnet","1-4",1,4,5,5,5,-3,"A"
"2003-10-18",2003,"Margate","Scarborough","1-0",1,0,5,5,1,1,"H"
"2003-10-18",2003,"Northwich Victoria","Ebbsfleet United","0-0",0,0,5,5,0,0,"D"
"2003-10-18",2003,"Shrewsbury Town","Morecambe","2-0",2,0,5,5,2,2,"H"
"2003-10-18",2003,"Tamworth","Aldershot","3-3",3,3,5,5,6,0,"D"
"2003-10-18",2003,"Woking","Halifax Town","2-2",2,2,5,5,4,0,"D"
"2003-11-01",2003,"Aldershot","Forest Green Rovers","3-0",3,0,5,5,3,3,"H"
"2003-11-01",2003,"Barnet","Northwich Victoria","1-0",1,0,5,5,1,1,"H"
"2003-11-01",2003,"Burton Albion","Farnborough Town","1-0",1,0,5,5,1,1,"H"
"2003-11-01",2003,"Ebbsfleet United","Accrington","0-0",0,0,5,5,0,0,"D"
"2003-11-01",2003,"Exeter City","Tamworth","3-2",3,2,5,5,5,1,"H"
"2003-11-01",2003,"Halifax Town","Dagenham and Redbridge","3-0",3,0,5,5,3,3,"H"
"2003-11-01",2003,"Hereford United","Leigh Genesis","0-1",0,1,5,5,1,-1,"A"
"2003-11-01",2003,"Morecambe","Margate","3-3",3,3,5,5,6,0,"D"
"2003-11-01",2003,"Scarborough","Chester","2-2",2,2,5,5,4,0,"D"
"2003-11-01",2003,"Stevenage Borough","Shrewsbury Town","2-0",2,0,5,5,2,2,"H"
"2003-11-01",2003,"Telford United","Woking","1-0",1,0,5,5,1,1,"H"
"2003-11-11",2003,"Accrington","Hereford United","2-0",2,0,5,5,2,2,"H"
"2003-11-11",2003,"Aldershot","Exeter City","2-1",2,1,5,5,3,1,"H"
"2003-11-11",2003,"Barnet","Ebbsfleet United","1-0",1,0,5,5,1,1,"H"
"2003-11-11",2003,"Dagenham and Redbridge","Farnborough Town","1-0",1,0,5,5,1,1,"H"
"2003-11-11",2003,"Halifax Town","Telford United","1-1",1,1,5,5,2,0,"D"
"2003-11-11",2003,"Leigh Genesis","Scarborough","1-4",1,4,5,5,5,-3,"A"
"2003-11-11",2003,"Margate","Woking","1-2",1,2,5,5,3,-1,"A"
"2003-11-11",2003,"Morecambe","Chester","0-1",0,1,5,5,1,-1,"A"
"2003-11-11",2003,"Shrewsbury Town","Forest Green Rovers","2-0",2,0,5,5,2,2,"H"
"2003-11-11",2003,"Tamworth","Stevenage Borough","1-2",1,2,5,5,3,-1,"A"
"2003-11-14",2003,"Burton Albion","Halifax Town","2-2",2,2,5,5,4,0,"D"
"2003-11-15",2003,"Chester","Barnet","1-0",1,0,5,5,1,1,"H"
"2003-11-15",2003,"Ebbsfleet United","Shrewsbury Town","0-3",0,3,5,5,3,-3,"A"
"2003-11-15",2003,"Exeter City","Morecambe","4-0",4,0,5,5,4,4,"H"
"2003-11-15",2003,"Farnborough Town","Northwich Victoria","2-0",2,0,5,5,2,2,"H"
"2003-11-15",2003,"Forest Green Rovers","Tamworth","2-1",2,1,5,5,3,1,"H"
"2003-11-15",2003,"Hereford United","Margate","2-1",2,1,5,5,3,1,"H"
"2003-11-15",2003,"Scarborough","Aldershot","1-0",1,0,5,5,1,1,"H"
"2003-11-15",2003,"Stevenage Borough","Accrington","2-1",2,1,5,5,3,1,"H"
"2003-11-15",2003,"Telford United","Leigh Genesis","5-0",5,0,5,5,5,5,"H"
"2003-11-15",2003,"Woking","Dagenham and Redbridge","0-0",0,0,5,5,0,0,"D"
"2003-11-18",2003,"Leigh Genesis","Shrewsbury Town","2-2",2,2,5,5,4,0,"D"
"2003-11-22",2003,"Accrington","Telford United","1-5",1,5,5,5,6,-4,"A"
"2003-11-22",2003,"Aldershot","Chester","1-1",1,1,5,5,2,0,"D"
"2003-11-22",2003,"Barnet","Forest Green Rovers","5-0",5,0,5,5,5,5,"H"
"2003-11-22",2003,"Dagenham and Redbridge","Scarborough","1-0",1,0,5,5,1,1,"H"
"2003-11-22",2003,"Halifax Town","Farnborough Town","2-0",2,0,5,5,2,2,"H"
"2003-11-22",2003,"Leigh Genesis","Exeter City","1-1",1,1,5,5,2,0,"D"
"2003-11-22",2003,"Margate","Burton Albion","1-2",1,2,5,5,3,-1,"A"
"2003-11-22",2003,"Morecambe","Stevenage Borough","2-1",2,1,5,5,3,1,"H"
"2003-11-22",2003,"Northwich Victoria","Woking","1-4",1,4,5,5,5,-3,"A"
"2003-11-22",2003,"Shrewsbury Town","Hereford United","4-1",4,1,5,5,5,3,"H"
"2003-11-22",2003,"Tamworth","Ebbsfleet United","1-3",1,3,5,5,4,-2,"A"
"2003-11-25",2003,"Burton Albion","Leigh Genesis","3-2",3,2,5,5,5,1,"H"
"2003-11-25",2003,"Chester","Accrington","3-3",3,3,5,5,6,0,"D"
"2003-11-25",2003,"Ebbsfleet United","Dagenham and Redbridge","1-2",1,2,5,5,3,-1,"A"
"2003-11-25",2003,"Exeter City","Shrewsbury Town","3-2",3,2,5,5,5,1,"H"
"2003-11-25",2003,"Forest Green Rovers","Morecambe","1-2",1,2,5,5,3,-1,"A"
"2003-11-25",2003,"Hereford United","Halifax Town","7-1",7,1,5,5,8,6,"H"
"2003-11-25",2003,"Scarborough","Barnet","2-2",2,2,5,5,4,0,"D"
"2003-11-25",2003,"Telford United","Northwich Victoria","0-1",0,1,5,5,1,-1,"A"
"2003-11-25",2003,"Woking","Tamworth","4-0",4,0,5,5,4,4,"H"
"2003-11-29",2003,"Accrington","Barnet","2-0",2,0,5,5,2,2,"H"
"2003-11-29",2003,"Aldershot","Morecambe","2-2",2,2,5,5,4,0,"D"
"2003-11-29",2003,"Chester","Margate","3-0",3,0,5,5,3,3,"H"
"2003-11-29",2003,"Ebbsfleet United","Scarborough","1-1",1,1,5,5,2,0,"D"
"2003-11-29",2003,"Forest Green Rovers","Leigh Genesis","2-2",2,2,5,5,4,0,"D"
"2003-11-29",2003,"Hereford United","Farnborough Town","2-0",2,0,5,5,2,2,"H"
"2003-11-29",2003,"Northwich Victoria","Halifax Town","0-1",0,1,5,5,1,-1,"A"
"2003-11-29",2003,"Stevenage Borough","Exeter City","2-2",2,2,5,5,4,0,"D"
"2003-11-29",2003,"Tamworth","Shrewsbury Town","1-1",1,1,5,5,2,0,"D"
"2003-11-29",2003,"Telford United","Dagenham and Redbridge","1-0",1,0,5,5,1,1,"H"
"2003-11-29",2003,"Woking","Burton Albion","1-0",1,0,5,5,1,1,"H"
"2003-12-02",2003,"Northwich Victoria","Burton Albion","1-2",1,2,5,5,3,-1,"A"
"2003-12-06",2003,"Dagenham and Redbridge","Northwich Victoria","2-0",2,0,5,5,2,2,"H"
"2003-12-06",2003,"Exeter City","Forest Green Rovers","2-2",2,2,5,5,4,0,"D"
"2003-12-06",2003,"Farnborough Town","Margate","1-1",1,1,5,5,2,0,"D"
"2003-12-06",2003,"Halifax Town","Chester","0-3",0,3,5,5,3,-3,"A"
"2003-12-06",2003,"Morecambe","Tamworth","4-0",4,0,5,5,4,4,"H"
"2003-12-09",2003,"Farnborough Town","Woking","1-0",1,0,5,5,1,1,"H"
"2003-12-09",2003,"Shrewsbury Town","Telford United","0-0",0,0,5,5,0,0,"D"
"2003-12-13",2003,"Accrington","Aldershot","4-2",4,2,5,5,6,2,"H"
"2003-12-13",2003,"Burton Albion","Ebbsfleet United","3-0",3,0,5,5,3,3,"H"
"2003-12-13",2003,"Chester","Stevenage Borough","1-2",1,2,5,5,3,-1,"A"
"2003-12-13",2003,"Dagenham and Redbridge","Leigh Genesis","1-2",1,2,5,5,3,-1,"A"
"2003-12-13",2003,"Farnborough Town","Scarborough","1-2",1,2,5,5,3,-1,"A"
"2003-12-13",2003,"Halifax Town","Exeter City","2-0",2,0,5,5,2,2,"H"
"2003-12-13",2003,"Hereford United","Tamworth","0-1",0,1,5,5,1,-1,"A"
"2003-12-13",2003,"Northwich Victoria","Forest Green Rovers","0-4",0,4,5,5,4,-4,"A"
"2003-12-13",2003,"Telford United","Barnet","1-2",1,2,5,5,3,-1,"A"
"2003-12-13",2003,"Woking","Morecambe","4-1",4,1,5,5,5,3,"H"
"2003-12-14",2003,"Margate","Shrewsbury Town","0-2",0,2,5,5,2,-2,"A"
"2003-12-16",2003,"Stevenage Borough","Aldershot","0-1",0,1,5,5,1,-1,"A"
"2003-12-19",2003,"Forest Green Rovers","Hereford United","1-7",1,7,5,5,8,-6,"A"
"2003-12-20",2003,"Aldershot","Margate","0-2",0,2,5,5,2,-2,"A"
"2003-12-20",2003,"Barnet","Farnborough Town","1-3",1,3,5,5,4,-2,"A"
"2003-12-20",2003,"Ebbsfleet United","Woking","2-2",2,2,5,5,4,0,"D"
"2003-12-20",2003,"Exeter City","Telford United","0-3",0,3,5,5,3,-3,"A"
"2003-12-20",2003,"Leigh Genesis","Accrington","1-2",1,2,5,5,3,-1,"A"
"2003-12-20",2003,"Morecambe","Halifax Town","2-0",2,0,5,5,2,2,"H"
"2003-12-20",2003,"Scarborough","Northwich Victoria","1-0",1,0,5,5,1,1,"H"
"2003-12-20",2003,"Stevenage Borough","Dagenham and Redbridge","0-2",0,2,5,5,2,-2,"A"
"2003-12-20",2003,"Tamworth","Chester","1-5",1,5,5,5,6,-4,"A"
"2003-12-26",2003,"Accrington","Morecambe","1-0",1,0,5,5,1,1,"H"
"2003-12-26",2003,"Burton Albion","Tamworth","0-1",0,1,5,5,1,-1,"A"
"2003-12-26",2003,"Chester","Leigh Genesis","5-0",5,0,5,5,5,5,"H"
"2003-12-26",2003,"Dagenham and Redbridge","Aldershot","2-3",2,3,5,5,5,-1,"A"
"2003-12-26",2003,"Farnborough Town","Stevenage Borough","2-0",2,0,5,5,2,2,"H"
"2003-12-26",2003,"Halifax Town","Scarborough","1-0",1,0,5,5,1,1,"H"
"2003-12-26",2003,"Hereford United","Exeter City","1-1",1,1,5,5,2,0,"D"
"2003-12-26",2003,"Shrewsbury Town","Northwich Victoria","3-1",3,1,5,5,4,2,"H"
"2003-12-26",2003,"Woking","Barnet","2-2",2,2,5,5,4,0,"D"
"2003-12-27",2003,"Margate","Ebbsfleet United","1-3",1,3,5,5,4,-2,"A"
"2004-01-01",2003,"Aldershot","Dagenham and Redbridge","2-1",2,1,5,5,3,1,"H"
"2004-01-01",2003,"Barnet","Woking","0-0",0,0,5,5,0,0,"D"
"2004-01-01",2003,"Ebbsfleet United","Margate","2-1",2,1,5,5,3,1,"H"
"2004-01-01",2003,"Exeter City","Hereford United","0-1",0,1,5,5,1,-1,"A"
"2004-01-01",2003,"Forest Green Rovers","Telford United","0-0",0,0,5,5,0,0,"D"
"2004-01-01",2003,"Leigh Genesis","Chester","2-6",2,6,5,5,8,-4,"A"
"2004-01-01",2003,"Morecambe","Accrington","1-0",1,0,5,5,1,1,"H"
"2004-01-01",2003,"Northwich Victoria","Shrewsbury Town","0-2",0,2,5,5,2,-2,"A"
"2004-01-01",2003,"Stevenage Borough","Farnborough Town","3-2",3,2,5,5,5,1,"H"
"2004-01-01",2003,"Tamworth","Burton Albion","1-1",1,1,5,5,2,0,"D"
"2004-01-03",2003,"Burton Albion","Morecambe","0-1",0,1,5,5,1,-1,"A"
"2004-01-03",2003,"Chester","Ebbsfleet United","2-2",2,2,5,5,4,0,"D"
"2004-01-03",2003,"Dagenham and Redbridge","Shrewsbury Town","5-0",5,0,5,5,5,5,"H"
"2004-01-03",2003,"Farnborough Town","Exeter City","1-2",1,2,5,5,3,-1,"A"
"2004-01-03",2003,"Halifax Town","Barnet","1-2",1,2,5,5,3,-1,"A"
"2004-01-03",2003,"Hereford United","Stevenage Borough","1-0",1,0,5,5,1,1,"H"
"2004-01-03",2003,"Northwich Victoria","Aldershot","1-1",1,1,5,5,2,0,"D"
"2004-01-03",2003,"Woking","Leigh Genesis","2-0",2,0,5,5,2,2,"H"
"2004-01-04",2003,"Margate","Forest Green Rovers","2-0",2,0,5,5,2,2,"H"
"2004-01-17",2003,"Aldershot","Telford United","3-1",3,1,5,5,4,2,"H"
"2004-01-17",2003,"Barnet","Dagenham and Redbridge","2-4",2,4,5,5,6,-2,"A"
"2004-01-17",2003,"Ebbsfleet United","Halifax Town","1-0",1,0,5,5,1,1,"H"
"2004-01-17",2003,"Exeter City","Margate","1-1",1,1,5,5,2,0,"D"
"2004-01-17",2003,"Forest Green Rovers","Chester","2-1",2,1,5,5,3,1,"H"
"2004-01-17",2003,"Leigh Genesis","Farnborough Town","0-2",0,2,5,5,2,-2,"A"
"2004-01-17",2003,"Morecambe","Hereford United","2-2",2,2,5,5,4,0,"D"
"2004-01-17",2003,"Scarborough","Woking","2-2",2,2,5,5,4,0,"D"
"2004-01-17",2003,"Shrewsbury Town","Accrington","0-0",0,0,5,5,0,0,"D"
"2004-01-17",2003,"Stevenage Borough","Burton Albion","1-0",1,0,5,5,1,1,"H"
"2004-01-17",2003,"Tamworth","Northwich Victoria","2-1",2,1,5,5,3,1,"H"
"2004-01-20",2003,"Accrington","Tamworth","3-0",3,0,5,5,3,3,"H"
"2004-01-24",2003,"Barnet","Margate","3-1",3,1,5,5,4,2,"H"
"2004-01-24",2003,"Burton Albion","Accrington","1-1",1,1,5,5,2,0,"D"
"2004-01-24",2003,"Dagenham and Redbridge","Exeter City","0-2",0,2,5,5,2,-2,"A"
"2004-01-24",2003,"Ebbsfleet United","Stevenage Borough","2-3",2,3,5,5,5,-1,"A"
"2004-01-24",2003,"Farnborough Town","Aldershot","4-0",4,0,5,5,4,4,"H"
"2004-01-24",2003,"Halifax Town","Shrewsbury Town","0-0",0,0,5,5,0,0,"D"
"2004-01-24",2003,"Leigh Genesis","Morecambe","3-1",3,1,5,5,4,2,"H"
"2004-01-24",2003,"Northwich Victoria","Chester","0-4",0,4,5,5,4,-4,"A"
"2004-01-24",2003,"Woking","Forest Green Rovers","1-1",1,1,5,5,2,0,"D"
"2004-02-03",2003,"Scarborough","Hereford United","3-3",3,3,5,5,6,0,"D"
"2004-02-06",2003,"Aldershot","Barnet","1-1",1,1,5,5,2,0,"D"
"2004-02-07",2003,"Accrington","Dagenham and Redbridge","2-3",2,3,5,5,5,-1,"A"
"2004-02-07",2003,"Chester","Farnborough Town","3-2",3,2,5,5,5,1,"H"
"2004-02-07",2003,"Exeter City","Ebbsfleet United","0-1",0,1,5,5,1,-1,"A"
"2004-02-07",2003,"Forest Green Rovers","Scarborough","4-0",4,0,5,5,4,4,"H"
"2004-02-07",2003,"Hereford United","Burton Albion","1-2",1,2,5,5,3,-1,"A"
"2004-02-07",2003,"Morecambe","Northwich Victoria","3-0",3,0,5,5,3,3,"H"
"2004-02-07",2003,"Stevenage Borough","Telford United","0-1",0,1,5,5,1,-1,"A"
"2004-02-07",2003,"Tamworth","Leigh Genesis","4-3",4,3,5,5,7,1,"H"
"2004-02-08",2003,"Margate","Halifax Town","2-0",2,0,5,5,2,2,"H"
"2004-02-14",2003,"Ebbsfleet United","Hereford United","2-5",2,5,5,5,7,-3,"A"
"2004-02-14",2003,"Farnborough Town","Morecambe","2-4",2,4,5,5,6,-2,"A"
"2004-02-14",2003,"Leigh Genesis","Stevenage Borough","1-3",1,3,5,5,4,-2,"A"
"2004-02-14",2003,"Northwich Victoria","Margate","0-3",0,3,5,5,3,-3,"A"
"2004-02-14",2003,"Woking","Accrington","2-2",2,2,5,5,4,0,"D"
"2004-02-21",2003,"Accrington","Northwich Victoria","2-2",2,2,5,5,4,0,"D"
"2004-02-21",2003,"Aldershot","Leigh Genesis","2-0",2,0,5,5,2,2,"H"
"2004-02-21",2003,"Chester","Dagenham and Redbridge","2-1",2,1,5,5,3,1,"H"
"2004-02-21",2003,"Exeter City","Burton Albion","2-0",2,0,5,5,2,2,"H"
"2004-02-21",2003,"Forest Green Rovers","Ebbsfleet United","1-2",1,2,5,5,3,-1,"A"
"2004-02-21",2003,"Hereford United","Woking","0-1",0,1,5,5,1,-1,"A"
"2004-02-21",2003,"Margate","Telford United","1-0",1,0,5,5,1,1,"H"
"2004-02-21",2003,"Morecambe","Barnet","1-3",1,3,5,5,4,-2,"A"
"2004-02-21",2003,"Shrewsbury Town","Scarborough","4-1",4,1,5,5,5,3,"H"
"2004-02-21",2003,"Stevenage Borough","Halifax Town","1-0",1,0,5,5,1,1,"H"
"2004-02-21",2003,"Tamworth","Farnborough Town","2-1",2,1,5,5,3,1,"H"
"2004-02-24",2003,"Halifax Town","Aldershot","1-2",1,2,5,5,3,-1,"A"
"2004-02-24",2003,"Shrewsbury Town","Burton Albion","1-0",1,0,5,5,1,1,"H"
"2004-02-27",2003,"Dagenham and Redbridge","Hereford United","0-9",0,9,5,5,9,-9,"A"
"2004-02-28",2003,"Barnet","Tamworth","1-0",1,0,5,5,1,1,"H"
"2004-02-28",2003,"Burton Albion","Forest Green Rovers","2-3",2,3,5,5,5,-1,"A"
"2004-02-28",2003,"Ebbsfleet United","Morecambe","6-0",6,0,5,5,6,6,"H"
"2004-02-28",2003,"Farnborough Town","Accrington","1-1",1,1,5,5,2,0,"D"
"2004-02-28",2003,"Leigh Genesis","Margate","4-2",4,2,5,5,6,2,"H"
"2004-02-28",2003,"Woking","Chester","1-2",1,2,5,5,3,-1,"A"
"2004-03-02",2003,"Shrewsbury Town","Woking","1-0",1,0,5,5,1,1,"H"
"2004-03-02",2003,"Telford United","Hereford United","0-3",0,3,5,5,3,-3,"A"
"2004-03-06",2003,"Accrington","Halifax Town","2-1",2,1,5,5,3,1,"H"
"2004-03-06",2003,"Aldershot","Ebbsfleet United","2-2",2,2,5,5,4,0,"D"
"2004-03-06",2003,"Chester","Burton Albion","3-1",3,1,5,5,4,2,"H"
"2004-03-06",2003,"Exeter City","Barnet","1-1",1,1,5,5,2,0,"D"
"2004-03-06",2003,"Forest Green Rovers","Farnborough Town","1-1",1,1,5,5,2,0,"D"
"2004-03-06",2003,"Hereford United","Northwich Victoria","1-0",1,0,5,5,1,1,"H"
"2004-03-06",2003,"Margate","Dagenham and Redbridge","3-3",3,3,5,5,6,0,"D"
"2004-03-06",2003,"Morecambe","Scarborough","2-1",2,1,5,5,3,1,"H"
"2004-03-06",2003,"Stevenage Borough","Woking","1-1",1,1,5,5,2,0,"D"
"2004-03-06",2003,"Tamworth","Telford United","0-1",0,1,5,5,1,-1,"A"
"2004-03-08",2003,"Shrewsbury Town","Leigh Genesis","3-1",3,1,5,5,4,2,"H"
"2004-03-09",2003,"Barnet","Stevenage Borough","0-0",0,0,5,5,0,0,"D"
"2004-03-09",2003,"Burton Albion","Telford United","2-1",2,1,5,5,3,1,"H"
"2004-03-09",2003,"Dagenham and Redbridge","Tamworth","0-0",0,0,5,5,0,0,"D"
"2004-03-09",2003,"Halifax Town","Forest Green Rovers","0-1",0,1,5,5,1,-1,"A"
"2004-03-13",2003,"Burton Albion","Northwich Victoria","0-1",0,1,5,5,1,-1,"A"
"2004-03-13",2003,"Chester","Morecambe","2-1",2,1,5,5,3,1,"H"
"2004-03-13",2003,"Ebbsfleet United","Barnet","1-1",1,1,5,5,2,0,"D"
"2004-03-13",2003,"Exeter City","Aldershot","2-1",2,1,5,5,3,1,"H"
"2004-03-13",2003,"Farnborough Town","Dagenham and Redbridge","2-2",2,2,5,5,4,0,"D"
"2004-03-13",2003,"Forest Green Rovers","Shrewsbury Town","1-1",1,1,5,5,2,0,"D"
"2004-03-13",2003,"Hereford United","Accrington","1-0",1,0,5,5,1,1,"H"
"2004-03-13",2003,"Scarborough","Leigh Genesis","4-1",4,1,5,5,5,3,"H"
"2004-03-13",2003,"Stevenage Borough","Tamworth","3-1",3,1,5,5,4,2,"H"
"2004-03-13",2003,"Telford United","Halifax Town","2-1",2,1,5,5,3,1,"H"
"2004-03-13",2003,"Woking","Margate","0-0",0,0,5,5,0,0,"D"
"2004-03-16",2003,"Burton Albion","Aldershot","1-4",1,4,5,5,5,-3,"A"
"2004-03-16",2003,"Margate","Accrington","3-1",3,1,5,5,4,2,"H"
"2004-03-16",2003,"Northwich Victoria","Exeter City","1-1",1,1,5,5,2,0,"D"
"2004-03-16",2003,"Scarborough","Tamworth","0-1",0,1,5,5,1,-1,"A"
"2004-03-20",2003,"Accrington","Stevenage Borough","2-1",2,1,5,5,3,1,"H"
"2004-03-20",2003,"Aldershot","Scarborough","1-2",1,2,5,5,3,-1,"A"
"2004-03-20",2003,"Barnet","Chester","0-0",0,0,5,5,0,0,"D"
"2004-03-20",2003,"Dagenham and Redbridge","Woking","1-0",1,0,5,5,1,1,"H"
"2004-03-20",2003,"Leigh Genesis","Telford United","1-1",1,1,5,5,2,0,"D"
"2004-03-20",2003,"Margate","Hereford United","1-3",1,3,5,5,4,-2,"A"
"2004-03-20",2003,"Morecambe","Exeter City","0-3",0,3,5,5,3,-3,"A"
"2004-03-20",2003,"Northwich Victoria","Farnborough Town","1-1",1,1,5,5,2,0,"D"
"2004-03-20",2003,"Tamworth","Forest Green Rovers","1-0",1,0,5,5,1,1,"H"
"2004-03-23",2003,"Scarborough","Exeter City","2-3",2,3,5,5,5,-1,"A"
"2004-03-23",2003,"Shrewsbury Town","Aldershot","1-2",1,2,5,5,3,-1,"A"
"2004-03-23",2003,"Telford United","Forest Green Rovers","0-2",0,2,5,5,2,-2,"A"
"2004-03-25",2003,"Scarborough","Halifax Town","1-0",1,0,5,5,1,1,"H"
"2004-03-27",2003,"Burton Albion","Margate","0-1",0,1,5,5,1,-1,"A"
"2004-03-27",2003,"Ebbsfleet United","Tamworth","2-0",2,0,5,5,2,2,"H"
"2004-03-27",2003,"Exeter City","Leigh Genesis","3-2",3,2,5,5,5,1,"H"
"2004-03-27",2003,"Farnborough Town","Halifax Town","1-0",1,0,5,5,1,1,"H"
"2004-03-27",2003,"Forest Green Rovers","Barnet","1-1",1,1,5,5,2,0,"D"
"2004-03-27",2003,"Hereford United","Shrewsbury Town","2-1",2,1,5,5,3,1,"H"
"2004-03-27",2003,"Scarborough","Dagenham and Redbridge","0-0",0,0,5,5,0,0,"D"
"2004-03-27",2003,"Stevenage Borough","Morecambe","0-1",0,1,5,5,1,-1,"A"
"2004-03-27",2003,"Woking","Northwich Victoria","3-0",3,0,5,5,3,3,"H"
"2004-03-30",2003,"Aldershot","Stevenage Borough","2-0",2,0,5,5,2,2,"H"
"2004-03-30",2003,"Barnet","Shrewsbury Town","0-1",0,1,5,5,1,-1,"A"
"2004-03-30",2003,"Halifax Town","Burton Albion","1-4",1,4,5,5,5,-3,"A"
"2004-03-30",2003,"Leigh Genesis","Ebbsfleet United","1-2",1,2,5,5,3,-1,"A"
"2004-03-30",2003,"Telford United","Chester","0-2",0,2,5,5,2,-2,"A"
"2004-04-03",2003,"Accrington","Chester","0-2",0,2,5,5,2,-2,"A"
"2004-04-03",2003,"Barnet","Scarborough","0-0",0,0,5,5,0,0,"D"
"2004-04-03",2003,"Dagenham and Redbridge","Ebbsfleet United","0-4",0,4,5,5,4,-4,"A"
"2004-04-03",2003,"Halifax Town","Hereford United","1-2",1,2,5,5,3,-1,"A"
"2004-04-03",2003,"Leigh Genesis","Burton Albion","0-1",0,1,5,5,1,-1,"A"
"2004-04-03",2003,"Margate","Farnborough Town","3-0",3,0,5,5,3,3,"H"
"2004-04-03",2003,"Morecambe","Forest Green Rovers","4-0",4,0,5,5,4,4,"H"
"2004-04-03",2003,"Shrewsbury Town","Exeter City","2-2",2,2,5,5,4,0,"D"
"2004-04-03",2003,"Tamworth","Woking","2-0",2,0,5,5,2,2,"H"
"2004-04-06",2003,"Chester","Aldershot","4-2",4,2,5,5,6,2,"H"
"2004-04-06",2003,"Scarborough","Stevenage Borough","2-2",2,2,5,5,4,0,"D"
"2004-04-06",2003,"Telford United","Shrewsbury Town","1-0",1,0,5,5,1,1,"H"
"2004-04-08",2003,"Telford United","Accrington","1-0",1,0,5,5,1,1,"H"
"2004-04-09",2003,"Halifax Town","Leigh Genesis","2-1",2,1,5,5,3,1,"H"
"2004-04-10",2003,"Accrington","Forest Green Rovers","4-1",4,1,5,5,5,3,"H"
"2004-04-10",2003,"Burton Albion","Scarborough","2-0",2,0,5,5,2,2,"H"
"2004-04-10",2003,"Chester","Exeter City","3-2",3,2,5,5,5,1,"H"
"2004-04-10",2003,"Dagenham and Redbridge","Morecambe","1-3",1,3,5,5,4,-2,"A"
"2004-04-10",2003,"Farnborough Town","Shrewsbury Town","1-3",1,3,5,5,4,-2,"A"
"2004-04-10",2003,"Hereford United","Barnet","2-0",2,0,5,5,2,2,"H"
"2004-04-10",2003,"Margate","Tamworth","3-2",3,2,5,5,5,1,"H"
"2004-04-10",2003,"Northwich Victoria","Stevenage Borough","1-2",1,2,5,5,3,-1,"A"
"2004-04-10",2003,"Telford United","Ebbsfleet United","1-1",1,1,5,5,2,0,"D"
"2004-04-10",2003,"Woking","Aldershot","2-2",2,2,5,5,4,0,"D"
"2004-04-12",2003,"Aldershot","Hereford United","1-2",1,2,5,5,3,-1,"A"
"2004-04-12",2003,"Barnet","Burton Albion","2-1",2,1,5,5,3,1,"H"
"2004-04-12",2003,"Ebbsfleet United","Farnborough Town","2-0",2,0,5,5,2,2,"H"
"2004-04-12",2003,"Exeter City","Woking","1-2",1,2,5,5,3,-1,"A"
"2004-04-12",2003,"Forest Green Rovers","Dagenham and Redbridge","1-3",1,3,5,5,4,-2,"A"
"2004-04-12",2003,"Leigh Genesis","Northwich Victoria","1-0",1,0,5,5,1,1,"H"
"2004-04-12",2003,"Morecambe","Telford United","1-0",1,0,5,5,1,1,"H"
"2004-04-12",2003,"Scarborough","Accrington","2-1",2,1,5,5,3,1,"H"
"2004-04-12",2003,"Stevenage Borough","Margate","2-1",2,1,5,5,3,1,"H"
"2004-04-12",2003,"Tamworth","Halifax Town","2-0",2,0,5,5,2,2,"H"
"2004-04-13",2003,"Shrewsbury Town","Chester","0-0",0,0,5,5,0,0,"D"
"2004-04-14",2003,"Telford United","Scarborough","2-1",2,1,5,5,3,1,"H"
"2004-04-17",2003,"Accrington","Ebbsfleet United","3-3",3,3,5,5,6,0,"D"
"2004-04-17",2003,"Chester","Scarborough","1-0",1,0,5,5,1,1,"H"
"2004-04-17",2003,"Dagenham and Redbridge","Halifax Town","0-1",0,1,5,5,1,-1,"A"
"2004-04-17",2003,"Farnborough Town","Burton Albion","2-1",2,1,5,5,3,1,"H"
"2004-04-17",2003,"Forest Green Rovers","Aldershot","3-1",3,1,5,5,4,2,"H"
"2004-04-17",2003,"Leigh Genesis","Hereford United","0-5",0,5,5,5,5,-5,"A"
"2004-04-17",2003,"Northwich Victoria","Barnet","1-1",1,1,5,5,2,0,"D"
"2004-04-17",2003,"Shrewsbury Town","Stevenage Borough","3-1",3,1,5,5,4,2,"H"
"2004-04-17",2003,"Tamworth","Exeter City","2-1",2,1,5,5,3,1,"H"
"2004-04-17",2003,"Woking","Telford United","3-1",3,1,5,5,4,2,"H"
"2004-04-18",2003,"Margate","Morecambe","1-1",1,1,5,5,2,0,"D"
"2004-04-20",2003,"Shrewsbury Town","Ebbsfleet United","1-1",1,1,5,5,2,0,"D"
"2004-04-21",2003,"Northwich Victoria","Telford United","1-0",1,0,5,5,1,1,"H"
"2004-04-24",2003,"Aldershot","Tamworth","1-1",1,1,5,5,2,0,"D"
"2004-04-24",2003,"Barnet","Leigh Genesis","2-1",2,1,5,5,3,1,"H"
"2004-04-24",2003,"Burton Albion","Dagenham and Redbridge","0-1",0,1,5,5,1,-1,"A"
"2004-04-24",2003,"Ebbsfleet United","Northwich Victoria","2-2",2,2,5,5,4,0,"D"
"2004-04-24",2003,"Exeter City","Accrington","3-2",3,2,5,5,5,1,"H"
"2004-04-24",2003,"Halifax Town","Woking","2-2",2,2,5,5,4,0,"D"
"2004-04-24",2003,"Hereford United","Chester","2-1",2,1,5,5,3,1,"H"
"2004-04-24",2003,"Margate","Scarborough","0-2",0,2,5,5,2,-2,"A"
"2004-04-24",2003,"Morecambe","Shrewsbury Town","3-3",3,3,5,5,6,0,"D"
"2004-04-24",2003,"Stevenage Borough","Forest Green Rovers","2-1",2,1,5,5,3,1,"H"
"2004-04-24",2003,"Telford United","Farnborough Town","2-4",2,4,5,5,6,-2,"A"
"2004-08-14",2004,"Accrington","Burton Albion","3-1",3,1,5,5,4,2,"H"
"2004-08-14",2004,"Aldershot","York City","2-0",2,0,5,5,2,2,"H"
"2004-08-14",2004,"Barnet","Forest Green Rovers","3-1",3,1,5,5,4,2,"H"
"2004-08-14",2004,"Carlisle United","Canvey Island","0-0",0,0,5,5,0,0,"D"
"2004-08-14",2004,"Dagenham and Redbridge","Stevenage Borough","3-1",3,1,5,5,4,2,"H"
"2004-08-14",2004,"Ebbsfleet United","Northwich Victoria","2-2",2,2,5,5,4,0,"D"
"2004-08-14",2004,"Exeter City","Morecambe","1-1",1,1,5,5,2,0,"D"
"2004-08-14",2004,"Hereford United","Farnborough Town","3-1",3,1,5,5,4,2,"H"
"2004-08-14",2004,"Leigh Genesis","Crawley Town","1-2",1,2,5,5,3,-1,"A"
"2004-08-14",2004,"Scarborough","Woking","2-0",2,0,5,5,2,2,"H"
"2004-08-14",2004,"Tamworth","Halifax Town","2-1",2,1,5,5,3,1,"H"
"2004-08-17",2004,"Burton Albion","Leigh Genesis","0-0",0,0,5,5,0,0,"D"
"2004-08-17",2004,"Canvey Island","Ebbsfleet United","1-1",1,1,5,5,2,0,"D"
"2004-08-17",2004,"Crawley Town","Hereford United","1-1",1,1,5,5,2,0,"D"
"2004-08-17",2004,"Farnborough Town","Barnet","0-0",0,0,5,5,0,0,"D"
"2004-08-17",2004,"Forest Green Rovers","Dagenham and Redbridge","1-4",1,4,5,5,5,-3,"A"
"2004-08-17",2004,"Halifax Town","Scarborough","2-1",2,1,5,5,3,1,"H"
"2004-08-17",2004,"Morecambe","Accrington","1-2",1,2,5,5,3,-1,"A"
"2004-08-17",2004,"Northwich Victoria","Carlisle United","2-2",2,2,5,5,4,0,"D"
"2004-08-17",2004,"Stevenage Borough","Aldershot","0-1",0,1,5,5,1,-1,"A"
"2004-08-17",2004,"Woking","Exeter City","3-3",3,3,5,5,6,0,"D"
"2004-08-17",2004,"York City","Tamworth","2-0",2,0,5,5,2,2,"H"
"2004-08-21",2004,"Burton Albion","Dagenham and Redbridge","1-3",1,3,5,5,4,-2,"A"
"2004-08-21",2004,"Canvey Island","Tamworth","3-3",3,3,5,5,6,0,"D"
"2004-08-21",2004,"Crawley Town","Aldershot","1-0",1,0,5,5,1,1,"H"
"2004-08-21",2004,"Farnborough Town","Scarborough","0-1",0,1,5,5,1,-1,"A"
"2004-08-21",2004,"Forest Green Rovers","Carlisle United","0-3",0,3,5,5,3,-3,"A"
"2004-08-21",2004,"Halifax Town","Barnet","2-3",2,3,5,5,5,-1,"A"
"2004-08-21",2004,"Morecambe","Ebbsfleet United","1-3",1,3,5,5,4,-2,"A"
"2004-08-21",2004,"Northwich Victoria","Exeter City","1-2",1,2,5,5,3,-1,"A"
"2004-08-21",2004,"Stevenage Borough","Accrington","5-0",5,0,5,5,5,5,"H"
"2004-08-21",2004,"Woking","Leigh Genesis","1-0",1,0,5,5,1,1,"H"
"2004-08-21",2004,"York City","Hereford United","0-3",0,3,5,5,3,-3,"A"
"2004-08-28",2004,"Accrington","Crawley Town","4-0",4,0,5,5,4,4,"H"
"2004-08-28",2004,"Aldershot","Burton Albion","3-0",3,0,5,5,3,3,"H"
"2004-08-28",2004,"Barnet","Northwich Victoria","4-0",4,0,5,5,4,4,"H"
"2004-08-28",2004,"Carlisle United","Farnborough Town","7-0",7,0,5,5,7,7,"H"
"2004-08-28",2004,"Dagenham and Redbridge","Woking","1-1",1,1,5,5,2,0,"D"
"2004-08-28",2004,"Ebbsfleet United","York City","4-0",4,0,5,5,4,4,"H"
"2004-08-28",2004,"Exeter City","Canvey Island","0-1",0,1,5,5,1,-1,"A"
"2004-08-28",2004,"Hereford United","Stevenage Borough","0-1",0,1,5,5,1,-1,"A"
"2004-08-28",2004,"Leigh Genesis","Halifax Town","0-3",0,3,5,5,3,-3,"A"
"2004-08-28",2004,"Scarborough","Morecambe","1-1",1,1,5,5,2,0,"D"
"2004-08-28",2004,"Tamworth","Forest Green Rovers","4-0",4,0,5,5,4,4,"H"
"2004-08-30",2004,"Burton Albion","Scarborough","2-3",2,3,5,5,5,-1,"A"
"2004-08-30",2004,"Canvey Island","Barnet","0-1",0,1,5,5,1,-1,"A"
"2004-08-30",2004,"Crawley Town","Dagenham and Redbridge","2-0",2,0,5,5,2,2,"H"
"2004-08-30",2004,"Farnborough Town","Exeter City","2-1",2,1,5,5,3,1,"H"
"2004-08-30",2004,"Forest Green Rovers","Ebbsfleet United","1-5",1,5,5,5,6,-4,"A"
"2004-08-30",2004,"Morecambe","Leigh Genesis","2-1",2,1,5,5,3,1,"H"
"2004-08-30",2004,"Northwich Victoria","Hereford United","1-4",1,4,5,5,5,-3,"A"
"2004-08-30",2004,"Stevenage Borough","Tamworth","2-0",2,0,5,5,2,2,"H"
"2004-08-30",2004,"Woking","Aldershot","1-2",1,2,5,5,3,-1,"A"
"2004-08-31",2004,"Halifax Town","Carlisle United","2-2",2,2,5,5,4,0,"D"
"2004-08-31",2004,"York City","Accrington","0-1",0,1,5,5,1,-1,"A"
"2004-09-04",2004,"Accrington","Woking","0-0",0,0,5,5,0,0,"D"
"2004-09-04",2004,"Aldershot","Northwich Victoria","2-1",2,1,5,5,3,1,"H"
"2004-09-04",2004,"Barnet","Morecambe","5-1",5,1,5,5,6,4,"H"
"2004-09-04",2004,"Carlisle United","Burton Albion","0-0",0,0,5,5,0,0,"D"
"2004-09-04",2004,"Dagenham and Redbridge","York City","0-3",0,3,5,5,3,-3,"A"
"2004-09-04",2004,"Ebbsfleet United","Stevenage Borough","2-1",2,1,5,5,3,1,"H"
"2004-09-04",2004,"Exeter City","Crawley Town","3-2",3,2,5,5,5,1,"H"
"2004-09-04",2004,"Hereford United","Halifax Town","2-3",2,3,5,5,5,-1,"A"
"2004-09-04",2004,"Leigh Genesis","Forest Green Rovers","2-0",2,0,5,5,2,2,"H"
"2004-09-04",2004,"Scarborough","Canvey Island","1-1",1,1,5,5,2,0,"D"
"2004-09-04",2004,"Tamworth","Farnborough Town","0-2",0,2,5,5,2,-2,"A"
"2004-09-11",2004,"Crawley Town","York City","1-0",1,0,5,5,1,1,"H"
"2004-09-11",2004,"Dagenham and Redbridge","Accrington","0-5",0,5,5,5,5,-5,"A"
"2004-09-11",2004,"Ebbsfleet United","Hereford United","1-2",1,2,5,5,3,-1,"A"
"2004-09-11",2004,"Farnborough Town","Canvey Island","1-3",1,3,5,5,4,-2,"A"
"2004-09-11",2004,"Halifax Town","Forest Green Rovers","4-0",4,0,5,5,4,4,"H"
"2004-09-11",2004,"Leigh Genesis","Aldershot","3-3",3,3,5,5,6,0,"D"
"2004-09-11",2004,"Northwich Victoria","Morecambe","2-2",2,2,5,5,4,0,"D"
"2004-09-11",2004,"Scarborough","Exeter City","1-1",1,1,5,5,2,0,"D"
"2004-09-11",2004,"Stevenage Borough","Burton Albion","0-1",0,1,5,5,1,-1,"A"
"2004-09-11",2004,"Tamworth","Barnet","0-2",0,2,5,5,2,-2,"A"
"2004-09-11",2004,"Woking","Carlisle United","1-1",1,1,5,5,2,0,"D"
"2004-09-18",2004,"Accrington","Leigh Genesis","2-1",2,1,5,5,3,1,"H"
"2004-09-18",2004,"Aldershot","Dagenham and Redbridge","4-0",4,0,5,5,4,4,"H"
"2004-09-18",2004,"Barnet","Ebbsfleet United","4-1",4,1,5,5,5,3,"H"
"2004-09-18",2004,"Burton Albion","Crawley Town","1-0",1,0,5,5,1,1,"H"
"2004-09-18",2004,"Canvey Island","Halifax Town","0-1",0,1,5,5,1,-1,"A"
"2004-09-18",2004,"Carlisle United","Tamworth","2-1",2,1,5,5,3,1,"H"
"2004-09-18",2004,"Exeter City","Stevenage Borough","2-0",2,0,5,5,2,2,"H"
"2004-09-18",2004,"Forest Green Rovers","Farnborough Town","1-1",1,1,5,5,2,0,"D"
"2004-09-18",2004,"Hereford United","Scarborough","1-0",1,0,5,5,1,1,"H"
"2004-09-18",2004,"Morecambe","Woking","2-1",2,1,5,5,3,1,"H"
"2004-09-18",2004,"York City","Northwich Victoria","0-0",0,0,5,5,0,0,"D"
"2004-09-21",2004,"Barnet","Burton Albion","2-3",2,3,5,5,5,-1,"A"
"2004-09-21",2004,"Canvey Island","Crawley Town","2-2",2,2,5,5,4,0,"D"
"2004-09-21",2004,"Carlisle United","Scarborough","2-1",2,1,5,5,3,1,"H"
"2004-09-21",2004,"Ebbsfleet United","Dagenham and Redbridge","2-1",2,1,5,5,3,1,"H"
"2004-09-21",2004,"Farnborough Town","Stevenage Borough","0-3",0,3,5,5,3,-3,"A"
"2004-09-21",2004,"Forest Green Rovers","Exeter City","2-3",2,3,5,5,5,-1,"A"
"2004-09-21",2004,"Halifax Town","Morecambe","1-3",1,3,5,5,4,-2,"A"
"2004-09-21",2004,"Hereford United","Aldershot","2-0",2,0,5,5,2,2,"H"
"2004-09-21",2004,"Northwich Victoria","Accrington","3-3",3,3,5,5,6,0,"D"
"2004-09-21",2004,"Tamworth","Woking","1-3",1,3,5,5,4,-2,"A"
"2004-09-21",2004,"York City","Leigh Genesis","1-1",1,1,5,5,2,0,"D"
"2004-09-25",2004,"Accrington","Ebbsfleet United","1-2",1,2,5,5,3,-1,"A"
"2004-09-25",2004,"Aldershot","Carlisle United","0-5",0,5,5,5,5,-5,"A"
"2004-09-25",2004,"Burton Albion","York City","0-2",0,2,5,5,2,-2,"A"
"2004-09-25",2004,"Crawley Town","Forest Green Rovers","4-2",4,2,5,5,6,2,"H"
"2004-09-25",2004,"Dagenham and Redbridge","Halifax Town","4-2",4,2,5,5,6,2,"H"
"2004-09-25",2004,"Exeter City","Tamworth","2-2",2,2,5,5,4,0,"D"
"2004-09-25",2004,"Leigh Genesis","Hereford United","3-4",3,4,5,5,7,-1,"A"
"2004-09-25",2004,"Morecambe","Farnborough Town","1-1",1,1,5,5,2,0,"D"
"2004-09-25",2004,"Scarborough","Barnet","1-1",1,1,5,5,2,0,"D"
"2004-09-25",2004,"Stevenage Borough","Northwich Victoria","4-1",4,1,5,5,5,3,"H"
"2004-09-25",2004,"Woking","Canvey Island","1-0",1,0,5,5,1,1,"H"
"2004-10-02",2004,"Barnet","Woking","2-2",2,2,5,5,4,0,"D"
"2004-10-02",2004,"Canvey Island","Morecambe","0-0",0,0,5,5,0,0,"D"
"2004-10-02",2004,"Carlisle United","Crawley Town","1-0",1,0,5,5,1,1,"H"
"2004-10-02",2004,"Ebbsfleet United","Leigh Genesis","4-1",4,1,5,5,5,3,"H"
"2004-10-02",2004,"Farnborough Town","Accrington","2-1",2,1,5,5,3,1,"H"
"2004-10-02",2004,"Forest Green Rovers","Scarborough","0-1",0,1,5,5,1,-1,"A"
"2004-10-02",2004,"Halifax Town","Exeter City","2-1",2,1,5,5,3,1,"H"
"2004-10-02",2004,"Hereford United","Burton Albion","0-0",0,0,5,5,0,0,"D"
"2004-10-02",2004,"Northwich Victoria","Dagenham and Redbridge","2-2",2,2,5,5,4,0,"D"
"2004-10-02",2004,"Tamworth","Aldershot","1-2",1,2,5,5,3,-1,"A"
"2004-10-02",2004,"York City","Stevenage Borough","3-1",3,1,5,5,4,2,"H"
"2004-10-05",2004,"Accrington","Tamworth","2-3",2,3,5,5,5,-1,"A"
"2004-10-05",2004,"Aldershot","Ebbsfleet United","1-0",1,0,5,5,1,1,"H"
"2004-10-05",2004,"Crawley Town","Farnborough Town","2-0",2,0,5,5,2,2,"H"
"2004-10-05",2004,"Dagenham and Redbridge","Hereford United","3-1",3,1,5,5,4,2,"H"
"2004-10-05",2004,"Exeter City","Barnet","0-3",0,3,5,5,3,-3,"A"
"2004-10-05",2004,"Leigh Genesis","Carlisle United","1-6",1,6,5,5,7,-5,"A"
"2004-10-05",2004,"Morecambe","York City","2-1",2,1,5,5,3,1,"H"
"2004-10-05",2004,"Scarborough","Northwich Victoria","3-0",3,0,5,5,3,3,"H"
"2004-10-05",2004,"Stevenage Borough","Canvey Island","1-4",1,4,5,5,5,-3,"A"
"2004-10-05",2004,"Woking","Forest Green Rovers","0-1",0,1,5,5,1,-1,"A"
"2004-10-08",2004,"Woking","Halifax Town","2-1",2,1,5,5,3,1,"H"
"2004-10-09",2004,"Barnet","Dagenham and Redbridge","5-0",5,0,5,5,5,5,"H"
"2004-10-09",2004,"Burton Albion","Ebbsfleet United","3-2",3,2,5,5,5,1,"H"
"2004-10-09",2004,"Canvey Island","Forest Green Rovers","2-1",2,1,5,5,3,1,"H"
"2004-10-09",2004,"Crawley Town","Northwich Victoria","0-0",0,0,5,5,0,0,"D"
"2004-10-09",2004,"Exeter City","Carlisle United","0-0",0,0,5,5,0,0,"D"
"2004-10-09",2004,"Farnborough Town","York City","1-1",1,1,5,5,2,0,"D"
"2004-10-09",2004,"Leigh Genesis","Stevenage Borough","1-2",1,2,5,5,3,-1,"A"
"2004-10-09",2004,"Morecambe","Tamworth","3-0",3,0,5,5,3,3,"H"
"2004-10-09",2004,"Scarborough","Aldershot","2-2",2,2,5,5,4,0,"D"
"2004-10-11",2004,"Accrington","Hereford United","2-1",2,1,5,5,3,1,"H"
"2004-10-12",2004,"Burton Albion","Halifax Town","2-2",2,2,5,5,4,0,"D"
"2004-10-16",2004,"Aldershot","Accrington","0-0",0,0,5,5,0,0,"D"
"2004-10-16",2004,"Carlisle United","Barnet","1-3",1,3,5,5,4,-2,"A"
"2004-10-16",2004,"Dagenham and Redbridge","Leigh Genesis","2-0",2,0,5,5,2,2,"H"
"2004-10-16",2004,"Ebbsfleet United","Exeter City","1-1",1,1,5,5,2,0,"D"
"2004-10-16",2004,"Forest Green Rovers","Morecambe","0-3",0,3,5,5,3,-3,"A"
"2004-10-16",2004,"Halifax Town","Farnborough Town","2-0",2,0,5,5,2,2,"H"
"2004-10-16",2004,"Hereford United","Woking","2-2",2,2,5,5,4,0,"D"
"2004-10-16",2004,"Northwich Victoria","Burton Albion","4-0",4,0,5,5,4,4,"H"
"2004-10-16",2004,"Stevenage Borough","Crawley Town","1-0",1,0,5,5,1,1,"H"
"2004-10-16",2004,"Tamworth","Scarborough","1-0",1,0,5,5,1,1,"H"
"2004-10-16",2004,"York City","Canvey Island","0-0",0,0,5,5,0,0,"D"
"2004-10-23",2004,"Barnet","York City","4-0",4,0,5,5,4,4,"H"
"2004-10-23",2004,"Canvey Island","Leigh Genesis","3-0",3,0,5,5,3,3,"H"
"2004-10-23",2004,"Carlisle United","Hereford United","3-1",3,1,5,5,4,2,"H"
"2004-10-23",2004,"Exeter City","Aldershot","3-1",3,1,5,5,4,2,"H"
"2004-10-23",2004,"Farnborough Town","Dagenham and Redbridge","2-1",2,1,5,5,3,1,"H"
"2004-10-23",2004,"Forest Green Rovers","Northwich Victoria","1-3",1,3,5,5,4,-2,"A"
"2004-10-23",2004,"Halifax Town","Ebbsfleet United","1-0",1,0,5,5,1,1,"H"
"2004-10-23",2004,"Morecambe","Stevenage Borough","1-3",1,3,5,5,4,-2,"A"
"2004-10-23",2004,"Scarborough","Accrington","4-0",4,0,5,5,4,4,"H"
"2004-10-23",2004,"Tamworth","Crawley Town","1-0",1,0,5,5,1,1,"H"
"2004-10-23",2004,"Woking","Burton Albion","1-0",1,0,5,5,1,1,"H"
"2004-11-05",2004,"Northwich Victoria","Canvey Island","3-1",3,1,5,5,4,2,"H"
"2004-11-06",2004,"Accrington","Exeter City","0-0",0,0,5,5,0,0,"D"
"2004-11-06",2004,"Aldershot","Morecambe","3-3",3,3,5,5,6,0,"D"
"2004-11-06",2004,"Burton Albion","Farnborough Town","0-0",0,0,5,5,0,0,"D"
"2004-11-06",2004,"Crawley Town","Woking","2-1",2,1,5,5,3,1,"H"
"2004-11-06",2004,"Dagenham and Redbridge","Scarborough","0-3",0,3,5,5,3,-3,"A"
"2004-11-06",2004,"Ebbsfleet United","Carlisle United","1-3",1,3,5,5,4,-2,"A"
"2004-11-06",2004,"Hereford United","Barnet","1-1",1,1,5,5,2,0,"D"
"2004-11-06",2004,"Leigh Genesis","Tamworth","2-3",2,3,5,5,5,-1,"A"
"2004-11-06",2004,"Stevenage Borough","Halifax Town","2-1",2,1,5,5,3,1,"H"
"2004-11-06",2004,"York City","Forest Green Rovers","1-3",1,3,5,5,4,-2,"A"
"2004-11-13",2004,"Accrington","Northwich Victoria","5-0",5,0,5,5,5,5,"H"
"2004-11-20",2004,"Barnet","Accrington","3-0",3,0,5,5,3,3,"H"
"2004-11-20",2004,"Canvey Island","Hereford United","0-4",0,4,5,5,4,-4,"A"
"2004-11-20",2004,"Carlisle United","Dagenham and Redbridge","1-0",1,0,5,5,1,1,"H"
"2004-11-20",2004,"Exeter City","Leigh Genesis","5-1",5,1,5,5,6,4,"H"
"2004-11-20",2004,"Farnborough Town","Northwich Victoria","0-2",0,2,5,5,2,-2,"A"
"2004-11-20",2004,"Forest Green Rovers","Burton Albion","3-2",3,2,5,5,5,1,"H"
"2004-11-20",2004,"Halifax Town","Aldershot","2-0",2,0,5,5,2,2,"H"
"2004-11-20",2004,"Morecambe","Crawley Town","1-2",1,2,5,5,3,-1,"A"
"2004-11-20",2004,"Scarborough","Stevenage Borough","3-3",3,3,5,5,6,0,"D"
"2004-11-20",2004,"Tamworth","Ebbsfleet United","2-1",2,1,5,5,3,1,"H"
"2004-11-20",2004,"Woking","York City","1-0",1,0,5,5,1,1,"H"
"2004-11-27",2004,"Accrington","Canvey Island","1-0",1,0,5,5,1,1,"H"
"2004-11-27",2004,"Aldershot","Barnet","2-3",2,3,5,5,5,-1,"A"
"2004-11-27",2004,"Burton Albion","Exeter City","1-0",1,0,5,5,1,1,"H"
"2004-11-27",2004,"Crawley Town","Scarborough","2-1",2,1,5,5,3,1,"H"
"2004-11-27",2004,"Dagenham and Redbridge","Morecambe","2-1",2,1,5,5,3,1,"H"
"2004-11-27",2004,"Ebbsfleet United","Woking","1-1",1,1,5,5,2,0,"D"
"2004-11-27",2004,"Hereford United","Tamworth","2-1",2,1,5,5,3,1,"H"
"2004-11-27",2004,"Leigh Genesis","Farnborough Town","1-2",1,2,5,5,3,-1,"A"
"2004-11-27",2004,"Northwich Victoria","Halifax Town","1-2",1,2,5,5,3,-1,"A"
"2004-11-27",2004,"Stevenage Borough","Forest Green Rovers","2-2",2,2,5,5,4,0,"D"
"2004-11-27",2004,"York City","Carlisle United","2-1",2,1,5,5,3,1,"H"
"2004-12-04",2004,"Barnet","Leigh Genesis","3-2",3,2,5,5,5,1,"H"
"2004-12-04",2004,"Canvey Island","Burton Albion","2-2",2,2,5,5,4,0,"D"
"2004-12-04",2004,"Forest Green Rovers","Accrington","1-0",1,0,5,5,1,1,"H"
"2004-12-04",2004,"Scarborough","Ebbsfleet United","1-0",1,0,5,5,1,1,"H"
"2004-12-04",2004,"Tamworth","Dagenham and Redbridge","0-4",0,4,5,5,4,-4,"A"
"2004-12-04",2004,"Woking","Northwich Victoria","2-0",2,0,5,5,2,2,"H"
"2004-12-07",2004,"Accrington","Carlisle United","1-2",1,2,5,5,3,-1,"A"
"2004-12-07",2004,"Aldershot","Canvey Island","2-0",2,0,5,5,2,2,"H"
"2004-12-07",2004,"Burton Albion","Morecambe","1-3",1,3,5,5,4,-2,"A"
"2004-12-07",2004,"Crawley Town","Barnet","1-3",1,3,5,5,4,-2,"A"
"2004-12-07",2004,"Dagenham and Redbridge","Exeter City","2-3",2,3,5,5,5,-1,"A"
"2004-12-07",2004,"Ebbsfleet United","Farnborough Town","2-2",2,2,5,5,4,0,"D"
"2004-12-07",2004,"Hereford United","Forest Green Rovers","2-1",2,1,5,5,3,1,"H"
"2004-12-07",2004,"Leigh Genesis","Scarborough","1-1",1,1,5,5,2,0,"D"
"2004-12-07",2004,"Stevenage Borough","Woking","0-2",0,2,5,5,2,-2,"A"
"2004-12-07",2004,"York City","Halifax Town","1-1",1,1,5,5,2,0,"D"
"2004-12-08",2004,"Northwich Victoria","Tamworth","1-2",1,2,5,5,3,-1,"A"
"2004-12-11",2004,"Crawley Town","Burton Albion","4-0",4,0,5,5,4,4,"H"
"2004-12-11",2004,"Dagenham and Redbridge","Aldershot","3-0",3,0,5,5,3,3,"H"
"2004-12-11",2004,"Ebbsfleet United","Barnet","1-3",1,3,5,5,4,-2,"A"
"2004-12-11",2004,"Farnborough Town","Forest Green Rovers","1-1",1,1,5,5,2,0,"D"
"2004-12-11",2004,"Halifax Town","Canvey Island","4-1",4,1,5,5,5,3,"H"
"2004-12-11",2004,"Leigh Genesis","Accrington","0-6",0,6,5,5,6,-6,"A"
"2004-12-11",2004,"Northwich Victoria","York City","3-0",3,0,5,5,3,3,"H"
"2004-12-11",2004,"Scarborough","Hereford United","0-0",0,0,5,5,0,0,"D"
"2004-12-11",2004,"Stevenage Borough","Exeter City","3-2",3,2,5,5,5,1,"H"
"2004-12-11",2004,"Tamworth","Carlisle United","1-0",1,0,5,5,1,1,"H"
"2004-12-11",2004,"Woking","Morecambe","0-0",0,0,5,5,0,0,"D"
"2004-12-18",2004,"Accrington","Dagenham and Redbridge","0-3",0,3,5,5,3,-3,"A"
"2004-12-18",2004,"Aldershot","Leigh Genesis","2-0",2,0,5,5,2,2,"H"
"2004-12-18",2004,"Barnet","Tamworth","0-3",0,3,5,5,3,-3,"A"
"2004-12-18",2004,"Burton Albion","Stevenage Borough","0-3",0,3,5,5,3,-3,"A"
"2004-12-18",2004,"Canvey Island","Farnborough Town","1-1",1,1,5,5,2,0,"D"
"2004-12-18",2004,"Carlisle United","Woking","2-1",2,1,5,5,3,1,"H"
"2004-12-18",2004,"Exeter City","Scarborough","3-1",3,1,5,5,4,2,"H"
"2004-12-18",2004,"Forest Green Rovers","Halifax Town","0-0",0,0,5,5,0,0,"D"
"2004-12-18",2004,"Hereford United","Ebbsfleet United","1-0",1,0,5,5,1,1,"H"
"2004-12-18",2004,"Morecambe","Northwich Victoria","3-1",3,1,5,5,4,2,"H"
"2004-12-18",2004,"York City","Crawley Town","3-1",3,1,5,5,4,2,"H"
"2004-12-26",2004,"Aldershot","Forest Green Rovers","1-2",1,2,5,5,3,-1,"A"
"2004-12-26",2004,"Crawley Town","Ebbsfleet United","1-1",1,1,5,5,2,0,"D"
"2004-12-26",2004,"Exeter City","Hereford United","4-0",4,0,5,5,4,4,"H"
"2004-12-26",2004,"Morecambe","Carlisle United","1-1",1,1,5,5,2,0,"D"
"2004-12-26",2004,"Scarborough","York City","5-1",5,1,5,5,6,4,"H"
"2004-12-26",2004,"Stevenage Borough","Barnet","2-1",2,1,5,5,3,1,"H"
"2004-12-26",2004,"Woking","Farnborough Town","2-0",2,0,5,5,2,2,"H"
"2004-12-28",2004,"Barnet","Scarborough","1-0",1,0,5,5,1,1,"H"
"2004-12-28",2004,"Canvey Island","Woking","2-2",2,2,5,5,4,0,"D"
"2004-12-28",2004,"Carlisle United","Aldershot","1-1",1,1,5,5,2,0,"D"
"2004-12-28",2004,"Ebbsfleet United","Accrington","2-2",2,2,5,5,4,0,"D"
"2004-12-28",2004,"Farnborough Town","Morecambe","1-2",1,2,5,5,3,-1,"A"
"2004-12-28",2004,"Forest Green Rovers","Crawley Town","1-1",1,1,5,5,2,0,"D"
"2004-12-28",2004,"Halifax Town","Dagenham and Redbridge","2-2",2,2,5,5,4,0,"D"
"2004-12-28",2004,"Hereford United","Leigh Genesis","3-0",3,0,5,5,3,3,"H"
"2004-12-28",2004,"Northwich Victoria","Stevenage Borough","1-1",1,1,5,5,2,0,"D"
"2004-12-28",2004,"Tamworth","Exeter City","1-2",1,2,5,5,3,-1,"A"
"2004-12-29",2004,"York City","Burton Albion","1-2",1,2,5,5,3,-1,"A"
"2005-01-01",2004,"Canvey Island","Dagenham and Redbridge","4-2",4,2,5,5,6,2,"H"
"2005-01-01",2004,"Ebbsfleet United","Crawley Town","0-0",0,0,5,5,0,0,"D"
"2005-01-01",2004,"Farnborough Town","Woking","0-0",0,0,5,5,0,0,"D"
"2005-01-01",2004,"Forest Green Rovers","Aldershot","0-0",0,0,5,5,0,0,"D"
"2005-01-01",2004,"Hereford United","Exeter City","1-2",1,2,5,5,3,-1,"A"
"2005-01-01",2004,"Tamworth","Burton Albion","0-2",0,2,5,5,2,-2,"A"
"2005-01-02",2004,"Barnet","Stevenage Borough","2-1",2,1,5,5,3,1,"H"
"2005-01-02",2004,"Carlisle United","Morecambe","3-3",3,3,5,5,6,0,"D"
"2005-01-02",2004,"York City","Scarborough","0-2",0,2,5,5,2,-2,"A"
"2005-01-03",2004,"Halifax Town","Accrington","1-2",1,2,5,5,3,-1,"A"
"2005-01-08",2004,"Accrington","Farnborough Town","2-1",2,1,5,5,3,1,"H"
"2005-01-08",2004,"Aldershot","Tamworth","4-3",4,3,5,5,7,1,"H"
"2005-01-08",2004,"Burton Albion","Hereford United","3-0",3,0,5,5,3,3,"H"
"2005-01-08",2004,"Crawley Town","Carlisle United","1-0",1,0,5,5,1,1,"H"
"2005-01-08",2004,"Dagenham and Redbridge","Northwich Victoria","2-3",2,3,5,5,5,-1,"A"
"2005-01-08",2004,"Leigh Genesis","Ebbsfleet United","0-1",0,1,5,5,1,-1,"A"
"2005-01-08",2004,"Morecambe","Canvey Island","4-0",4,0,5,5,4,4,"H"
"2005-01-08",2004,"Scarborough","Forest Green Rovers","0-0",0,0,5,5,0,0,"D"
"2005-01-08",2004,"Stevenage Borough","York City","2-2",2,2,5,5,4,0,"D"
"2005-01-08",2004,"Woking","Barnet","1-1",1,1,5,5,2,0,"D"
"2005-01-11",2004,"Halifax Town","Crawley Town","1-0",1,0,5,5,1,1,"H"
"2005-01-18",2004,"Farnborough Town","Aldershot","1-2",1,2,5,5,3,-1,"A"
"2005-01-22",2004,"Barnet","Exeter City","1-0",1,0,5,5,1,1,"H"
"2005-01-22",2004,"Canvey Island","Stevenage Borough","3-0",3,0,5,5,3,3,"H"
"2005-01-22",2004,"Ebbsfleet United","Aldershot","1-3",1,3,5,5,4,-2,"A"
"2005-01-22",2004,"Farnborough Town","Crawley Town","2-3",2,3,5,5,5,-1,"A"
"2005-01-22",2004,"Forest Green Rovers","Woking","1-3",1,3,5,5,4,-2,"A"
"2005-01-22",2004,"Hereford United","Dagenham and Redbridge","0-1",0,1,5,5,1,-1,"A"
"2005-01-22",2004,"Northwich Victoria","Scarborough","1-0",1,0,5,5,1,1,"H"
"2005-01-22",2004,"Tamworth","Accrington","1-0",1,0,5,5,1,1,"H"
"2005-01-22",2004,"York City","Morecambe","1-0",1,0,5,5,1,1,"H"
"2005-01-25",2004,"Halifax Town","Burton Albion","2-0",2,0,5,5,2,2,"H"
"2005-01-29",2004,"Burton Albion","Barnet","1-1",1,1,5,5,2,0,"D"
"2005-01-29",2004,"Crawley Town","Canvey Island","2-1",2,1,5,5,3,1,"H"
"2005-01-29",2004,"Dagenham and Redbridge","Ebbsfleet United","5-0",5,0,5,5,5,5,"H"
"2005-01-29",2004,"Exeter City","Forest Green Rovers","2-0",2,0,5,5,2,2,"H"
"2005-01-29",2004,"Leigh Genesis","York City","0-3",0,3,5,5,3,-3,"A"
"2005-01-29",2004,"Morecambe","Halifax Town","2-1",2,1,5,5,3,1,"H"
"2005-01-29",2004,"Scarborough","Carlisle United","1-1",1,1,5,5,2,0,"D"
"2005-01-29",2004,"Stevenage Borough","Farnborough Town","3-1",3,1,5,5,4,2,"H"
"2005-01-29",2004,"Woking","Tamworth","2-1",2,1,5,5,3,1,"H"
"2005-01-30",2004,"Aldershot","Hereford United","0-2",0,2,5,5,2,-2,"A"
"2005-01-31",2004,"Dagenham and Redbridge","Canvey Island","3-1",3,1,5,5,4,2,"H"
"2005-02-01",2004,"Burton Albion","Tamworth","1-1",1,1,5,5,2,0,"D"
"2005-02-05",2004,"Accrington","Scarborough","2-1",2,1,5,5,3,1,"H"
"2005-02-05",2004,"Dagenham and Redbridge","Farnborough Town","0-0",0,0,5,5,0,0,"D"
"2005-02-05",2004,"Forest Green Rovers","Leigh Genesis","1-1",1,1,5,5,2,0,"D"
"2005-02-06",2004,"York City","Aldershot","0-2",0,2,5,5,2,-2,"A"
"2005-02-12",2004,"Barnet","Hereford United","0-2",0,2,5,5,2,-2,"A"
"2005-02-12",2004,"Canvey Island","Northwich Victoria","2-2",2,2,5,5,4,0,"D"
"2005-02-12",2004,"Carlisle United","Ebbsfleet United","2-2",2,2,5,5,4,0,"D"
"2005-02-12",2004,"Exeter City","Accrington","1-2",1,2,5,5,3,-1,"A"
"2005-02-12",2004,"Farnborough Town","Burton Albion","1-3",1,3,5,5,4,-2,"A"
"2005-02-12",2004,"Forest Green Rovers","York City","1-1",1,1,5,5,2,0,"D"
"2005-02-12",2004,"Halifax Town","Stevenage Borough","2-1",2,1,5,5,3,1,"H"
"2005-02-12",2004,"Scarborough","Dagenham and Redbridge","2-0",2,0,5,5,2,2,"H"
"2005-02-12",2004,"Woking","Crawley Town","2-0",2,0,5,5,2,2,"H"
"2005-02-15",2004,"Crawley Town","Tamworth","3-0",3,0,5,5,3,3,"H"
"2005-02-15",2004,"Leigh Genesis","Northwich Victoria","0-1",0,1,5,5,1,-1,"A"
"2005-02-19",2004,"Accrington","Barnet","4-1",4,1,5,5,5,3,"H"
"2005-02-19",2004,"Aldershot","Halifax Town","0-0",0,0,5,5,0,0,"D"
"2005-02-19",2004,"Burton Albion","Forest Green Rovers","4-1",4,1,5,5,5,3,"H"
"2005-02-19",2004,"Dagenham and Redbridge","Carlisle United","1-0",1,0,5,5,1,1,"H"
"2005-02-19",2004,"Ebbsfleet United","Tamworth","2-0",2,0,5,5,2,2,"H"
"2005-02-19",2004,"Hereford United","Canvey Island","1-0",1,0,5,5,1,1,"H"
"2005-02-19",2004,"Leigh Genesis","Exeter City","0-1",0,1,5,5,1,-1,"A"
"2005-02-19",2004,"Northwich Victoria","Farnborough Town","2-0",2,0,5,5,2,2,"H"
"2005-02-19",2004,"Stevenage Borough","Scarborough","1-0",1,0,5,5,1,1,"H"
"2005-02-19",2004,"York City","Woking","0-2",0,2,5,5,2,-2,"A"
"2005-02-21",2004,"Crawley Town","Morecambe","2-1",2,1,5,5,3,1,"H"
"2005-02-22",2004,"Accrington","Halifax Town","1-1",1,1,5,5,2,0,"D"
"2005-02-22",2004,"Carlisle United","Stevenage Borough","1-2",1,2,5,5,3,-1,"A"
"2005-02-22",2004,"Exeter City","York City","0-1",0,1,5,5,1,-1,"A"
"2005-02-22",2004,"Tamworth","Leigh Genesis","0-1",0,1,5,5,1,-1,"A"
"2005-02-26",2004,"Barnet","Aldershot","2-1",2,1,5,5,3,1,"H"
"2005-02-26",2004,"Farnborough Town","Leigh Genesis","0-1",0,1,5,5,1,-1,"A"
"2005-02-26",2004,"Forest Green Rovers","Stevenage Borough","1-1",1,1,5,5,2,0,"D"
"2005-02-26",2004,"Halifax Town","Northwich Victoria","2-2",2,2,5,5,4,0,"D"
"2005-02-26",2004,"Scarborough","Crawley Town","2-2",2,2,5,5,4,0,"D"
"2005-03-01",2004,"Aldershot","Exeter City","2-1",2,1,5,5,3,1,"H"
"2005-03-01",2004,"Stevenage Borough","Morecambe","0-1",0,1,5,5,1,-1,"A"
"2005-03-01",2004,"York City","Barnet","2-1",2,1,5,5,3,1,"H"
"2005-03-05",2004,"Accrington","Forest Green Rovers","2-2",2,2,5,5,4,0,"D"
"2005-03-05",2004,"Aldershot","Farnborough Town","3-1",3,1,5,5,4,2,"H"
"2005-03-05",2004,"Burton Albion","Canvey Island","1-1",1,1,5,5,2,0,"D"
"2005-03-05",2004,"Crawley Town","Halifax Town","1-2",1,2,5,5,3,-1,"A"
"2005-03-05",2004,"Dagenham and Redbridge","Tamworth","0-0",0,0,5,5,0,0,"D"
"2005-03-05",2004,"Ebbsfleet United","Scarborough","4-0",4,0,5,5,4,4,"H"
"2005-03-05",2004,"Hereford United","Morecambe","1-1",1,1,5,5,2,0,"D"
"2005-03-05",2004,"Leigh Genesis","Barnet","0-3",0,3,5,5,3,-3,"A"
"2005-03-05",2004,"Northwich Victoria","Woking","1-3",1,3,5,5,4,-2,"A"
"2005-03-05",2004,"Stevenage Borough","Carlisle United","2-1",2,1,5,5,3,1,"H"
"2005-03-05",2004,"York City","Exeter City","1-2",1,2,5,5,3,-1,"A"
"2005-03-08",2004,"Burton Albion","Woking","0-1",0,1,5,5,1,-1,"A"
"2005-03-08",2004,"Carlisle United","Leigh Genesis","3-0",3,0,5,5,3,3,"H"
"2005-03-08",2004,"Ebbsfleet United","Halifax Town","0-3",0,3,5,5,3,-3,"A"
"2005-03-08",2004,"Morecambe","Aldershot","0-0",0,0,5,5,0,0,"D"
"2005-03-08",2004,"Tamworth","Hereford United","2-2",2,2,5,5,4,0,"D"
"2005-03-11",2004,"Canvey Island","Aldershot","2-2",2,2,5,5,4,0,"D"
"2005-03-12",2004,"Barnet","Crawley Town","3-0",3,0,5,5,3,3,"H"
"2005-03-12",2004,"Carlisle United","Accrington","2-0",2,0,5,5,2,2,"H"
"2005-03-12",2004,"Morecambe","Dagenham and Redbridge","1-0",1,0,5,5,1,1,"H"
"2005-03-12",2004,"Scarborough","Leigh Genesis","3-0",3,0,5,5,3,3,"H"
"2005-03-12",2004,"Tamworth","Northwich Victoria","3-0",3,0,5,5,3,3,"H"
"2005-03-14",2004,"Halifax Town","York City","2-0",2,0,5,5,2,2,"H"
"2005-03-15",2004,"Exeter City","Burton Albion","3-1",3,1,5,5,4,2,"H"
"2005-03-15",2004,"Scarborough","Tamworth","2-2",2,2,5,5,4,0,"D"
"2005-03-19",2004,"Accrington","Morecambe","2-1",2,1,5,5,3,1,"H"
"2005-03-19",2004,"Aldershot","Stevenage Borough","0-1",0,1,5,5,1,-1,"A"
"2005-03-19",2004,"Barnet","Farnborough Town","7-1",7,1,5,5,8,6,"H"
"2005-03-19",2004,"Carlisle United","Northwich Victoria","1-0",1,0,5,5,1,1,"H"
"2005-03-19",2004,"Dagenham and Redbridge","Forest Green Rovers","2-2",2,2,5,5,4,0,"D"
"2005-03-19",2004,"Ebbsfleet United","Canvey Island","3-2",3,2,5,5,5,1,"H"
"2005-03-19",2004,"Exeter City","Woking","0-0",0,0,5,5,0,0,"D"
"2005-03-19",2004,"Hereford United","Crawley Town","0-0",0,0,5,5,0,0,"D"
"2005-03-19",2004,"Leigh Genesis","Burton Albion","1-4",1,4,5,5,5,-3,"A"
"2005-03-19",2004,"Scarborough","Halifax Town","3-1",3,1,5,5,4,2,"H"
"2005-03-19",2004,"Tamworth","York City","1-0",1,0,5,5,1,1,"H"
"2005-03-22",2004,"Burton Albion","Aldershot","1-3",1,3,5,5,4,-2,"A"
"2005-03-22",2004,"Canvey Island","Accrington","0-2",0,2,5,5,2,-2,"A"
"2005-03-22",2004,"Morecambe","Hereford United","2-1",2,1,5,5,3,1,"H"
"2005-03-23",2004,"Woking","Scarborough","1-1",1,1,5,5,2,0,"D"
"2005-03-25",2004,"Burton Albion","Accrington","2-2",2,2,5,5,4,0,"D"
"2005-03-25",2004,"Canvey Island","Carlisle United","0-3",0,3,5,5,3,-3,"A"
"2005-03-25",2004,"Crawley Town","Leigh Genesis","2-2",2,2,5,5,4,0,"D"
"2005-03-25",2004,"Farnborough Town","Hereford United","0-6",0,6,5,5,6,-6,"A"
"2005-03-25",2004,"Forest Green Rovers","Barnet","0-2",0,2,5,5,2,-2,"A"
"2005-03-25",2004,"Halifax Town","Tamworth","3-3",3,3,5,5,6,0,"D"
"2005-03-25",2004,"Morecambe","Exeter City","2-2",2,2,5,5,4,0,"D"
"2005-03-25",2004,"Northwich Victoria","Ebbsfleet United","1-2",1,2,5,5,3,-1,"A"
"2005-03-25",2004,"Stevenage Borough","Dagenham and Redbridge","1-0",1,0,5,5,1,1,"H"
"2005-03-27",2004,"Aldershot","Woking","4-0",4,0,5,5,4,4,"H"
"2005-03-28",2004,"Accrington","York City","2-2",2,2,5,5,4,0,"D"
"2005-03-28",2004,"Barnet","Canvey Island","1-0",1,0,5,5,1,1,"H"
"2005-03-28",2004,"Carlisle United","Halifax Town","1-0",1,0,5,5,1,1,"H"
"2005-03-28",2004,"Dagenham and Redbridge","Crawley Town","1-0",1,0,5,5,1,1,"H"
"2005-03-28",2004,"Ebbsfleet United","Forest Green Rovers","0-0",0,0,5,5,0,0,"D"
"2005-03-28",2004,"Exeter City","Farnborough Town","2-1",2,1,5,5,3,1,"H"
"2005-03-28",2004,"Hereford United","Northwich Victoria","4-0",4,0,5,5,4,4,"H"
"2005-03-28",2004,"Leigh Genesis","Morecambe","0-2",0,2,5,5,2,-2,"A"
"2005-03-28",2004,"Scarborough","Burton Albion","1-1",1,1,5,5,2,0,"D"
"2005-03-28",2004,"Tamworth","Stevenage Borough","0-0",0,0,5,5,0,0,"D"
"2005-04-02",2004,"Canvey Island","Exeter City","2-2",2,2,5,5,4,0,"D"
"2005-04-02",2004,"Crawley Town","Accrington","2-0",2,0,5,5,2,2,"H"
"2005-04-02",2004,"Farnborough Town","Carlisle United","1-2",1,2,5,5,3,-1,"A"
"2005-04-02",2004,"Forest Green Rovers","Tamworth","1-1",1,1,5,5,2,0,"D"
"2005-04-02",2004,"Halifax Town","Leigh Genesis","5-1",5,1,5,5,6,4,"H"
"2005-04-02",2004,"Morecambe","Scarborough","2-1",2,1,5,5,3,1,"H"
"2005-04-02",2004,"Northwich Victoria","Barnet","2-0",2,0,5,5,2,2,"H"
"2005-04-02",2004,"Stevenage Borough","Hereford United","0-1",0,1,5,5,1,-1,"A"
"2005-04-02",2004,"Woking","Dagenham and Redbridge","2-4",2,4,5,5,6,-2,"A"
"2005-04-02",2004,"York City","Ebbsfleet United","0-0",0,0,5,5,0,0,"D"
"2005-04-05",2004,"Dagenham and Redbridge","Burton Albion","3-1",3,1,5,5,4,2,"H"
"2005-04-05",2004,"Exeter City","Halifax Town","2-1",2,1,5,5,3,1,"H"
"2005-04-05",2004,"Hereford United","Carlisle United","0-0",0,0,5,5,0,0,"D"
"2005-04-05",2004,"Leigh Genesis","Canvey Island","2-1",2,1,5,5,3,1,"H"
"2005-04-05",2004,"Northwich Victoria","Forest Green Rovers","2-1",2,1,5,5,3,1,"H"
"2005-04-05",2004,"Woking","Stevenage Borough","1-2",1,2,5,5,3,-1,"A"
"2005-04-09",2004,"Accrington","Stevenage Borough","4-1",4,1,5,5,5,3,"H"
"2005-04-09",2004,"Aldershot","Crawley Town","1-0",1,0,5,5,1,1,"H"
"2005-04-09",2004,"Barnet","Halifax Town","3-1",3,1,5,5,4,2,"H"
"2005-04-09",2004,"Carlisle United","Forest Green Rovers","0-1",0,1,5,5,1,-1,"A"
"2005-04-09",2004,"Ebbsfleet United","Morecambe","1-2",1,2,5,5,3,-1,"A"
"2005-04-09",2004,"Exeter City","Northwich Victoria","2-3",2,3,5,5,5,-1,"A"
"2005-04-09",2004,"Hereford United","York City","2-0",2,0,5,5,2,2,"H"
"2005-04-09",2004,"Leigh Genesis","Woking","0-3",0,3,5,5,3,-3,"A"
"2005-04-09",2004,"Scarborough","Farnborough Town","4-0",4,0,5,5,4,4,"H"
"2005-04-09",2004,"Tamworth","Canvey Island","1-0",1,0,5,5,1,1,"H"
"2005-04-12",2004,"Carlisle United","York City","6-0",6,0,5,5,6,6,"H"
"2005-04-12",2004,"Exeter City","Dagenham and Redbridge","1-1",1,1,5,5,2,0,"D"
"2005-04-12",2004,"Farnborough Town","Ebbsfleet United","0-3",0,3,5,5,3,-3,"A"
"2005-04-12",2004,"Forest Green Rovers","Hereford United","1-3",1,3,5,5,4,-2,"A"
"2005-04-12",2004,"Morecambe","Burton Albion","3-0",3,0,5,5,3,3,"H"
"2005-04-12",2004,"Northwich Victoria","Leigh Genesis","2-0",2,0,5,5,2,2,"H"
"2005-04-14",2004,"Woking","Ebbsfleet United","2-0",2,0,5,5,2,2,"H"
"2005-04-16",2004,"Burton Albion","Carlisle United","0-1",0,1,5,5,1,-1,"A"
"2005-04-16",2004,"Canvey Island","Scarborough","1-0",1,0,5,5,1,1,"H"
"2005-04-16",2004,"Crawley Town","Exeter City","0-1",0,1,5,5,1,-1,"A"
"2005-04-16",2004,"Farnborough Town","Tamworth","2-2",2,2,5,5,4,0,"D"
"2005-04-16",2004,"Halifax Town","Hereford United","0-1",0,1,5,5,1,-1,"A"
"2005-04-16",2004,"Morecambe","Barnet","1-1",1,1,5,5,2,0,"D"
"2005-04-16",2004,"Northwich Victoria","Aldershot","1-2",1,2,5,5,3,-1,"A"
"2005-04-16",2004,"Stevenage Borough","Ebbsfleet United","2-0",2,0,5,5,2,2,"H"
"2005-04-16",2004,"Woking","Accrington","2-1",2,1,5,5,3,1,"H"
"2005-04-16",2004,"York City","Dagenham and Redbridge","0-0",0,0,5,5,0,0,"D"
"2005-04-19",2004,"Accrington","Aldershot","3-3",3,3,5,5,6,0,"D"
"2005-04-19",2004,"Barnet","Carlisle United","1-1",1,1,5,5,2,0,"D"
"2005-04-19",2004,"Burton Albion","Northwich Victoria","1-0",1,0,5,5,1,1,"H"
"2005-04-19",2004,"Canvey Island","York City","4-0",4,0,5,5,4,4,"H"
"2005-04-19",2004,"Crawley Town","Stevenage Borough","1-2",1,2,5,5,3,-1,"A"
"2005-04-19",2004,"Exeter City","Ebbsfleet United","3-0",3,0,5,5,3,3,"H"
"2005-04-19",2004,"Farnborough Town","Halifax Town","3-2",3,2,5,5,5,1,"H"
"2005-04-19",2004,"Leigh Genesis","Dagenham and Redbridge","0-1",0,1,5,5,1,-1,"A"
"2005-04-19",2004,"Morecambe","Forest Green Rovers","3-1",3,1,5,5,4,2,"H"
"2005-04-19",2004,"Woking","Hereford United","1-1",1,1,5,5,2,0,"D"
"2005-04-23",2004,"Aldershot","Scarborough","2-0",2,0,5,5,2,2,"H"
"2005-04-23",2004,"Carlisle United","Exeter City","0-2",0,2,5,5,2,-2,"A"
"2005-04-23",2004,"Dagenham and Redbridge","Barnet","2-0",2,0,5,5,2,2,"H"
"2005-04-23",2004,"Ebbsfleet United","Burton Albion","0-2",0,2,5,5,2,-2,"A"
"2005-04-23",2004,"Forest Green Rovers","Canvey Island","2-2",2,2,5,5,4,0,"D"
"2005-04-23",2004,"Halifax Town","Woking","3-1",3,1,5,5,4,2,"H"
"2005-04-23",2004,"Hereford United","Accrington","0-0",0,0,5,5,0,0,"D"
"2005-04-23",2004,"Northwich Victoria","Crawley Town","1-0",1,0,5,5,1,1,"H"
"2005-04-23",2004,"Stevenage Borough","Leigh Genesis","2-0",2,0,5,5,2,2,"H"
"2005-04-23",2004,"Tamworth","Morecambe","0-0",0,0,5,5,0,0,"D"
"2005-04-23",2004,"York City","Farnborough Town","4-0",4,0,5,5,4,4,"H"
"2005-08-13",2005,"Accrington","Canvey Island","1-0",1,0,5,5,1,1,"H"
"2005-08-13",2005,"Aldershot","Tamworth","0-2",0,2,5,5,2,-2,"A"
"2005-08-13",2005,"Burton Albion","Grays Athletic","1-1",1,1,5,5,2,0,"D"
"2005-08-13",2005,"Dagenham and Redbridge","Southport","3-1",3,1,5,5,4,2,"H"
"2005-08-13",2005,"Ebbsfleet United","Exeter City","0-2",0,2,5,5,2,-2,"A"
"2005-08-13",2005,"Forest Green Rovers","Cambridge United","1-0",1,0,5,5,1,1,"H"
"2005-08-13",2005,"Hereford United","Scarborough","4-0",4,0,5,5,4,4,"H"
"2005-08-13",2005,"Kidderminster Harriers","Woking","2-1",2,1,5,5,3,1,"H"
"2005-08-13",2005,"Morecambe","Halifax Town","1-0",1,0,5,5,1,1,"H"
"2005-08-13",2005,"Stevenage Borough","Altrincham","3-0",3,0,5,5,3,3,"H"
"2005-08-13",2005,"York City","Crawley Town","0-0",0,0,5,5,0,0,"D"
"2005-08-16",2005,"Altrincham","Accrington","0-1",0,1,5,5,1,-1,"A"
"2005-08-16",2005,"Cambridge United","Hereford United","2-1",2,1,5,5,3,1,"H"
"2005-08-16",2005,"Canvey Island","Aldershot","2-1",2,1,5,5,3,1,"H"
"2005-08-16",2005,"Crawley Town","Dagenham and Redbridge","0-0",0,0,5,5,0,0,"D"
"2005-08-16",2005,"Exeter City","Kidderminster Harriers","1-0",1,0,5,5,1,1,"H"
"2005-08-16",2005,"Grays Athletic","Ebbsfleet United","6-1",6,1,5,5,7,5,"H"
"2005-08-16",2005,"Halifax Town","Burton Albion","1-0",1,0,5,5,1,1,"H"
"2005-08-16",2005,"Scarborough","Morecambe","0-1",0,1,5,5,1,-1,"A"
"2005-08-16",2005,"Southport","York City","1-4",1,4,5,5,5,-3,"A"
"2005-08-16",2005,"Tamworth","Forest Green Rovers","0-0",0,0,5,5,0,0,"D"
"2005-08-16",2005,"Woking","Stevenage Borough","3-2",3,2,5,5,5,1,"H"
"2005-08-20",2005,"Altrincham","Forest Green Rovers","2-1",2,1,5,5,3,1,"H"
"2005-08-20",2005,"Cambridge United","Accrington","3-1",3,1,5,5,4,2,"H"
"2005-08-20",2005,"Canvey Island","Ebbsfleet United","1-2",1,2,5,5,3,-1,"A"
"2005-08-20",2005,"Crawley Town","Hereford United","0-2",0,2,5,5,2,-2,"A"
"2005-08-20",2005,"Exeter City","Morecambe","2-0",2,0,5,5,2,2,"H"
"2005-08-20",2005,"Grays Athletic","York City","1-1",1,1,5,5,2,0,"D"
"2005-08-20",2005,"Halifax Town","Aldershot","1-1",1,1,5,5,2,0,"D"
"2005-08-20",2005,"Scarborough","Kidderminster Harriers","1-1",1,1,5,5,2,0,"D"
"2005-08-20",2005,"Southport","Stevenage Borough","3-2",3,2,5,5,5,1,"H"
"2005-08-20",2005,"Tamworth","Dagenham and Redbridge","2-2",2,2,5,5,4,0,"D"
"2005-08-20",2005,"Woking","Burton Albion","2-2",2,2,5,5,4,0,"D"
"2005-08-26",2005,"York City","Woking","2-1",2,1,5,5,3,1,"H"
"2005-08-27",2005,"Accrington","Exeter City","1-2",1,2,5,5,3,-1,"A"
"2005-08-27",2005,"Aldershot","Altrincham","0-2",0,2,5,5,2,-2,"A"
"2005-08-27",2005,"Burton Albion","Canvey Island","1-2",1,2,5,5,3,-1,"A"
"2005-08-27",2005,"Dagenham and Redbridge","Scarborough","0-2",0,2,5,5,2,-2,"A"
"2005-08-27",2005,"Ebbsfleet United","Cambridge United","0-0",0,0,5,5,0,0,"D"
"2005-08-27",2005,"Forest Green Rovers","Halifax Town","2-2",2,2,5,5,4,0,"D"
"2005-08-27",2005,"Hereford United","Grays Athletic","0-2",0,2,5,5,2,-2,"A"
"2005-08-27",2005,"Kidderminster Harriers","Southport","1-1",1,1,5,5,2,0,"D"
"2005-08-27",2005,"Morecambe","Crawley Town","3-0",3,0,5,5,3,3,"H"
"2005-08-27",2005,"Stevenage Borough","Tamworth","3-1",3,1,5,5,4,2,"H"
"2005-08-29",2005,"Altrincham","Morecambe","2-0",2,0,5,5,2,2,"H"
"2005-08-29",2005,"Cambridge United","Kidderminster Harriers","0-2",0,2,5,5,2,-2,"A"
"2005-08-29",2005,"Canvey Island","Dagenham and Redbridge","1-2",1,2,5,5,3,-1,"A"
"2005-08-29",2005,"Crawley Town","Stevenage Borough","1-2",1,2,5,5,3,-1,"A"
"2005-08-29",2005,"Exeter City","Forest Green Rovers","0-0",0,0,5,5,0,0,"D"
"2005-08-29",2005,"Grays Athletic","Aldershot","2-1",2,1,5,5,3,1,"H"
"2005-08-29",2005,"Halifax Town","York City","1-0",1,0,5,5,1,1,"H"
"2005-08-29",2005,"Scarborough","Accrington","2-2",2,2,5,5,4,0,"D"
"2005-08-29",2005,"Southport","Burton Albion","3-2",3,2,5,5,5,1,"H"
"2005-08-29",2005,"Tamworth","Hereford United","0-1",0,1,5,5,1,-1,"A"
"2005-08-29",2005,"Woking","Ebbsfleet United","1-3",1,3,5,5,4,-2,"A"
"2005-09-02",2005,"Forest Green Rovers","Grays Athletic","1-2",1,2,5,5,3,-1,"A"
"2005-09-02",2005,"Kidderminster Harriers","Canvey Island","3-2",3,2,5,5,5,1,"H"
"2005-09-02",2005,"York City","Cambridge United","1-0",1,0,5,5,1,1,"H"
"2005-09-03",2005,"Accrington","Woking","2-1",2,1,5,5,3,1,"H"
"2005-09-03",2005,"Burton Albion","Scarborough","2-1",2,1,5,5,3,1,"H"
"2005-09-03",2005,"Dagenham and Redbridge","Exeter City","2-2",2,2,5,5,4,0,"D"
"2005-09-03",2005,"Ebbsfleet United","Southport","2-1",2,1,5,5,3,1,"H"
"2005-09-03",2005,"Hereford United","Altrincham","0-0",0,0,5,5,0,0,"D"
"2005-09-03",2005,"Morecambe","Tamworth","0-0",0,0,5,5,0,0,"D"
"2005-09-03",2005,"Stevenage Borough","Halifax Town","1-0",1,0,5,5,1,1,"H"
"2005-09-05",2005,"Aldershot","Crawley Town","3-2",3,2,5,5,5,1,"H"
"2005-09-10",2005,"Altrincham","Dagenham and Redbridge","0-5",0,5,5,5,5,-5,"A"
"2005-09-10",2005,"Burton Albion","Accrington","0-2",0,2,5,5,2,-2,"A"
"2005-09-10",2005,"Crawley Town","Canvey Island","3-1",3,1,5,5,4,2,"H"
"2005-09-10",2005,"Exeter City","Cambridge United","4-0",4,0,5,5,4,4,"H"
"2005-09-10",2005,"Forest Green Rovers","York City","1-2",1,2,5,5,3,-1,"A"
"2005-09-10",2005,"Grays Athletic","Kidderminster Harriers","2-2",2,2,5,5,4,0,"D"
"2005-09-10",2005,"Halifax Town","Tamworth","4-0",4,0,5,5,4,4,"H"
"2005-09-10",2005,"Morecambe","Aldershot","5-2",5,2,5,5,7,3,"H"
"2005-09-10",2005,"Scarborough","Ebbsfleet United","3-1",3,1,5,5,4,2,"H"
"2005-09-10",2005,"Stevenage Borough","Hereford United","0-0",0,0,5,5,0,0,"D"
"2005-09-10",2005,"Woking","Southport","1-0",1,0,5,5,1,1,"H"
"2005-09-17",2005,"Accrington","Crawley Town","4-2",4,2,5,5,6,2,"H"
"2005-09-17",2005,"Aldershot","Stevenage Borough","2-2",2,2,5,5,4,0,"D"
"2005-09-17",2005,"Cambridge United","Woking","0-2",0,2,5,5,2,-2,"A"
"2005-09-17",2005,"Canvey Island","Scarborough","1-0",1,0,5,5,1,1,"H"
"2005-09-17",2005,"Dagenham and Redbridge","Burton Albion","3-1",3,1,5,5,4,2,"H"
"2005-09-17",2005,"Ebbsfleet United","Halifax Town","4-0",4,0,5,5,4,4,"H"
"2005-09-17",2005,"Hereford United","Morecambe","1-0",1,0,5,5,1,1,"H"
"2005-09-17",2005,"Kidderminster Harriers","Forest Green Rovers","1-3",1,3,5,5,4,-2,"A"
"2005-09-17",2005,"Southport","Exeter City","0-3",0,3,5,5,3,-3,"A"
"2005-09-17",2005,"Tamworth","Grays Athletic","2-2",2,2,5,5,4,0,"D"
"2005-09-17",2005,"York City","Altrincham","5-0",5,0,5,5,5,5,"H"
"2005-09-20",2005,"Accrington","Aldershot","3-2",3,2,5,5,5,1,"H"
"2005-09-20",2005,"Altrincham","Scarborough","1-1",1,1,5,5,2,0,"D"
"2005-09-20",2005,"Burton Albion","Morecambe","0-4",0,4,5,5,4,-4,"A"
"2005-09-20",2005,"Forest Green Rovers","Crawley Town","2-2",2,2,5,5,4,0,"D"
"2005-09-20",2005,"Grays Athletic","Cambridge United","5-3",5,3,5,5,8,2,"H"
"2005-09-20",2005,"Hereford United","Ebbsfleet United","1-1",1,1,5,5,2,0,"D"
"2005-09-20",2005,"Kidderminster Harriers","Halifax Town","0-1",0,1,5,5,1,-1,"A"
"2005-09-20",2005,"Southport","Tamworth","1-1",1,1,5,5,2,0,"D"
"2005-09-20",2005,"Stevenage Borough","Exeter City","2-0",2,0,5,5,2,2,"H"
"2005-09-20",2005,"Woking","Canvey Island","1-1",1,1,5,5,2,0,"D"
"2005-09-20",2005,"York City","Dagenham and Redbridge","1-1",1,1,5,5,2,0,"D"
"2005-09-24",2005,"Aldershot","York City","2-1",2,1,5,5,3,1,"H"
"2005-09-24",2005,"Cambridge United","Altrincham","4-0",4,0,5,5,4,4,"H"
"2005-09-24",2005,"Canvey Island","Southport","2-1",2,1,5,5,3,1,"H"
"2005-09-24",2005,"Crawley Town","Grays Athletic","1-3",1,3,5,5,4,-2,"A"
"2005-09-24",2005,"Dagenham and Redbridge","Accrington","1-2",1,2,5,5,3,-1,"A"
"2005-09-24",2005,"Ebbsfleet United","Kidderminster Harriers","1-2",1,2,5,5,3,-1,"A"
"2005-09-24",2005,"Exeter City","Burton Albion","1-2",1,2,5,5,3,-1,"A"
"2005-09-24",2005,"Halifax Town","Hereford United","2-1",2,1,5,5,3,1,"H"
"2005-09-24",2005,"Morecambe","Stevenage Borough","4-1",4,1,5,5,5,3,"H"
"2005-09-24",2005,"Scarborough","Forest Green Rovers","1-0",1,0,5,5,1,1,"H"
"2005-09-24",2005,"Tamworth","Woking","0-1",0,1,5,5,1,-1,"A"
"2005-09-27",2005,"Aldershot","Hereford United","0-1",0,1,5,5,1,-1,"A"
"2005-09-27",2005,"Cambridge United","Burton Albion","2-2",2,2,5,5,4,0,"D"
"2005-09-27",2005,"Canvey Island","Stevenage Borough","1-1",1,1,5,5,2,0,"D"
"2005-09-27",2005,"Crawley Town","Kidderminster Harriers","2-0",2,0,5,5,2,2,"H"
"2005-09-27",2005,"Dagenham and Redbridge","Grays Athletic","1-2",1,2,5,5,3,-1,"A"
"2005-09-27",2005,"Ebbsfleet United","Forest Green Rovers","2-0",2,0,5,5,2,2,"H"
"2005-09-27",2005,"Exeter City","Woking","1-1",1,1,5,5,2,0,"D"
"2005-09-27",2005,"Halifax Town","Altrincham","2-0",2,0,5,5,2,2,"H"
"2005-09-27",2005,"Morecambe","Accrington","3-2",3,2,5,5,5,1,"H"
"2005-09-27",2005,"Scarborough","Southport","0-1",0,1,5,5,1,-1,"A"
"2005-09-27",2005,"Tamworth","York City","0-3",0,3,5,5,3,-3,"A"
"2005-10-01",2005,"Accrington","Ebbsfleet United","1-1",1,1,5,5,2,0,"D"
"2005-10-01",2005,"Altrincham","Crawley Town","1-1",1,1,5,5,2,0,"D"
"2005-10-01",2005,"Forest Green Rovers","Morecambe","1-0",1,0,5,5,1,1,"H"
"2005-10-01",2005,"Grays Athletic","Halifax Town","1-1",1,1,5,5,2,0,"D"
"2005-10-01",2005,"Hereford United","Canvey Island","1-1",1,1,5,5,2,0,"D"
"2005-10-01",2005,"Kidderminster Harriers","Tamworth","0-1",0,1,5,5,1,-1,"A"
"2005-10-01",2005,"Southport","Cambridge United","2-2",2,2,5,5,4,0,"D"
"2005-10-01",2005,"Woking","Scarborough","4-0",4,0,5,5,4,4,"H"
"2005-10-01",2005,"York City","Exeter City","4-2",4,2,5,5,6,2,"H"
"2005-10-02",2005,"Burton Albion","Aldershot","1-2",1,2,5,5,3,-1,"A"
"2005-10-05",2005,"Stevenage Borough","Dagenham and Redbridge","2-1",2,1,5,5,3,1,"H"
"2005-10-07",2005,"Accrington","Hereford United","2-1",2,1,5,5,3,1,"H"
"2005-10-07",2005,"Cambridge United","Tamworth","2-1",2,1,5,5,3,1,"H"
"2005-10-07",2005,"Southport","Forest Green Rovers","3-1",3,1,5,5,4,2,"H"
"2005-10-08",2005,"Burton Albion","Stevenage Borough","3-1",3,1,5,5,4,2,"H"
"2005-10-08",2005,"Canvey Island","Altrincham","1-1",1,1,5,5,2,0,"D"
"2005-10-08",2005,"Ebbsfleet United","York City","2-2",2,2,5,5,4,0,"D"
"2005-10-08",2005,"Exeter City","Halifax Town","4-2",4,2,5,5,6,2,"H"
"2005-10-08",2005,"Kidderminster Harriers","Morecambe","1-0",1,0,5,5,1,1,"H"
"2005-10-08",2005,"Scarborough","Crawley Town","1-2",1,2,5,5,3,-1,"A"
"2005-10-08",2005,"Woking","Grays Athletic","1-1",1,1,5,5,2,0,"D"
"2005-10-09",2005,"Dagenham and Redbridge","Aldershot","2-0",2,0,5,5,2,2,"H"
"2005-10-15",2005,"Aldershot","Kidderminster Harriers","1-0",1,0,5,5,1,1,"H"
"2005-10-15",2005,"Altrincham","Southport","1-0",1,0,5,5,1,1,"H"
"2005-10-15",2005,"Crawley Town","Exeter City","0-2",0,2,5,5,2,-2,"A"
"2005-10-15",2005,"Forest Green Rovers","Woking","0-3",0,3,5,5,3,-3,"A"
"2005-10-15",2005,"Grays Athletic","Scarborough","5-0",5,0,5,5,5,5,"H"
"2005-10-15",2005,"Halifax Town","Cambridge United","1-0",1,0,5,5,1,1,"H"
"2005-10-15",2005,"Hereford United","Burton Albion","2-0",2,0,5,5,2,2,"H"
"2005-10-15",2005,"Morecambe","Dagenham and Redbridge","2-0",2,0,5,5,2,2,"H"
"2005-10-15",2005,"Stevenage Borough","Accrington","3-1",3,1,5,5,4,2,"H"
"2005-10-15",2005,"Tamworth","Ebbsfleet United","1-0",1,0,5,5,1,1,"H"
"2005-10-15",2005,"York City","Canvey Island","2-1",2,1,5,5,3,1,"H"
"2005-10-29",2005,"Accrington","York City","2-1",2,1,5,5,3,1,"H"
"2005-10-29",2005,"Cambridge United","Crawley Town","2-1",2,1,5,5,3,1,"H"
"2005-10-29",2005,"Canvey Island","Morecambe","3-3",3,3,5,5,6,0,"D"
"2005-10-29",2005,"Dagenham and Redbridge","Forest Green Rovers","1-1",1,1,5,5,2,0,"D"
"2005-10-29",2005,"Ebbsfleet United","Stevenage Borough","0-2",0,2,5,5,2,-2,"A"
"2005-10-29",2005,"Exeter City","Tamworth","3-0",3,0,5,5,3,3,"H"
"2005-10-29",2005,"Kidderminster Harriers","Hereford United","1-1",1,1,5,5,2,0,"D"
"2005-10-29",2005,"Scarborough","Aldershot","2-2",2,2,5,5,4,0,"D"
"2005-10-29",2005,"Southport","Grays Athletic","1-4",1,4,5,5,5,-3,"A"
"2005-10-29",2005,"Woking","Halifax Town","2-2",2,2,5,5,4,0,"D"
"2005-10-30",2005,"Burton Albion","Altrincham","1-0",1,0,5,5,1,1,"H"
"2005-11-05",2005,"Kidderminster Harriers","Exeter City","1-2",1,2,5,5,3,-1,"A"
"2005-11-12",2005,"Aldershot","Ebbsfleet United","3-2",3,2,5,5,5,1,"H"
"2005-11-12",2005,"Altrincham","Exeter City","1-1",1,1,5,5,2,0,"D"
"2005-11-12",2005,"Crawley Town","Southport","2-0",2,0,5,5,2,2,"H"
"2005-11-12",2005,"Forest Green Rovers","Canvey Island","1-2",1,2,5,5,3,-1,"A"
"2005-11-12",2005,"Grays Athletic","Accrington","1-2",1,2,5,5,3,-1,"A"
"2005-11-12",2005,"Halifax Town","Dagenham and Redbridge","3-0",3,0,5,5,3,3,"H"
"2005-11-12",2005,"Hereford United","Woking","4-0",4,0,5,5,4,4,"H"
"2005-11-12",2005,"Morecambe","Cambridge United","0-1",0,1,5,5,1,-1,"A"
"2005-11-12",2005,"Stevenage Borough","Kidderminster Harriers","3-1",3,1,5,5,4,2,"H"
"2005-11-12",2005,"Tamworth","Scarborough","0-1",0,1,5,5,1,-1,"A"
"2005-11-12",2005,"York City","Burton Albion","0-1",0,1,5,5,1,-1,"A"
"2005-11-18",2005,"Accrington","Forest Green Rovers","2-0",2,0,5,5,2,2,"H"
"2005-11-19",2005,"Burton Albion","Crawley Town","3-1",3,1,5,5,4,2,"H"
"2005-11-19",2005,"Cambridge United","Aldershot","0-2",0,2,5,5,2,-2,"A"
"2005-11-19",2005,"Canvey Island","Tamworth","1-2",1,2,5,5,3,-1,"A"
"2005-11-19",2005,"Dagenham and Redbridge","Hereford United","0-1",0,1,5,5,1,-1,"A"
"2005-11-19",2005,"Ebbsfleet United","Altrincham","2-0",2,0,5,5,2,2,"H"
"2005-11-19",2005,"Exeter City","Grays Athletic","1-2",1,2,5,5,3,-1,"A"
"2005-11-19",2005,"Kidderminster Harriers","York City","0-0",0,0,5,5,0,0,"D"
"2005-11-19",2005,"Scarborough","Stevenage Borough","1-1",1,1,5,5,2,0,"D"
"2005-11-19",2005,"Southport","Halifax Town","0-2",0,2,5,5,2,-2,"A"
"2005-11-19",2005,"Woking","Morecambe","0-1",0,1,5,5,1,-1,"A"
"2005-11-26",2005,"Accrington","Southport","4-0",4,0,5,5,4,4,"H"
"2005-11-26",2005,"Aldershot","Forest Green Rovers","2-1",2,1,5,5,3,1,"H"
"2005-11-26",2005,"Altrincham","Tamworth","2-0",2,0,5,5,2,2,"H"
"2005-11-26",2005,"Burton Albion","Kidderminster Harriers","1-0",1,0,5,5,1,1,"H"
"2005-11-26",2005,"Canvey Island","Cambridge United","1-1",1,1,5,5,2,0,"D"
"2005-11-26",2005,"Crawley Town","Ebbsfleet United","1-2",1,2,5,5,3,-1,"A"
"2005-11-26",2005,"Dagenham and Redbridge","Woking","1-3",1,3,5,5,4,-2,"A"
"2005-11-26",2005,"Hereford United","Exeter City","0-2",0,2,5,5,2,-2,"A"
"2005-11-26",2005,"Morecambe","York City","2-0",2,0,5,5,2,2,"H"
"2005-11-26",2005,"Scarborough","Halifax Town","2-0",2,0,5,5,2,2,"H"
"2005-11-26",2005,"Stevenage Borough","Grays Athletic","0-1",0,1,5,5,1,-1,"A"
"2005-12-03",2005,"Accrington","Altrincham","1-0",1,0,5,5,1,1,"H"
"2005-12-03",2005,"Cambridge United","Scarborough","2-1",2,1,5,5,3,1,"H"
"2005-12-03",2005,"Ebbsfleet United","Morecambe","1-0",1,0,5,5,1,1,"H"
"2005-12-03",2005,"Exeter City","Canvey Island","0-2",0,2,5,5,2,-2,"A"
"2005-12-03",2005,"Halifax Town","Crawley Town","2-2",2,2,5,5,4,0,"D"
"2005-12-03",2005,"Kidderminster Harriers","Dagenham and Redbridge","3-1",3,1,5,5,4,2,"H"
"2005-12-06",2005,"Grays Athletic","Altrincham","1-1",1,1,5,5,2,0,"D"
"2005-12-10",2005,"Accrington","Kidderminster Harriers","2-0",2,0,5,5,2,2,"H"
"2005-12-10",2005,"Aldershot","Southport","2-0",2,0,5,5,2,2,"H"
"2005-12-10",2005,"Altrincham","Woking","0-4",0,4,5,5,4,-4,"A"
"2005-12-10",2005,"Burton Albion","Ebbsfleet United","0-0",0,0,5,5,0,0,"D"
"2005-12-10",2005,"Canvey Island","Halifax Town","0-1",0,1,5,5,1,-1,"A"
"2005-12-10",2005,"Crawley Town","Tamworth","3-0",3,0,5,5,3,3,"H"
"2005-12-10",2005,"Dagenham and Redbridge","Cambridge United","1-0",1,0,5,5,1,1,"H"
"2005-12-10",2005,"Hereford United","York City","1-0",1,0,5,5,1,1,"H"
"2005-12-10",2005,"Morecambe","Grays Athletic","3-0",3,0,5,5,3,3,"H"
"2005-12-10",2005,"Scarborough","Exeter City","0-1",0,1,5,5,1,-1,"A"
"2005-12-10",2005,"Stevenage Borough","Forest Green Rovers","2-1",2,1,5,5,3,1,"H"
"2005-12-13",2005,"Forest Green Rovers","Burton Albion","1-0",1,0,5,5,1,1,"H"
"2005-12-26",2005,"Cambridge United","Stevenage Borough","1-0",1,0,5,5,1,1,"H"
"2005-12-26",2005,"Ebbsfleet United","Dagenham and Redbridge","1-3",1,3,5,5,4,-2,"A"
"2005-12-26",2005,"Exeter City","Aldershot","4-0",4,0,5,5,4,4,"H"
"2005-12-26",2005,"Forest Green Rovers","Hereford United","2-2",2,2,5,5,4,0,"D"
"2005-12-26",2005,"Halifax Town","Accrington","2-2",2,2,5,5,4,0,"D"
"2005-12-26",2005,"Kidderminster Harriers","Altrincham","1-1",1,1,5,5,2,0,"D"
"2005-12-26",2005,"Southport","Morecambe","0-3",0,3,5,5,3,-3,"A"
"2005-12-26",2005,"Tamworth","Burton Albion","1-1",1,1,5,5,2,0,"D"
"2005-12-26",2005,"Woking","Crawley Town","0-0",0,0,5,5,0,0,"D"
"2005-12-26",2005,"York City","Scarborough","3-1",3,1,5,5,4,2,"H"
"2005-12-27",2005,"Grays Athletic","Canvey Island","1-2",1,2,5,5,3,-1,"A"
"2005-12-30",2005,"Exeter City","Hereford United","1-2",1,2,5,5,3,-1,"A"
"2005-12-30",2005,"Halifax Town","Scarborough","1-0",1,0,5,5,1,1,"H"
"2005-12-30",2005,"Kidderminster Harriers","Burton Albion","0-1",0,1,5,5,1,-1,"A"
"2005-12-31",2005,"Cambridge United","Canvey Island","3-1",3,1,5,5,4,2,"H"
"2005-12-31",2005,"Forest Green Rovers","Aldershot","4-2",4,2,5,5,6,2,"H"
"2005-12-31",2005,"Grays Athletic","Stevenage Borough","2-2",2,2,5,5,4,0,"D"
"2005-12-31",2005,"Tamworth","Altrincham","1-1",1,1,5,5,2,0,"D"
"2005-12-31",2005,"Woking","Dagenham and Redbridge","0-0",0,0,5,5,0,0,"D"
"2005-12-31",2005,"York City","Morecambe","1-1",1,1,5,5,2,0,"D"
"2006-01-02",2005,"Accrington","Halifax Town","1-1",1,1,5,5,2,0,"D"
"2006-01-02",2005,"Aldershot","Exeter City","1-0",1,0,5,5,1,1,"H"
"2006-01-02",2005,"Altrincham","Kidderminster Harriers","3-0",3,0,5,5,3,3,"H"
"2006-01-02",2005,"Burton Albion","Tamworth","1-1",1,1,5,5,2,0,"D"
"2006-01-02",2005,"Canvey Island","Grays Athletic","2-1",2,1,5,5,3,1,"H"
"2006-01-02",2005,"Crawley Town","Woking","2-2",2,2,5,5,4,0,"D"
"2006-01-02",2005,"Dagenham and Redbridge","Ebbsfleet United","1-2",1,2,5,5,3,-1,"A"
"2006-01-02",2005,"Hereford United","Forest Green Rovers","1-1",1,1,5,5,2,0,"D"
"2006-01-02",2005,"Morecambe","Southport","0-0",0,0,5,5,0,0,"D"
"2006-01-02",2005,"Scarborough","York City","2-2",2,2,5,5,4,0,"D"
"2006-01-02",2005,"Stevenage Borough","Cambridge United","3-1",3,1,5,5,4,2,"H"
"2006-01-07",2005,"Altrincham","Stevenage Borough","1-1",1,1,5,5,2,0,"D"
"2006-01-07",2005,"Cambridge United","Forest Green Rovers","2-2",2,2,5,5,4,0,"D"
"2006-01-07",2005,"Canvey Island","Accrington","0-2",0,2,5,5,2,-2,"A"
"2006-01-07",2005,"Crawley Town","York City","0-1",0,1,5,5,1,-1,"A"
"2006-01-07",2005,"Exeter City","Ebbsfleet United","1-0",1,0,5,5,1,1,"H"
"2006-01-07",2005,"Scarborough","Hereford United","0-1",0,1,5,5,1,-1,"A"
"2006-01-07",2005,"Southport","Dagenham and Redbridge","1-2",1,2,5,5,3,-1,"A"
"2006-01-07",2005,"Woking","Kidderminster Harriers","0-1",0,1,5,5,1,-1,"A"
"2006-01-09",2005,"Halifax Town","Morecambe","0-0",0,0,5,5,0,0,"D"
"2006-01-10",2005,"Tamworth","Accrington","1-2",1,2,5,5,3,-1,"A"
"2006-01-10",2005,"York City","Stevenage Borough","0-1",0,1,5,5,1,-1,"A"
"2006-01-14",2005,"Southport","Scarborough","0-2",0,2,5,5,2,-2,"A"
"2006-01-20",2005,"Ebbsfleet United","Canvey Island","2-0",2,0,5,5,2,2,"H"
"2006-01-21",2005,"Accrington","Cambridge United","1-0",1,0,5,5,1,1,"H"
"2006-01-21",2005,"Aldershot","Halifax Town","3-1",3,1,5,5,4,2,"H"
"2006-01-21",2005,"Burton Albion","Woking","1-1",1,1,5,5,2,0,"D"
"2006-01-21",2005,"Dagenham and Redbridge","Tamworth","2-1",2,1,5,5,3,1,"H"
"2006-01-21",2005,"Forest Green Rovers","Altrincham","5-0",5,0,5,5,5,5,"H"
"2006-01-21",2005,"Hereford United","Crawley Town","2-1",2,1,5,5,3,1,"H"
"2006-01-21",2005,"Kidderminster Harriers","Scarborough","2-1",2,1,5,5,3,1,"H"
"2006-01-21",2005,"Morecambe","Exeter City","2-2",2,2,5,5,4,0,"D"
"2006-01-21",2005,"Stevenage Borough","Southport","0-1",0,1,5,5,1,-1,"A"
"2006-01-21",2005,"York City","Grays Athletic","1-2",1,2,5,5,3,-1,"A"
"2006-01-24",2005,"Aldershot","Canvey Island","2-2",2,2,5,5,4,0,"D"
"2006-01-24",2005,"Burton Albion","Halifax Town","1-2",1,2,5,5,3,-1,"A"
"2006-01-24",2005,"Forest Green Rovers","Tamworth","1-3",1,3,5,5,4,-2,"A"
"2006-01-24",2005,"Morecambe","Scarborough","0-3",0,3,5,5,3,-3,"A"
"2006-01-24",2005,"Stevenage Borough","Woking","1-1",1,1,5,5,2,0,"D"
"2006-01-24",2005,"York City","Southport","0-0",0,0,5,5,0,0,"D"
"2006-01-28",2005,"Altrincham","Aldershot","5-1",5,1,5,5,6,4,"H"
"2006-01-28",2005,"Cambridge United","Ebbsfleet United","1-1",1,1,5,5,2,0,"D"
"2006-01-28",2005,"Canvey Island","Burton Albion","0-2",0,2,5,5,2,-2,"A"
"2006-01-28",2005,"Crawley Town","Morecambe","1-3",1,3,5,5,4,-2,"A"
"2006-01-28",2005,"Grays Athletic","Hereford United","2-2",2,2,5,5,4,0,"D"
"2006-01-28",2005,"Halifax Town","Forest Green Rovers","1-0",1,0,5,5,1,1,"H"
"2006-01-28",2005,"Scarborough","Dagenham and Redbridge","0-1",0,1,5,5,1,-1,"A"
"2006-01-28",2005,"Southport","Kidderminster Harriers","1-4",1,4,5,5,5,-3,"A"
"2006-01-28",2005,"Tamworth","Stevenage Borough","2-0",2,0,5,5,2,2,"H"
"2006-01-28",2005,"Woking","York City","2-0",2,0,5,5,2,2,"H"
"2006-01-30",2005,"Exeter City","Accrington","1-3",1,3,5,5,4,-2,"A"
"2006-01-31",2005,"Grays Athletic","Burton Albion","2-3",2,3,5,5,5,-1,"A"
"2006-01-31",2005,"Hereford United","Cambridge United","3-0",3,0,5,5,3,3,"H"
"2006-02-04",2005,"Halifax Town","Kidderminster Harriers","0-0",0,0,5,5,0,0,"D"
"2006-02-04",2005,"Morecambe","Burton Albion","3-1",3,1,5,5,4,2,"H"
"2006-02-04",2005,"Scarborough","Altrincham","1-2",1,2,5,5,3,-1,"A"
"2006-02-04",2005,"Stevenage Borough","Aldershot","2-1",2,1,5,5,3,1,"H"
"2006-02-10",2005,"Burton Albion","Exeter City","2-0",2,0,5,5,2,2,"H"
"2006-02-11",2005,"Accrington","Dagenham and Redbridge","1-0",1,0,5,5,1,1,"H"
"2006-02-11",2005,"Altrincham","Cambridge United","2-1",2,1,5,5,3,1,"H"
"2006-02-11",2005,"Forest Green Rovers","Scarborough","5-1",5,1,5,5,6,4,"H"
"2006-02-11",2005,"Grays Athletic","Crawley Town","1-0",1,0,5,5,1,1,"H"
"2006-02-11",2005,"Hereford United","Halifax Town","1-0",1,0,5,5,1,1,"H"
"2006-02-11",2005,"Kidderminster Harriers","Ebbsfleet United","0-2",0,2,5,5,2,-2,"A"
"2006-02-11",2005,"Southport","Canvey Island","2-0",2,0,5,5,2,2,"H"
"2006-02-11",2005,"Stevenage Borough","Morecambe","1-0",1,0,5,5,1,1,"H"
"2006-02-11",2005,"Woking","Tamworth","5-0",5,0,5,5,5,5,"H"
"2006-02-12",2005,"York City","Aldershot","3-2",3,2,5,5,5,1,"H"
"2006-02-17",2005,"Ebbsfleet United","Accrington","1-3",1,3,5,5,4,-2,"A"
"2006-02-18",2005,"Aldershot","Burton Albion","1-1",1,1,5,5,2,0,"D"
"2006-02-18",2005,"Cambridge United","Southport","2-1",2,1,5,5,3,1,"H"
"2006-02-18",2005,"Canvey Island","Hereford United","1-1",1,1,5,5,2,0,"D"
"2006-02-18",2005,"Crawley Town","Altrincham","2-0",2,0,5,5,2,2,"H"
"2006-02-18",2005,"Dagenham and Redbridge","Stevenage Borough","2-2",2,2,5,5,4,0,"D"
"2006-02-18",2005,"Exeter City","York City","1-3",1,3,5,5,4,-2,"A"
"2006-02-18",2005,"Halifax Town","Grays Athletic","2-1",2,1,5,5,3,1,"H"
"2006-02-18",2005,"Morecambe","Forest Green Rovers","3-2",3,2,5,5,5,1,"H"
"2006-02-18",2005,"Scarborough","Woking","1-1",1,1,5,5,2,0,"D"
"2006-02-18",2005,"Tamworth","Kidderminster Harriers","1-1",1,1,5,5,2,0,"D"
"2006-02-20",2005,"Accrington","Morecambe","2-0",2,0,5,5,2,2,"H"
"2006-02-21",2005,"Altrincham","Halifax Town","1-2",1,2,5,5,3,-1,"A"
"2006-02-21",2005,"Burton Albion","Cambridge United","2-0",2,0,5,5,2,2,"H"
"2006-02-21",2005,"Forest Green Rovers","Ebbsfleet United","0-0",0,0,5,5,0,0,"D"
"2006-02-21",2005,"Grays Athletic","Dagenham and Redbridge","0-4",0,4,5,5,4,-4,"A"
"2006-02-21",2005,"Hereford United","Aldershot","2-1",2,1,5,5,3,1,"H"
"2006-02-21",2005,"Kidderminster Harriers","Crawley Town","1-0",1,0,5,5,1,1,"H"
"2006-02-21",2005,"Stevenage Borough","Canvey Island","3-0",3,0,5,5,3,3,"H"
"2006-02-21",2005,"Woking","Exeter City","1-0",1,0,5,5,1,1,"H"
"2006-02-21",2005,"York City","Tamworth","2-1",2,1,5,5,3,1,"H"
"2006-02-25",2005,"Accrington","Burton Albion","2-1",2,1,5,5,3,1,"H"
"2006-02-25",2005,"Aldershot","Morecambe","2-0",2,0,5,5,2,2,"H"
"2006-02-25",2005,"Canvey Island","Crawley Town","1-0",1,0,5,5,1,1,"H"
"2006-02-25",2005,"Ebbsfleet United","Scarborough","0-0",0,0,5,5,0,0,"D"
"2006-02-25",2005,"Tamworth","Halifax Town","1-2",1,2,5,5,3,-1,"A"
"2006-02-25",2005,"York City","Forest Green Rovers","5-1",5,1,5,5,6,4,"H"
"2006-02-27",2005,"Hereford United","Stevenage Borough","2-0",2,0,5,5,2,2,"H"
"2006-02-28",2005,"Ebbsfleet United","Crawley Town","1-1",1,1,5,5,2,0,"D"
"2006-03-04",2005,"Crawley Town","Accrington","0-1",0,1,5,5,1,-1,"A"
"2006-03-04",2005,"Exeter City","Southport","5-0",5,0,5,5,5,5,"H"
"2006-03-04",2005,"Forest Green Rovers","Kidderminster Harriers","0-0",0,0,5,5,0,0,"D"
"2006-03-04",2005,"Grays Athletic","Tamworth","5-0",5,0,5,5,5,5,"H"
"2006-03-04",2005,"Woking","Cambridge United","0-1",0,1,5,5,1,-1,"A"
"2006-03-07",2005,"Aldershot","Accrington","1-4",1,4,5,5,5,-3,"A"
"2006-03-07",2005,"Cambridge United","Grays Athletic","1-1",1,1,5,5,2,0,"D"
"2006-03-07",2005,"Dagenham and Redbridge","York City","0-2",0,2,5,5,2,-2,"A"
"2006-03-07",2005,"Ebbsfleet United","Hereford United","1-2",1,2,5,5,3,-1,"A"
"2006-03-11",2005,"Aldershot","Dagenham and Redbridge","3-1",3,1,5,5,4,2,"H"
"2006-03-11",2005,"Altrincham","Canvey Island","0-1",0,1,5,5,1,-1,"A"
"2006-03-11",2005,"Crawley Town","Scarborough","2-0",2,0,5,5,2,2,"H"
"2006-03-11",2005,"Forest Green Rovers","Southport","1-2",1,2,5,5,3,-1,"A"
"2006-03-11",2005,"Grays Athletic","Woking","2-2",2,2,5,5,4,0,"D"
"2006-03-11",2005,"Halifax Town","Exeter City","2-0",2,0,5,5,2,2,"H"
"2006-03-11",2005,"Hereford United","Accrington","2-2",2,2,5,5,4,0,"D"
"2006-03-11",2005,"Morecambe","Kidderminster Harriers","2-0",2,0,5,5,2,2,"H"
"2006-03-11",2005,"Stevenage Borough","Burton Albion","2-3",2,3,5,5,5,-1,"A"
"2006-03-11",2005,"Tamworth","Cambridge United","1-1",1,1,5,5,2,0,"D"
"2006-03-11",2005,"York City","Ebbsfleet United","1-0",1,0,5,5,1,1,"H"
"2006-03-14",2005,"Exeter City","Stevenage Borough","0-2",0,2,5,5,2,-2,"A"
"2006-03-14",2005,"Southport","Hereford United","1-2",1,2,5,5,3,-1,"A"
"2006-03-18",2005,"Accrington","Stevenage Borough","1-1",1,1,5,5,2,0,"D"
"2006-03-18",2005,"Burton Albion","Hereford United","0-1",0,1,5,5,1,-1,"A"
"2006-03-18",2005,"Cambridge United","Halifax Town","1-1",1,1,5,5,2,0,"D"
"2006-03-18",2005,"Canvey Island","York City","1-1",1,1,5,5,2,0,"D"
"2006-03-18",2005,"Crawley Town","Forest Green Rovers","1-0",1,0,5,5,1,1,"H"
"2006-03-18",2005,"Dagenham and Redbridge","Morecambe","3-1",3,1,5,5,4,2,"H"
"2006-03-18",2005,"Ebbsfleet United","Tamworth","2-0",2,0,5,5,2,2,"H"
"2006-03-18",2005,"Kidderminster Harriers","Aldershot","1-4",1,4,5,5,5,-3,"A"
"2006-03-18",2005,"Southport","Altrincham","1-1",1,1,5,5,2,0,"D"
"2006-03-21",2005,"Scarborough","Canvey Island","1-2",1,2,5,5,3,-1,"A"
"2006-03-21",2005,"Southport","Accrington","2-0",2,0,5,5,2,2,"H"
"2006-03-21",2005,"Woking","Aldershot","1-2",1,2,5,5,3,-1,"A"
"2006-03-25",2005,"Aldershot","Scarborough","0-1",0,1,5,5,1,-1,"A"
"2006-03-25",2005,"Altrincham","Burton Albion","1-2",1,2,5,5,3,-1,"A"
"2006-03-25",2005,"Crawley Town","Cambridge United","1-0",1,0,5,5,1,1,"H"
"2006-03-25",2005,"Forest Green Rovers","Dagenham and Redbridge","0-3",0,3,5,5,3,-3,"A"
"2006-03-25",2005,"Hereford United","Kidderminster Harriers","0-1",0,1,5,5,1,-1,"A"
"2006-03-25",2005,"Morecambe","Canvey Island","1-0",1,0,5,5,1,1,"H"
"2006-03-25",2005,"Stevenage Borough","Ebbsfleet United","2-0",2,0,5,5,2,2,"H"
"2006-03-25",2005,"Tamworth","Southport","0-0",0,0,5,5,0,0,"D"
"2006-03-25",2005,"York City","Accrington","2-4",2,4,5,5,6,-2,"A"
"2006-03-28",2005,"Dagenham and Redbridge","Crawley Town","0-3",0,3,5,5,3,-3,"A"
"2006-03-28",2005,"Halifax Town","Woking","1-0",1,0,5,5,1,1,"H"
"2006-03-28",2005,"Kidderminster Harriers","Grays Athletic","0-5",0,5,5,5,5,-5,"A"
"2006-03-28",2005,"Tamworth","Exeter City","1-1",1,1,5,5,2,0,"D"
"2006-04-01",2005,"Accrington","Grays Athletic","2-3",2,3,5,5,5,-1,"A"
"2006-04-01",2005,"Burton Albion","York City","0-0",0,0,5,5,0,0,"D"
"2006-04-01",2005,"Cambridge United","Morecambe","2-2",2,2,5,5,4,0,"D"
"2006-04-01",2005,"Canvey Island","Forest Green Rovers","1-1",1,1,5,5,2,0,"D"
"2006-04-01",2005,"Dagenham and Redbridge","Halifax Town","1-0",1,0,5,5,1,1,"H"
"2006-04-01",2005,"Ebbsfleet United","Aldershot","0-3",0,3,5,5,3,-3,"A"
"2006-04-01",2005,"Exeter City","Altrincham","3-1",3,1,5,5,4,2,"H"
"2006-04-01",2005,"Kidderminster Harriers","Stevenage Borough","0-0",0,0,5,5,0,0,"D"
"2006-04-01",2005,"Southport","Crawley Town","0-2",0,2,5,5,2,-2,"A"
"2006-04-01",2005,"Woking","Hereford United","1-1",1,1,5,5,2,0,"D"
"2006-04-04",2005,"Altrincham","York City","0-3",0,3,5,5,3,-3,"A"
"2006-04-04",2005,"Cambridge United","Exeter City","2-1",2,1,5,5,3,1,"H"
"2006-04-04",2005,"Canvey Island","Woking","0-2",0,2,5,5,2,-2,"A"
"2006-04-04",2005,"Ebbsfleet United","Grays Athletic","1-3",1,3,5,5,4,-2,"A"
"2006-04-04",2005,"Morecambe","Hereford United","2-2",2,2,5,5,4,0,"D"
"2006-04-04",2005,"Tamworth","Aldershot","2-1",2,1,5,5,3,1,"H"
"2006-04-07",2005,"Forest Green Rovers","Accrington","1-1",1,1,5,5,2,0,"D"
"2006-04-08",2005,"Aldershot","Cambridge United","1-3",1,3,5,5,4,-2,"A"
"2006-04-08",2005,"Altrincham","Ebbsfleet United","2-2",2,2,5,5,4,0,"D"
"2006-04-08",2005,"Crawley Town","Burton Albion","1-1",1,1,5,5,2,0,"D"
"2006-04-08",2005,"Halifax Town","Southport","2-1",2,1,5,5,3,1,"H"
"2006-04-08",2005,"Hereford United","Dagenham and Redbridge","1-1",1,1,5,5,2,0,"D"
"2006-04-08",2005,"Morecambe","Woking","3-1",3,1,5,5,4,2,"H"
"2006-04-08",2005,"Stevenage Borough","Scarborough","2-0",2,0,5,5,2,2,"H"
"2006-04-08",2005,"Tamworth","Canvey Island","1-0",1,0,5,5,1,1,"H"
"2006-04-09",2005,"York City","Kidderminster Harriers","2-2",2,2,5,5,4,0,"D"
"2006-04-10",2005,"Grays Athletic","Exeter City","3-0",3,0,5,5,3,3,"H"
"2006-04-10",2005,"Southport","Woking","1-0",1,0,5,5,1,1,"H"
"2006-04-11",2005,"Dagenham and Redbridge","Altrincham","2-4",2,4,5,5,6,-2,"A"
"2006-04-11",2005,"Scarborough","Tamworth","0-0",0,0,5,5,0,0,"D"
"2006-04-14",2005,"Cambridge United","York City","2-0",2,0,5,5,2,2,"H"
"2006-04-14",2005,"Canvey Island","Kidderminster Harriers","2-1",2,1,5,5,3,1,"H"
"2006-04-14",2005,"Halifax Town","Stevenage Borough","1-1",1,1,5,5,2,0,"D"
"2006-04-15",2005,"Altrincham","Hereford United","0-1",0,1,5,5,1,-1,"A"
"2006-04-15",2005,"Crawley Town","Aldershot","2-0",2,0,5,5,2,2,"H"
"2006-04-15",2005,"Exeter City","Dagenham and Redbridge","3-1",3,1,5,5,4,2,"H"
"2006-04-15",2005,"Grays Athletic","Forest Green Rovers","2-2",2,2,5,5,4,0,"D"
"2006-04-15",2005,"Scarborough","Burton Albion","3-0",3,0,5,5,3,3,"H"
"2006-04-15",2005,"Southport","Ebbsfleet United","1-0",1,0,5,5,1,1,"H"
"2006-04-15",2005,"Tamworth","Morecambe","0-3",0,3,5,5,3,-3,"A"
"2006-04-15",2005,"Woking","Accrington","0-1",0,1,5,5,1,-1,"A"
"2006-04-17",2005,"Accrington","Scarborough","1-0",1,0,5,5,1,1,"H"
"2006-04-17",2005,"Aldershot","Grays Athletic","0-3",0,3,5,5,3,-3,"A"
"2006-04-17",2005,"Dagenham and Redbridge","Canvey Island","2-2",2,2,5,5,4,0,"D"
"2006-04-17",2005,"Ebbsfleet United","Woking","2-0",2,0,5,5,2,2,"H"
"2006-04-17",2005,"Forest Green Rovers","Exeter City","0-0",0,0,5,5,0,0,"D"
"2006-04-17",2005,"Hereford United","Tamworth","1-0",1,0,5,5,1,1,"H"
"2006-04-17",2005,"Kidderminster Harriers","Cambridge United","1-0",1,0,5,5,1,1,"H"
"2006-04-17",2005,"Morecambe","Altrincham","2-0",2,0,5,5,2,2,"H"
"2006-04-17",2005,"Stevenage Borough","Crawley Town","2-1",2,1,5,5,3,1,"H"
"2006-04-17",2005,"York City","Halifax Town","0-2",0,2,5,5,2,-2,"A"
"2006-04-18",2005,"Burton Albion","Southport","0-0",0,0,5,5,0,0,"D"
"2006-04-19",2005,"Scarborough","Grays Athletic","2-7",2,7,5,5,9,-5,"A"
"2006-04-22",2005,"Accrington","Tamworth","2-1",2,1,5,5,3,1,"H"
"2006-04-22",2005,"Aldershot","Woking","1-1",1,1,5,5,2,0,"D"
"2006-04-22",2005,"Altrincham","Grays Athletic","0-2",0,2,5,5,2,-2,"A"
"2006-04-22",2005,"Burton Albion","Forest Green Rovers","1-0",1,0,5,5,1,1,"H"
"2006-04-22",2005,"Canvey Island","Exeter City","1-1",1,1,5,5,2,0,"D"
"2006-04-22",2005,"Crawley Town","Halifax Town","2-2",2,2,5,5,4,0,"D"
"2006-04-22",2005,"Dagenham and Redbridge","Kidderminster Harriers","3-0",3,0,5,5,3,3,"H"
"2006-04-22",2005,"Hereford United","Southport","1-1",1,1,5,5,2,0,"D"
"2006-04-22",2005,"Morecambe","Ebbsfleet United","3-0",3,0,5,5,3,3,"H"
"2006-04-22",2005,"Scarborough","Cambridge United","1-2",1,2,5,5,3,-1,"A"
"2006-04-22",2005,"Stevenage Borough","York City","1-1",1,1,5,5,2,0,"D"
"2006-04-25",2005,"Burton Albion","Dagenham and Redbridge","2-2",2,2,5,5,4,0,"D"
"2006-04-25",2005,"Exeter City","Crawley Town","4-0",4,0,5,5,4,4,"H"
"2006-04-25",2005,"Grays Athletic","Southport","1-1",1,1,5,5,2,0,"D"
"2006-04-25",2005,"Halifax Town","Ebbsfleet United","2-0",2,0,5,5,2,2,"H"
"2006-04-25",2005,"Woking","Forest Green Rovers","2-1",2,1,5,5,3,1,"H"
"2006-04-29",2005,"Cambridge United","Dagenham and Redbridge","1-2",1,2,5,5,3,-1,"A"
"2006-04-29",2005,"Ebbsfleet United","Burton Albion","0-1",0,1,5,5,1,-1,"A"
"2006-04-29",2005,"Exeter City","Scarborough","1-1",1,1,5,5,2,0,"D"
"2006-04-29",2005,"Forest Green Rovers","Stevenage Borough","2-0",2,0,5,5,2,2,"H"
"2006-04-29",2005,"Grays Athletic","Morecambe","1-2",1,2,5,5,3,-1,"A"
"2006-04-29",2005,"Halifax Town","Canvey Island","0-2",0,2,5,5,2,-2,"A"
"2006-04-29",2005,"Kidderminster Harriers","Accrington","2-0",2,0,5,5,2,2,"H"
"2006-04-29",2005,"Southport","Aldershot","0-1",0,1,5,5,1,-1,"A"
"2006-04-29",2005,"Tamworth","Crawley Town","0-0",0,0,5,5,0,0,"D"
"2006-04-29",2005,"Woking","Altrincham","3-1",3,1,5,5,4,2,"H"
"2006-04-29",2005,"York City","Hereford United","1-3",1,3,5,5,4,-2,"A"
"2006-08-12",2006,"Aldershot","Ebbsfleet United","3-2",3,2,5,5,5,1,"H"
"2006-08-12",2006,"Altrincham","Stevenage Borough","2-1",2,1,5,5,3,1,"H"
"2006-08-12",2006,"Cambridge United","Northwich Victoria","0-1",0,1,5,5,1,-1,"A"
"2006-08-12",2006,"Crawley Town","Rushden & Diamonds","1-0",1,0,5,5,1,1,"H"
"2006-08-12",2006,"Forest Green Rovers","Dagenham and Redbridge","0-1",0,1,5,5,1,-1,"A"
"2006-08-12",2006,"Grays Athletic","Stafford Rangers","1-1",1,1,5,5,2,0,"D"
"2006-08-12",2006,"Kidderminster Harriers","St Albans","1-3",1,3,5,5,4,-2,"A"
"2006-08-12",2006,"Morecambe","Burton Albion","0-1",0,1,5,5,1,-1,"A"
"2006-08-12",2006,"Oxford United","Halifax Town","2-0",2,0,5,5,2,2,"H"
"2006-08-12",2006,"Southport","Woking","0-0",0,0,5,5,0,0,"D"
"2006-08-12",2006,"Tamworth","Weymouth","1-3",1,3,5,5,4,-2,"A"
"2006-08-12",2006,"York City","Exeter City","0-0",0,0,5,5,0,0,"D"
"2006-08-15",2006,"Burton Albion","Kidderminster Harriers","1-1",1,1,5,5,2,0,"D"
"2006-08-15",2006,"Dagenham and Redbridge","Oxford United","0-1",0,1,5,5,1,-1,"A"
"2006-08-15",2006,"Ebbsfleet United","Tamworth","4-1",4,1,5,5,5,3,"H"
"2006-08-15",2006,"Exeter City","Forest Green Rovers","1-0",1,0,5,5,1,1,"H"
"2006-08-15",2006,"Halifax Town","Southport","1-1",1,1,5,5,2,0,"D"
"2006-08-15",2006,"Northwich Victoria","Morecambe","0-2",0,2,5,5,2,-2,"A"
"2006-08-15",2006,"Rushden & Diamonds","Grays Athletic","1-3",1,3,5,5,4,-2,"A"
"2006-08-15",2006,"St Albans","Cambridge United","0-0",0,0,5,5,0,0,"D"
"2006-08-15",2006,"Stafford Rangers","Altrincham","1-0",1,0,5,5,1,1,"H"
"2006-08-15",2006,"Stevenage Borough","York City","1-2",1,2,5,5,3,-1,"A"
"2006-08-15",2006,"Weymouth","Aldershot","1-0",1,0,5,5,1,1,"H"
"2006-08-15",2006,"Woking","Crawley Town","1-2",1,2,5,5,3,-1,"A"
"2006-08-18",2006,"Burton Albion","Oxford United","1-2",1,2,5,5,3,-1,"A"
"2006-08-19",2006,"Dagenham and Redbridge","Tamworth","4-0",4,0,5,5,4,4,"H"
"2006-08-19",2006,"Ebbsfleet United","York City","0-1",0,1,5,5,1,-1,"A"
"2006-08-19",2006,"Exeter City","Altrincham","2-1",2,1,5,5,3,1,"H"
"2006-08-19",2006,"Halifax Town","Grays Athletic","0-2",0,2,5,5,2,-2,"A"
"2006-08-19",2006,"Northwich Victoria","Kidderminster Harriers","0-1",0,1,5,5,1,-1,"A"
"2006-08-19",2006,"Rushden & Diamonds","Forest Green Rovers","2-0",2,0,5,5,2,2,"H"
"2006-08-19",2006,"St Albans","Aldershot","3-5",3,5,5,5,8,-2,"A"
"2006-08-19",2006,"Stafford Rangers","Southport","1-0",1,0,5,5,1,1,"H"
"2006-08-19",2006,"Stevenage Borough","Crawley Town","2-3",2,3,5,5,5,-1,"A"
"2006-08-19",2006,"Weymouth","Cambridge United","2-1",2,1,5,5,3,1,"H"
"2006-08-19",2006,"Woking","Morecambe","1-1",1,1,5,5,2,0,"D"
"2006-08-25",2006,"York City","Burton Albion","3-2",3,2,5,5,5,1,"H"
"2006-08-26",2006,"Aldershot","Dagenham and Redbridge","1-1",1,1,5,5,2,0,"D"
"2006-08-26",2006,"Altrincham","St Albans","2-0",2,0,5,5,2,2,"H"
"2006-08-26",2006,"Cambridge United","Halifax Town","1-2",1,2,5,5,3,-1,"A"
"2006-08-26",2006,"Crawley Town","Stafford Rangers","1-2",1,2,5,5,3,-1,"A"
"2006-08-26",2006,"Forest Green Rovers","Ebbsfleet United","0-1",0,1,5,5,1,-1,"A"
"2006-08-26",2006,"Grays Athletic","Woking","3-0",3,0,5,5,3,3,"H"
"2006-08-26",2006,"Kidderminster Harriers","Weymouth","0-1",0,1,5,5,1,-1,"A"
"2006-08-26",2006,"Morecambe","Stevenage Borough","3-3",3,3,5,5,6,0,"D"
"2006-08-26",2006,"Oxford United","Northwich Victoria","5-1",5,1,5,5,6,4,"H"
"2006-08-26",2006,"Southport","Rushden & Diamonds","1-2",1,2,5,5,3,-1,"A"
"2006-08-26",2006,"Tamworth","Exeter City","1-0",1,0,5,5,1,1,"H"
"2006-08-28",2006,"Burton Albion","Southport","0-1",0,1,5,5,1,-1,"A"
"2006-08-28",2006,"Dagenham and Redbridge","Cambridge United","2-0",2,0,5,5,2,2,"H"
"2006-08-28",2006,"Ebbsfleet United","Altrincham","3-1",3,1,5,5,4,2,"H"
"2006-08-28",2006,"Exeter City","Crawley Town","1-1",1,1,5,5,2,0,"D"
"2006-08-28",2006,"Halifax Town","Morecambe","1-1",1,1,5,5,2,0,"D"
"2006-08-28",2006,"Northwich Victoria","Grays Athletic","0-3",0,3,5,5,3,-3,"A"
"2006-08-28",2006,"Rushden & Diamonds","York City","0-1",0,1,5,5,1,-1,"A"
"2006-08-28",2006,"St Albans","Tamworth","1-0",1,0,5,5,1,1,"H"
"2006-08-28",2006,"Stafford Rangers","Aldershot","0-3",0,3,5,5,3,-3,"A"
"2006-08-28",2006,"Stevenage Borough","Forest Green Rovers","3-3",3,3,5,5,6,0,"D"
"2006-08-28",2006,"Weymouth","Oxford United","1-1",1,1,5,5,2,0,"D"
"2006-08-28",2006,"Woking","Kidderminster Harriers","3-0",3,0,5,5,3,3,"H"
"2006-09-01",2006,"Cambridge United","Exeter City","1-3",1,3,5,5,4,-2,"A"
"2006-09-01",2006,"Forest Green Rovers","Woking","2-3",2,3,5,5,5,-1,"A"
"2006-09-01",2006,"Grays Athletic","Burton Albion","0-1",0,1,5,5,1,-1,"A"
"2006-09-01",2006,"Kidderminster Harriers","Rushden & Diamonds","0-0",0,0,5,5,0,0,"D"
"2006-09-01",2006,"Oxford United","St Albans","2-1",2,1,5,5,3,1,"H"
"2006-09-01",2006,"York City","Stafford Rangers","0-0",0,0,5,5,0,0,"D"
"2006-09-02",2006,"Aldershot","Halifax Town","1-0",1,0,5,5,1,1,"H"
"2006-09-02",2006,"Crawley Town","Northwich Victoria","0-2",0,2,5,5,2,-2,"A"
"2006-09-02",2006,"Morecambe","Weymouth","2-0",2,0,5,5,2,2,"H"
"2006-09-02",2006,"Southport","Ebbsfleet United","2-2",2,2,5,5,4,0,"D"
"2006-09-02",2006,"Tamworth","Stevenage Borough","2-1",2,1,5,5,3,1,"H"
"2006-09-03",2006,"Altrincham","Dagenham and Redbridge","0-5",0,5,5,5,5,-5,"A"
"2006-09-09",2006,"Burton Albion","Weymouth","1-1",1,1,5,5,2,0,"D"
"2006-09-09",2006,"Crawley Town","York City","3-0",3,0,5,5,3,3,"H"
"2006-09-09",2006,"Exeter City","Aldershot","0-0",0,0,5,5,0,0,"D"
"2006-09-09",2006,"Forest Green Rovers","Cambridge United","1-1",1,1,5,5,2,0,"D"
"2006-09-09",2006,"Grays Athletic","Southport","4-0",4,0,5,5,4,4,"H"
"2006-09-09",2006,"Halifax Town","Ebbsfleet United","1-1",1,1,5,5,2,0,"D"
"2006-09-09",2006,"Kidderminster Harriers","Tamworth","0-2",0,2,5,5,2,-2,"A"
"2006-09-09",2006,"Morecambe","Oxford United","0-3",0,3,5,5,3,-3,"A"
"2006-09-09",2006,"Northwich Victoria","St Albans","0-3",0,3,5,5,3,-3,"A"
"2006-09-09",2006,"Rushden & Diamonds","Altrincham","3-0",3,0,5,5,3,3,"H"
"2006-09-09",2006,"Stevenage Borough","Stafford Rangers","6-0",6,0,5,5,6,6,"H"
"2006-09-09",2006,"Woking","Dagenham and Redbridge","2-2",2,2,5,5,4,0,"D"
"2006-09-12",2006,"Aldershot","Stevenage Borough","4-0",4,0,5,5,4,4,"H"
"2006-09-12",2006,"Altrincham","Halifax Town","1-0",1,0,5,5,1,1,"H"
"2006-09-12",2006,"Cambridge United","Kidderminster Harriers","1-1",1,1,5,5,2,0,"D"
"2006-09-12",2006,"Dagenham and Redbridge","Crawley Town","2-1",2,1,5,5,3,1,"H"
"2006-09-12",2006,"Ebbsfleet United","Grays Athletic","2-0",2,0,5,5,2,2,"H"
"2006-09-12",2006,"Oxford United","Exeter City","1-0",1,0,5,5,1,1,"H"
"2006-09-12",2006,"St Albans","Woking","0-1",0,1,5,5,1,-1,"A"
"2006-09-12",2006,"Stafford Rangers","Burton Albion","1-1",1,1,5,5,2,0,"D"
"2006-09-12",2006,"Tamworth","Rushden & Diamonds","1-4",1,4,5,5,5,-3,"A"
"2006-09-12",2006,"Weymouth","Forest Green Rovers","1-0",1,0,5,5,1,1,"H"
"2006-09-12",2006,"York City","Morecambe","2-3",2,3,5,5,5,-1,"A"
"2006-09-16",2006,"Aldershot","Northwich Victoria","1-3",1,3,5,5,4,-2,"A"
"2006-09-16",2006,"Altrincham","Woking","2-3",2,3,5,5,5,-1,"A"
"2006-09-16",2006,"Cambridge United","Stevenage Borough","1-0",1,0,5,5,1,1,"H"
"2006-09-16",2006,"Dagenham and Redbridge","Morecambe","2-1",2,1,5,5,3,1,"H"
"2006-09-16",2006,"Ebbsfleet United","Exeter City","2-2",2,2,5,5,4,0,"D"
"2006-09-16",2006,"Oxford United","Grays Athletic","1-1",1,1,5,5,2,0,"D"
"2006-09-16",2006,"Southport","Crawley Town","3-1",3,1,5,5,4,2,"H"
"2006-09-16",2006,"St Albans","Burton Albion","0-1",0,1,5,5,1,-1,"A"
"2006-09-16",2006,"Stafford Rangers","Rushden & Diamonds","1-1",1,1,5,5,2,0,"D"
"2006-09-16",2006,"Tamworth","Forest Green Rovers","1-1",1,1,5,5,2,0,"D"
"2006-09-16",2006,"Weymouth","Halifax Town","1-0",1,0,5,5,1,1,"H"
"2006-09-16",2006,"York City","Kidderminster Harriers","1-0",1,0,5,5,1,1,"H"
"2006-09-18",2006,"Crawley Town","Oxford United","0-1",0,1,5,5,1,-1,"A"
"2006-09-19",2006,"Burton Albion","Cambridge United","2-1",2,1,5,5,3,1,"H"
"2006-09-19",2006,"Exeter City","St Albans","4-2",4,2,5,5,6,2,"H"
"2006-09-19",2006,"Forest Green Rovers","Altrincham","2-2",2,2,5,5,4,0,"D"
"2006-09-19",2006,"Grays Athletic","Aldershot","1-2",1,2,5,5,3,-1,"A"
"2006-09-19",2006,"Halifax Town","Dagenham and Redbridge","3-1",3,1,5,5,4,2,"H"
"2006-09-19",2006,"Kidderminster Harriers","Southport","2-0",2,0,5,5,2,2,"H"
"2006-09-19",2006,"Morecambe","Tamworth","0-0",0,0,5,5,0,0,"D"
"2006-09-19",2006,"Northwich Victoria","Stafford Rangers","4-0",4,0,5,5,4,4,"H"
"2006-09-19",2006,"Rushden & Diamonds","Ebbsfleet United","0-0",0,0,5,5,0,0,"D"
"2006-09-19",2006,"Stevenage Borough","Weymouth","1-0",1,0,5,5,1,1,"H"
"2006-09-19",2006,"Woking","York City","1-2",1,2,5,5,3,-1,"A"
"2006-09-22",2006,"Cambridge United","Aldershot","2-0",2,0,5,5,2,2,"H"
"2006-09-23",2006,"Altrincham","Tamworth","2-0",2,0,5,5,2,2,"H"
"2006-09-23",2006,"Burton Albion","Northwich Victoria","2-0",2,0,5,5,2,2,"H"
"2006-09-23",2006,"Crawley Town","Grays Athletic","0-1",0,1,5,5,1,-1,"A"
"2006-09-23",2006,"Dagenham and Redbridge","Weymouth","4-1",4,1,5,5,5,3,"H"
"2006-09-23",2006,"Exeter City","Stevenage Borough","1-1",1,1,5,5,2,0,"D"
"2006-09-23",2006,"Halifax Town","Forest Green Rovers","2-2",2,2,5,5,4,0,"D"
"2006-09-23",2006,"Morecambe","Kidderminster Harriers","0-1",0,1,5,5,1,-1,"A"
"2006-09-23",2006,"St Albans","Ebbsfleet United","2-3",2,3,5,5,5,-1,"A"
"2006-09-23",2006,"Stafford Rangers","Oxford United","0-1",0,1,5,5,1,-1,"A"
"2006-09-23",2006,"Woking","Rushden & Diamonds","3-0",3,0,5,5,3,3,"H"
"2006-09-23",2006,"York City","Southport","2-2",2,2,5,5,4,0,"D"
"2006-09-26",2006,"Southport","Northwich Victoria","1-2",1,2,5,5,3,-1,"A"
"2006-09-30",2006,"Aldershot","Altrincham","0-0",0,0,5,5,0,0,"D"
"2006-09-30",2006,"Ebbsfleet United","Dagenham and Redbridge","0-0",0,0,5,5,0,0,"D"
"2006-09-30",2006,"Forest Green Rovers","Stafford Rangers","2-1",2,1,5,5,3,1,"H"
"2006-09-30",2006,"Grays Athletic","Morecambe","0-1",0,1,5,5,1,-1,"A"
"2006-09-30",2006,"Kidderminster Harriers","Crawley Town","0-1",0,1,5,5,1,-1,"A"
"2006-09-30",2006,"Northwich Victoria","Woking","0-2",0,2,5,5,2,-2,"A"
"2006-09-30",2006,"Oxford United","York City","2-0",2,0,5,5,2,2,"H"
"2006-09-30",2006,"Rushden & Diamonds","Burton Albion","1-2",1,2,5,5,3,-1,"A"
"2006-09-30",2006,"Southport","Exeter City","0-1",0,1,5,5,1,-1,"A"
"2006-09-30",2006,"Stevenage Borough","Halifax Town","2-1",2,1,5,5,3,1,"H"
"2006-09-30",2006,"Tamworth","Cambridge United","0-1",0,1,5,5,1,-1,"A"
"2006-09-30",2006,"Weymouth","St Albans","2-1",2,1,5,5,3,1,"H"
"2006-10-03",2006,"Aldershot","Tamworth","3-3",3,3,5,5,6,0,"D"
"2006-10-03",2006,"Burton Albion","Crawley Town","2-1",2,1,5,5,3,1,"H"
"2006-10-03",2006,"Cambridge United","Altrincham","2-2",2,2,5,5,4,0,"D"
"2006-10-03",2006,"Grays Athletic","Exeter City","2-2",2,2,5,5,4,0,"D"
"2006-10-03",2006,"Halifax Town","Kidderminster Harriers","2-0",2,0,5,5,2,2,"H"
"2006-10-03",2006,"Morecambe","Rushden & Diamonds","1-0",1,0,5,5,1,1,"H"
"2006-10-03",2006,"Northwich Victoria","York City","1-2",1,2,5,5,3,-1,"A"
"2006-10-03",2006,"Oxford United","Southport","2-2",2,2,5,5,4,0,"D"
"2006-10-03",2006,"St Albans","Forest Green Rovers","0-0",0,0,5,5,0,0,"D"
"2006-10-03",2006,"Stafford Rangers","Dagenham and Redbridge","1-2",1,2,5,5,3,-1,"A"
"2006-10-03",2006,"Stevenage Borough","Woking","3-2",3,2,5,5,5,1,"H"
"2006-10-04",2006,"Weymouth","Ebbsfleet United","2-1",2,1,5,5,3,1,"H"
"2006-10-06",2006,"Forest Green Rovers","Oxford United","1-5",1,5,5,5,6,-4,"A"
"2006-10-06",2006,"Rushden & Diamonds","Stevenage Borough","2-2",2,2,5,5,4,0,"D"
"2006-10-06",2006,"Woking","Burton Albion","0-0",0,0,5,5,0,0,"D"
"2006-10-06",2006,"York City","Aldershot","1-0",1,0,5,5,1,1,"H"
"2006-10-07",2006,"Altrincham","Weymouth","0-0",0,0,5,5,0,0,"D"
"2006-10-07",2006,"Crawley Town","Morecambe","4-0",4,0,5,5,4,4,"H"
"2006-10-07",2006,"Dagenham and Redbridge","Northwich Victoria","5-0",5,0,5,5,5,5,"H"
"2006-10-07",2006,"Ebbsfleet United","Cambridge United","2-0",2,0,5,5,2,2,"H"
"2006-10-07",2006,"Exeter City","Halifax Town","4-1",4,1,5,5,5,3,"H"
"2006-10-07",2006,"Kidderminster Harriers","Grays Athletic","2-1",2,1,5,5,3,1,"H"
"2006-10-07",2006,"Southport","St Albans","1-1",1,1,5,5,2,0,"D"
"2006-10-08",2006,"Tamworth","Stafford Rangers","0-0",0,0,5,5,0,0,"D"
"2006-10-09",2006,"Woking","Aldershot","2-0",2,0,5,5,2,2,"H"
"2006-10-10",2006,"Altrincham","Morecambe","0-2",0,2,5,5,2,-2,"A"
"2006-10-10",2006,"Crawley Town","Weymouth","0-3",0,3,5,5,3,-3,"A"
"2006-10-10",2006,"Dagenham and Redbridge","St Albans","4-2",4,2,5,5,6,2,"H"
"2006-10-10",2006,"Ebbsfleet United","Stafford Rangers","1-4",1,4,5,5,5,-3,"A"
"2006-10-10",2006,"Exeter City","Northwich Victoria","1-1",1,1,5,5,2,0,"D"
"2006-10-10",2006,"Forest Green Rovers","Burton Albion","1-0",1,0,5,5,1,1,"H"
"2006-10-10",2006,"Kidderminster Harriers","Oxford United","0-0",0,0,5,5,0,0,"D"
"2006-10-10",2006,"Rushden & Diamonds","Halifax Town","0-1",0,1,5,5,1,-1,"A"
"2006-10-10",2006,"Southport","Stevenage Borough","1-2",1,2,5,5,3,-1,"A"
"2006-10-10",2006,"Tamworth","Grays Athletic","4-2",4,2,5,5,6,2,"H"
"2006-10-10",2006,"York City","Cambridge United","1-2",1,2,5,5,3,-1,"A"
"2006-10-14",2006,"Aldershot","Kidderminster Harriers","4-2",4,2,5,5,6,2,"H"
"2006-10-14",2006,"Burton Albion","Ebbsfleet United","0-1",0,1,5,5,1,-1,"A"
"2006-10-14",2006,"Cambridge United","Crawley Town","1-2",1,2,5,5,3,-1,"A"
"2006-10-14",2006,"Grays Athletic","Forest Green Rovers","1-1",1,1,5,5,2,0,"D"
"2006-10-14",2006,"Halifax Town","Tamworth","3-1",3,1,5,5,4,2,"H"
"2006-10-14",2006,"Morecambe","Exeter City","2-2",2,2,5,5,4,0,"D"
"2006-10-14",2006,"Northwich Victoria","Rushden & Diamonds","4-1",4,1,5,5,5,3,"H"
"2006-10-14",2006,"Oxford United","Altrincham","1-1",1,1,5,5,2,0,"D"
"2006-10-14",2006,"St Albans","York City","4-2",4,2,5,5,6,2,"H"
"2006-10-14",2006,"Stafford Rangers","Woking","1-0",1,0,5,5,1,1,"H"
"2006-10-14",2006,"Stevenage Borough","Dagenham and Redbridge","1-2",1,2,5,5,3,-1,"A"
"2006-10-14",2006,"Weymouth","Southport","3-0",3,0,5,5,3,3,"H"
"2006-10-20",2006,"Cambridge United","Oxford United","0-3",0,3,5,5,3,-3,"A"
"2006-10-21",2006,"Aldershot","Morecambe","0-1",0,1,5,5,1,-1,"A"
"2006-10-21",2006,"Altrincham","Southport","2-1",2,1,5,5,3,1,"H"
"2006-10-21",2006,"Dagenham and Redbridge","Kidderminster Harriers","1-3",1,3,5,5,4,-2,"A"
"2006-10-21",2006,"Ebbsfleet United","Woking","1-0",1,0,5,5,1,1,"H"
"2006-10-21",2006,"Exeter City","Stafford Rangers","1-2",1,2,5,5,3,-1,"A"
"2006-10-21",2006,"Forest Green Rovers","Crawley Town","1-0",1,0,5,5,1,1,"H"
"2006-10-21",2006,"Halifax Town","Burton Albion","1-2",1,2,5,5,3,-1,"A"
"2006-10-21",2006,"St Albans","Grays Athletic","0-6",0,6,5,5,6,-6,"A"
"2006-10-21",2006,"Stevenage Borough","Northwich Victoria","0-2",0,2,5,5,2,-2,"A"
"2006-10-21",2006,"Tamworth","York City","2-2",2,2,5,5,4,0,"D"
"2006-10-21",2006,"Weymouth","Rushden & Diamonds","1-1",1,1,5,5,2,0,"D"
"2006-11-03",2006,"Burton Albion","Stevenage Borough","2-1",2,1,5,5,3,1,"H"
"2006-11-04",2006,"Crawley Town","St Albans","2-1",2,1,5,5,3,1,"H"
"2006-11-04",2006,"Grays Athletic","Cambridge United","1-1",1,1,5,5,2,0,"D"
"2006-11-04",2006,"Kidderminster Harriers","Forest Green Rovers","2-2",2,2,5,5,4,0,"D"
"2006-11-04",2006,"Morecambe","Ebbsfleet United","1-0",1,0,5,5,1,1,"H"
"2006-11-04",2006,"Northwich Victoria","Halifax Town","3-2",3,2,5,5,5,1,"H"
"2006-11-04",2006,"Oxford United","Aldershot","2-0",2,0,5,5,2,2,"H"
"2006-11-04",2006,"Rushden & Diamonds","Dagenham and Redbridge","2-3",2,3,5,5,5,-1,"A"
"2006-11-04",2006,"Southport","Tamworth","1-0",1,0,5,5,1,1,"H"
"2006-11-04",2006,"Stafford Rangers","Weymouth","2-0",2,0,5,5,2,2,"H"
"2006-11-04",2006,"Woking","Exeter City","0-2",0,2,5,5,2,-2,"A"
"2006-11-05",2006,"York City","Altrincham","1-0",1,0,5,5,1,1,"H"
"2006-11-11",2006,"Cambridge United","Ebbsfleet United","3-0",3,0,5,5,3,3,"H"
"2006-11-11",2006,"Forest Green Rovers","St Albans","2-2",2,2,5,5,4,0,"D"
"2006-11-18",2006,"Aldershot","Southport","2-2",2,2,5,5,4,0,"D"
"2006-11-18",2006,"Altrincham","Crawley Town","1-1",1,1,5,5,2,0,"D"
"2006-11-18",2006,"Cambridge United","Morecambe","1-3",1,3,5,5,4,-2,"A"
"2006-11-18",2006,"Dagenham and Redbridge","Burton Albion","3-0",3,0,5,5,3,3,"H"
"2006-11-18",2006,"Ebbsfleet United","Oxford United","1-0",1,0,5,5,1,1,"H"
"2006-11-18",2006,"Exeter City","Kidderminster Harriers","1-1",1,1,5,5,2,0,"D"
"2006-11-18",2006,"Forest Green Rovers","Northwich Victoria","2-1",2,1,5,5,3,1,"H"
"2006-11-18",2006,"Halifax Town","Stafford Rangers","3-1",3,1,5,5,4,2,"H"
"2006-11-18",2006,"St Albans","Rushden & Diamonds","3-2",3,2,5,5,5,1,"H"
"2006-11-18",2006,"Stevenage Borough","Grays Athletic","1-0",1,0,5,5,1,1,"H"
"2006-11-18",2006,"Tamworth","Woking","3-1",3,1,5,5,4,2,"H"
"2006-11-18",2006,"Weymouth","York City","1-2",1,2,5,5,3,-1,"A"
"2006-11-25",2006,"Crawley Town","Halifax Town","2-0",2,0,5,5,2,2,"H"
"2006-11-25",2006,"Grays Athletic","Altrincham","1-1",1,1,5,5,2,0,"D"
"2006-11-25",2006,"Kidderminster Harriers","Stevenage Borough","1-2",1,2,5,5,3,-1,"A"
"2006-11-25",2006,"Morecambe","Forest Green Rovers","1-1",1,1,5,5,2,0,"D"
"2006-11-25",2006,"Northwich Victoria","Ebbsfleet United","1-2",1,2,5,5,3,-1,"A"
"2006-11-25",2006,"Oxford United","Tamworth","2-1",2,1,5,5,3,1,"H"
"2006-11-25",2006,"Rushden & Diamonds","Aldershot","0-1",0,1,5,5,1,-1,"A"
"2006-11-25",2006,"Southport","Cambridge United","1-2",1,2,5,5,3,-1,"A"
"2006-11-25",2006,"Stafford Rangers","St Albans","2-2",2,2,5,5,4,0,"D"
"2006-11-25",2006,"Woking","Weymouth","4-0",4,0,5,5,4,4,"H"
"2006-11-25",2006,"York City","Dagenham and Redbridge","2-3",2,3,5,5,5,-1,"A"
"2006-11-27",2006,"Burton Albion","Exeter City","1-0",1,0,5,5,1,1,"H"
"2006-12-02",2006,"Altrincham","Burton Albion","2-3",2,3,5,5,5,-1,"A"
"2006-12-02",2006,"Cambridge United","St Albans","0-2",0,2,5,5,2,-2,"A"
"2006-12-02",2006,"Dagenham and Redbridge","Southport","0-0",0,0,5,5,0,0,"D"
"2006-12-02",2006,"Ebbsfleet United","Kidderminster Harriers","1-3",1,3,5,5,4,-2,"A"
"2006-12-02",2006,"Forest Green Rovers","York City","0-1",0,1,5,5,1,-1,"A"
"2006-12-02",2006,"Halifax Town","Woking","3-0",3,0,5,5,3,3,"H"
"2006-12-02",2006,"Stevenage Borough","Oxford United","2-2",2,2,5,5,4,0,"D"
"2006-12-02",2006,"Weymouth","Grays Athletic","3-2",3,2,5,5,5,1,"H"
"2006-12-09",2006,"Burton Albion","Aldershot","1-3",1,3,5,5,4,-2,"A"
"2006-12-09",2006,"Crawley Town","Tamworth","1-0",1,0,5,5,1,1,"H"
"2006-12-09",2006,"Exeter City","Dagenham and Redbridge","3-2",3,2,5,5,5,1,"H"
"2006-12-09",2006,"Forest Green Rovers","Southport","1-2",1,2,5,5,3,-1,"A"
"2006-12-09",2006,"Grays Athletic","York City","0-0",0,0,5,5,0,0,"D"
"2006-12-09",2006,"Halifax Town","St Albans","4-1",4,1,5,5,5,3,"H"
"2006-12-09",2006,"Kidderminster Harriers","Altrincham","3-2",3,2,5,5,5,1,"H"
"2006-12-09",2006,"Morecambe","Stafford Rangers","1-0",1,0,5,5,1,1,"H"
"2006-12-09",2006,"Northwich Victoria","Weymouth","0-1",0,1,5,5,1,-1,"A"
"2006-12-09",2006,"Rushden & Diamonds","Oxford United","1-0",1,0,5,5,1,1,"H"
"2006-12-09",2006,"Stevenage Borough","Ebbsfleet United","3-0",3,0,5,5,3,3,"H"
"2006-12-09",2006,"Woking","Cambridge United","0-1",0,1,5,5,1,-1,"A"
"2006-12-23",2006,"York City","Halifax Town","2-0",2,0,5,5,2,2,"H"
"2006-12-26",2006,"Aldershot","Forest Green Rovers","2-1",2,1,5,5,3,1,"H"
"2006-12-26",2006,"Altrincham","Northwich Victoria","3-0",3,0,5,5,3,3,"H"
"2006-12-26",2006,"Cambridge United","Rushden & Diamonds","0-1",0,1,5,5,1,-1,"A"
"2006-12-26",2006,"Dagenham and Redbridge","Grays Athletic","0-0",0,0,5,5,0,0,"D"
"2006-12-26",2006,"Ebbsfleet United","Crawley Town","1-0",1,0,5,5,1,1,"H"
"2006-12-26",2006,"Oxford United","Woking","0-0",0,0,5,5,0,0,"D"
"2006-12-26",2006,"Southport","Morecambe","1-2",1,2,5,5,3,-1,"A"
"2006-12-26",2006,"St Albans","Stevenage Borough","2-3",2,3,5,5,5,-1,"A"
"2006-12-26",2006,"Stafford Rangers","Kidderminster Harriers","1-2",1,2,5,5,3,-1,"A"
"2006-12-26",2006,"Tamworth","Burton Albion","0-1",0,1,5,5,1,-1,"A"
"2006-12-26",2006,"Weymouth","Exeter City","2-1",2,1,5,5,3,1,"H"
"2006-12-29",2006,"York City","Woking","0-1",0,1,5,5,1,-1,"A"
"2006-12-30",2006,"Altrincham","Forest Green Rovers","2-2",2,2,5,5,4,0,"D"
"2006-12-30",2006,"Cambridge United","Burton Albion","1-2",1,2,5,5,3,-1,"A"
"2006-12-30",2006,"Dagenham and Redbridge","Halifax Town","1-0",1,0,5,5,1,1,"H"
"2006-12-30",2006,"Ebbsfleet United","Rushden & Diamonds","1-0",1,0,5,5,1,1,"H"
"2006-12-30",2006,"Oxford United","Crawley Town","1-1",1,1,5,5,2,0,"D"
"2006-12-30",2006,"Southport","Kidderminster Harriers","0-1",0,1,5,5,1,-1,"A"
"2006-12-30",2006,"St Albans","Exeter City","1-2",1,2,5,5,3,-1,"A"
"2006-12-30",2006,"Tamworth","Morecambe","0-1",0,1,5,5,1,-1,"A"
"2006-12-30",2006,"Weymouth","Stevenage Borough","0-1",0,1,5,5,1,-1,"A"
"2007-01-01",2006,"Burton Albion","Stafford Rangers","0-0",0,0,5,5,0,0,"D"
"2007-01-01",2006,"Crawley Town","Dagenham and Redbridge","0-0",0,0,5,5,0,0,"D"
"2007-01-01",2006,"Exeter City","Oxford United","2-1",2,1,5,5,3,1,"H"
"2007-01-01",2006,"Forest Green Rovers","Weymouth","3-2",3,2,5,5,5,1,"H"
"2007-01-01",2006,"Halifax Town","Altrincham","1-1",1,1,5,5,2,0,"D"
"2007-01-01",2006,"Kidderminster Harriers","Cambridge United","1-0",1,0,5,5,1,1,"H"
"2007-01-01",2006,"Morecambe","York City","1-3",1,3,5,5,4,-2,"A"
"2007-01-01",2006,"Northwich Victoria","Southport","3-1",3,1,5,5,4,2,"H"
"2007-01-01",2006,"Rushden & Diamonds","Tamworth","1-1",1,1,5,5,2,0,"D"
"2007-01-01",2006,"Stevenage Borough","Aldershot","3-2",3,2,5,5,5,1,"H"
"2007-01-01",2006,"Woking","St Albans","1-2",1,2,5,5,3,-1,"A"
"2007-01-03",2006,"Grays Athletic","Ebbsfleet United","0-2",0,2,5,5,2,-2,"A"
"2007-01-06",2006,"Altrincham","Rushden & Diamonds","2-1",2,1,5,5,3,1,"H"
"2007-01-06",2006,"Dagenham and Redbridge","Woking","3-2",3,2,5,5,5,1,"H"
"2007-01-06",2006,"Oxford United","Morecambe","0-0",0,0,5,5,0,0,"D"
"2007-01-06",2006,"Southport","Grays Athletic","3-1",3,1,5,5,4,2,"H"
"2007-01-06",2006,"St Albans","Northwich Victoria","1-3",1,3,5,5,4,-2,"A"
"2007-01-06",2006,"York City","Crawley Town","5-0",5,0,5,5,5,5,"H"
"2007-01-13",2006,"Aldershot","Crawley Town","0-2",0,2,5,5,2,-2,"A"
"2007-01-13",2006,"Cambridge United","Stafford Rangers","0-1",0,1,5,5,1,-1,"A"
"2007-01-20",2006,"Burton Albion","St Albans","1-0",1,0,5,5,1,1,"H"
"2007-01-20",2006,"Crawley Town","Southport","2-1",2,1,5,5,3,1,"H"
"2007-01-20",2006,"Exeter City","Ebbsfleet United","1-3",1,3,5,5,4,-2,"A"
"2007-01-20",2006,"Forest Green Rovers","Tamworth","2-0",2,0,5,5,2,2,"H"
"2007-01-20",2006,"Grays Athletic","Oxford United","2-2",2,2,5,5,4,0,"D"
"2007-01-20",2006,"Kidderminster Harriers","York City","2-1",2,1,5,5,3,1,"H"
"2007-01-20",2006,"Morecambe","Dagenham and Redbridge","1-1",1,1,5,5,2,0,"D"
"2007-01-20",2006,"Northwich Victoria","Aldershot","1-3",1,3,5,5,4,-2,"A"
"2007-01-20",2006,"Rushden & Diamonds","Stafford Rangers","2-1",2,1,5,5,3,1,"H"
"2007-01-20",2006,"Stevenage Borough","Cambridge United","4-1",4,1,5,5,5,3,"H"
"2007-01-20",2006,"Woking","Altrincham","2-0",2,0,5,5,2,2,"H"
"2007-01-23",2006,"Crawley Town","Ebbsfleet United","1-1",1,1,5,5,2,0,"D"
"2007-01-23",2006,"Exeter City","Weymouth","4-0",4,0,5,5,4,4,"H"
"2007-01-23",2006,"Forest Green Rovers","Aldershot","3-0",3,0,5,5,3,3,"H"
"2007-01-23",2006,"Grays Athletic","Dagenham and Redbridge","0-1",0,1,5,5,1,-1,"A"
"2007-01-23",2006,"Halifax Town","York City","1-1",1,1,5,5,2,0,"D"
"2007-01-23",2006,"Kidderminster Harriers","Stafford Rangers","2-0",2,0,5,5,2,2,"H"
"2007-01-23",2006,"Morecambe","Southport","0-0",0,0,5,5,0,0,"D"
"2007-01-23",2006,"Rushden & Diamonds","Cambridge United","3-1",3,1,5,5,4,2,"H"
"2007-01-23",2006,"Stevenage Borough","St Albans","1-2",1,2,5,5,3,-1,"A"
"2007-01-23",2006,"Woking","Oxford United","1-0",1,0,5,5,1,1,"H"
"2007-01-27",2006,"Aldershot","Burton Albion","3-2",3,2,5,5,5,1,"H"
"2007-01-27",2006,"Altrincham","Kidderminster Harriers","0-1",0,1,5,5,1,-1,"A"
"2007-01-27",2006,"Cambridge United","Woking","3-0",3,0,5,5,3,3,"H"
"2007-01-27",2006,"Dagenham and Redbridge","Exeter City","4-1",4,1,5,5,5,3,"H"
"2007-01-27",2006,"Ebbsfleet United","Stevenage Borough","1-1",1,1,5,5,2,0,"D"
"2007-01-27",2006,"Southport","Forest Green Rovers","1-2",1,2,5,5,3,-1,"A"
"2007-01-27",2006,"St Albans","Halifax Town","3-2",3,2,5,5,5,1,"H"
"2007-01-27",2006,"Stafford Rangers","Morecambe","1-3",1,3,5,5,4,-2,"A"
"2007-01-27",2006,"Tamworth","Crawley Town","0-1",0,1,5,5,1,-1,"A"
"2007-01-27",2006,"Weymouth","Northwich Victoria","1-1",1,1,5,5,2,0,"D"
"2007-01-27",2006,"York City","Grays Athletic","2-2",2,2,5,5,4,0,"D"
"2007-01-29",2006,"Oxford United","Rushden & Diamonds","0-1",0,1,5,5,1,-1,"A"
"2007-02-03",2006,"Crawley Town","Forest Green Rovers","3-1",3,1,5,5,4,2,"H"
"2007-02-03",2006,"Oxford United","Cambridge United","1-1",1,1,5,5,2,0,"D"
"2007-02-03",2006,"Southport","Altrincham","2-1",2,1,5,5,3,1,"H"
"2007-02-03",2006,"Stafford Rangers","Exeter City","0-1",0,1,5,5,1,-1,"A"
"2007-02-03",2006,"Weymouth","Burton Albion","1-1",1,1,5,5,2,0,"D"
"2007-02-03",2006,"York City","Tamworth","0-2",0,2,5,5,2,-2,"A"
"2007-02-06",2006,"Aldershot","Grays Athletic","1-0",1,0,5,5,1,1,"H"
"2007-02-10",2006,"Aldershot","Oxford United","1-1",1,1,5,5,2,0,"D"
"2007-02-10",2006,"Altrincham","York City","0-4",0,4,5,5,4,-4,"A"
"2007-02-10",2006,"Cambridge United","Grays Athletic","2-0",2,0,5,5,2,2,"H"
"2007-02-10",2006,"Dagenham and Redbridge","Rushden & Diamonds","1-2",1,2,5,5,3,-1,"A"
"2007-02-10",2006,"Ebbsfleet United","Morecambe","2-1",2,1,5,5,3,1,"H"
"2007-02-10",2006,"Exeter City","Woking","1-0",1,0,5,5,1,1,"H"
"2007-02-10",2006,"Forest Green Rovers","Kidderminster Harriers","2-1",2,1,5,5,3,1,"H"
"2007-02-10",2006,"St Albans","Crawley Town","2-2",2,2,5,5,4,0,"D"
"2007-02-10",2006,"Stevenage Borough","Burton Albion","2-1",2,1,5,5,3,1,"H"
"2007-02-10",2006,"Tamworth","Southport","1-1",1,1,5,5,2,0,"D"
"2007-02-10",2006,"Weymouth","Stafford Rangers","1-2",1,2,5,5,3,-1,"A"
"2007-02-17",2006,"Burton Albion","Dagenham and Redbridge","0-2",0,2,5,5,2,-2,"A"
"2007-02-17",2006,"Crawley Town","Altrincham","1-1",1,1,5,5,2,0,"D"
"2007-02-17",2006,"Grays Athletic","Stevenage Borough","0-2",0,2,5,5,2,-2,"A"
"2007-02-17",2006,"Kidderminster Harriers","Exeter City","0-2",0,2,5,5,2,-2,"A"
"2007-02-17",2006,"Morecambe","Cambridge United","2-2",2,2,5,5,4,0,"D"
"2007-02-17",2006,"Northwich Victoria","Forest Green Rovers","2-0",2,0,5,5,2,2,"H"
"2007-02-17",2006,"Oxford United","Ebbsfleet United","1-0",1,0,5,5,1,1,"H"
"2007-02-17",2006,"Rushden & Diamonds","St Albans","1-0",1,0,5,5,1,1,"H"
"2007-02-17",2006,"Southport","Aldershot","1-0",1,0,5,5,1,1,"H"
"2007-02-17",2006,"Stafford Rangers","Halifax Town","2-3",2,3,5,5,5,-1,"A"
"2007-02-17",2006,"Woking","Tamworth","0-2",0,2,5,5,2,-2,"A"
"2007-02-17",2006,"York City","Weymouth","1-0",1,0,5,5,1,1,"H"
"2007-02-20",2006,"Burton Albion","Tamworth","1-0",1,0,5,5,1,1,"H"
"2007-02-20",2006,"Exeter City","Rushden & Diamonds","0-0",0,0,5,5,0,0,"D"
"2007-02-20",2006,"Halifax Town","Weymouth","4-1",4,1,5,5,5,3,"H"
"2007-02-20",2006,"Kidderminster Harriers","Dagenham and Redbridge","1-4",1,4,5,5,5,-3,"A"
"2007-02-20",2006,"Northwich Victoria","Altrincham","1-1",1,1,5,5,2,0,"D"
"2007-02-20",2006,"Stafford Rangers","Stevenage Borough","1-3",1,3,5,5,4,-2,"A"
"2007-02-20",2006,"Woking","Ebbsfleet United","2-2",2,2,5,5,4,0,"D"
"2007-02-24",2006,"Aldershot","Rushden & Diamonds","2-2",2,2,5,5,4,0,"D"
"2007-02-24",2006,"Cambridge United","Southport","2-2",2,2,5,5,4,0,"D"
"2007-02-24",2006,"Dagenham and Redbridge","York City","2-1",2,1,5,5,3,1,"H"
"2007-02-24",2006,"Exeter City","Burton Albion","3-0",3,0,5,5,3,3,"H"
"2007-02-24",2006,"Forest Green Rovers","Morecambe","1-3",1,3,5,5,4,-2,"A"
"2007-02-24",2006,"St Albans","Stafford Rangers","0-3",0,3,5,5,3,-3,"A"
"2007-02-24",2006,"Tamworth","Oxford United","1-3",1,3,5,5,4,-2,"A"
"2007-02-27",2006,"Cambridge United","Forest Green Rovers","1-1",1,1,5,5,2,0,"D"
"2007-02-27",2006,"Grays Athletic","St Albans","2-1",2,1,5,5,3,1,"H"
"2007-02-27",2006,"Halifax Town","Northwich Victoria","0-2",0,2,5,5,2,-2,"A"
"2007-03-02",2006,"Burton Albion","Altrincham","2-1",2,1,5,5,3,1,"H"
"2007-03-03",2006,"Crawley Town","Aldershot","1-2",1,2,5,5,3,-1,"A"
"2007-03-03",2006,"Grays Athletic","Weymouth","2-2",2,2,5,5,4,0,"D"
"2007-03-03",2006,"Kidderminster Harriers","Ebbsfleet United","1-2",1,2,5,5,3,-1,"A"
"2007-03-03",2006,"Morecambe","St Albans","2-0",2,0,5,5,2,2,"H"
"2007-03-03",2006,"Northwich Victoria","Tamworth","0-1",0,1,5,5,1,-1,"A"
"2007-03-03",2006,"Oxford United","Stevenage Borough","2-0",2,0,5,5,2,2,"H"
"2007-03-03",2006,"Rushden & Diamonds","Exeter City","3-0",3,0,5,5,3,3,"H"
"2007-03-03",2006,"Southport","Dagenham and Redbridge","1-4",1,4,5,5,5,-3,"A"
"2007-03-03",2006,"Stafford Rangers","Cambridge United","1-2",1,2,5,5,3,-1,"A"
"2007-03-03",2006,"Woking","Halifax Town","2-2",2,2,5,5,4,0,"D"
"2007-03-03",2006,"York City","Forest Green Rovers","0-0",0,0,5,5,0,0,"D"
"2007-03-06",2006,"Altrincham","Cambridge United","5-0",5,0,5,5,5,5,"H"
"2007-03-06",2006,"Crawley Town","Burton Albion","1-0",1,0,5,5,1,1,"H"
"2007-03-06",2006,"Dagenham and Redbridge","Stafford Rangers","1-1",1,1,5,5,2,0,"D"
"2007-03-06",2006,"Ebbsfleet United","Weymouth","1-3",1,3,5,5,4,-2,"A"
"2007-03-06",2006,"Exeter City","Grays Athletic","2-1",2,1,5,5,3,1,"H"
"2007-03-06",2006,"Kidderminster Harriers","Halifax Town","1-0",1,0,5,5,1,1,"H"
"2007-03-06",2006,"Rushden & Diamonds","Morecambe","2-2",2,2,5,5,4,0,"D"
"2007-03-06",2006,"Southport","Oxford United","0-1",0,1,5,5,1,-1,"A"
"2007-03-06",2006,"Tamworth","Aldershot","2-0",2,0,5,5,2,2,"H"
"2007-03-06",2006,"Woking","Stevenage Borough","0-1",0,1,5,5,1,-1,"A"
"2007-03-06",2006,"York City","Northwich Victoria","2-1",2,1,5,5,3,1,"H"
"2007-03-10",2006,"Aldershot","York City","0-2",0,2,5,5,2,-2,"A"
"2007-03-10",2006,"Burton Albion","Woking","2-1",2,1,5,5,3,1,"H"
"2007-03-10",2006,"Halifax Town","Exeter City","2-1",2,1,5,5,3,1,"H"
"2007-03-10",2006,"Morecambe","Crawley Town","1-0",1,0,5,5,1,1,"H"
"2007-03-10",2006,"Oxford United","Forest Green Rovers","0-2",0,2,5,5,2,-2,"A"
"2007-03-10",2006,"St Albans","Southport","2-2",2,2,5,5,4,0,"D"
"2007-03-10",2006,"Stafford Rangers","Tamworth","0-4",0,4,5,5,4,-4,"A"
"2007-03-10",2006,"Weymouth","Altrincham","1-2",1,2,5,5,3,-1,"A"
"2007-03-12",2006,"Burton Albion","Forest Green Rovers","1-0",1,0,5,5,1,1,"H"
"2007-03-13",2006,"Aldershot","Woking","2-2",2,2,5,5,4,0,"D"
"2007-03-13",2006,"Cambridge United","York City","0-5",0,5,5,5,5,-5,"A"
"2007-03-13",2006,"Grays Athletic","Tamworth","1-0",1,0,5,5,1,1,"H"
"2007-03-13",2006,"Halifax Town","Rushden & Diamonds","0-0",0,0,5,5,0,0,"D"
"2007-03-13",2006,"Morecambe","Altrincham","0-1",0,1,5,5,1,-1,"A"
"2007-03-13",2006,"Oxford United","Kidderminster Harriers","0-1",0,1,5,5,1,-1,"A"
"2007-03-13",2006,"St Albans","Dagenham and Redbridge","1-2",1,2,5,5,3,-1,"A"
"2007-03-13",2006,"Stafford Rangers","Ebbsfleet United","3-1",3,1,5,5,4,2,"H"
"2007-03-13",2006,"Stevenage Borough","Southport","3-1",3,1,5,5,4,2,"H"
"2007-03-13",2006,"Weymouth","Crawley Town","3-2",3,2,5,5,5,1,"H"
"2007-03-17",2006,"Altrincham","Oxford United","0-3",0,3,5,5,3,-3,"A"
"2007-03-17",2006,"Crawley Town","Cambridge United","1-1",1,1,5,5,2,0,"D"
"2007-03-17",2006,"Dagenham and Redbridge","Forest Green Rovers","1-1",1,1,5,5,2,0,"D"
"2007-03-17",2006,"Ebbsfleet United","Burton Albion","0-0",0,0,5,5,0,0,"D"
"2007-03-17",2006,"Exeter City","Morecambe","1-0",1,0,5,5,1,1,"H"
"2007-03-17",2006,"Southport","Weymouth","0-1",0,1,5,5,1,-1,"A"
"2007-03-17",2006,"Tamworth","Halifax Town","1-0",1,0,5,5,1,1,"H"
"2007-03-17",2006,"Woking","Stafford Rangers","1-1",1,1,5,5,2,0,"D"
"2007-03-17",2006,"York City","St Albans","0-0",0,0,5,5,0,0,"D"
"2007-03-20",2006,"Altrincham","Grays Athletic","1-0",1,0,5,5,1,1,"H"
"2007-03-20",2006,"Dagenham and Redbridge","Stevenage Borough","2-0",2,0,5,5,2,2,"H"
"2007-03-20",2006,"Morecambe","Aldershot","2-1",2,1,5,5,3,1,"H"
"2007-03-20",2006,"Northwich Victoria","Exeter City","1-0",1,0,5,5,1,1,"H"
"2007-03-20",2006,"Tamworth","Kidderminster Harriers","0-0",0,0,5,5,0,0,"D"
"2007-03-20",2006,"Weymouth","Woking","2-3",2,3,5,5,5,-1,"A"
"2007-03-21",2006,"Halifax Town","Oxford United","1-1",1,1,5,5,2,0,"D"
"2007-03-23",2006,"Ebbsfleet United","Aldershot","1-1",1,1,5,5,2,0,"D"
"2007-03-23",2006,"Rushden & Diamonds","Crawley Town","1-1",1,1,5,5,2,0,"D"
"2007-03-24",2006,"Burton Albion","Morecambe","2-1",2,1,5,5,3,1,"H"
"2007-03-24",2006,"Exeter City","York City","1-1",1,1,5,5,2,0,"D"
"2007-03-24",2006,"St Albans","Kidderminster Harriers","1-1",1,1,5,5,2,0,"D"
"2007-03-24",2006,"Stafford Rangers","Grays Athletic","4-2",4,2,5,5,6,2,"H"
"2007-03-24",2006,"Stevenage Borough","Altrincham","0-1",0,1,5,5,1,-1,"A"
"2007-03-24",2006,"Weymouth","Tamworth","3-1",3,1,5,5,4,2,"H"
"2007-03-24",2006,"Woking","Southport","1-1",1,1,5,5,2,0,"D"
"2007-03-25",2006,"Northwich Victoria","Cambridge United","0-4",0,4,5,5,4,-4,"A"
"2007-03-26",2006,"Oxford United","Dagenham and Redbridge","2-2",2,2,5,5,4,0,"D"
"2007-03-27",2006,"Aldershot","Weymouth","1-0",1,0,5,5,1,1,"H"
"2007-03-27",2006,"Altrincham","Stafford Rangers","0-1",0,1,5,5,1,-1,"A"
"2007-03-27",2006,"Crawley Town","Woking","0-0",0,0,5,5,0,0,"D"
"2007-03-27",2006,"Forest Green Rovers","Exeter City","2-1",2,1,5,5,3,1,"H"
"2007-03-27",2006,"Grays Athletic","Rushden & Diamonds","3-1",3,1,5,5,4,2,"H"
"2007-03-27",2006,"Kidderminster Harriers","Burton Albion","0-0",0,0,5,5,0,0,"D"
"2007-03-27",2006,"Morecambe","Northwich Victoria","2-1",2,1,5,5,3,1,"H"
"2007-03-27",2006,"Southport","Halifax Town","1-1",1,1,5,5,2,0,"D"
"2007-03-27",2006,"Tamworth","Ebbsfleet United","2-1",2,1,5,5,3,1,"H"
"2007-03-27",2006,"York City","Stevenage Borough","0-1",0,1,5,5,1,-1,"A"
"2007-03-31",2006,"Aldershot","St Albans","2-0",2,0,5,5,2,2,"H"
"2007-03-31",2006,"Altrincham","Exeter City","1-2",1,2,5,5,3,-1,"A"
"2007-03-31",2006,"Cambridge United","Weymouth","7-0",7,0,5,5,7,7,"H"
"2007-03-31",2006,"Crawley Town","Stevenage Borough","3-0",3,0,5,5,3,3,"H"
"2007-03-31",2006,"Forest Green Rovers","Rushden & Diamonds","0-2",0,2,5,5,2,-2,"A"
"2007-03-31",2006,"Grays Athletic","Halifax Town","1-0",1,0,5,5,1,1,"H"
"2007-03-31",2006,"Kidderminster Harriers","Northwich Victoria","0-1",0,1,5,5,1,-1,"A"
"2007-03-31",2006,"Morecambe","Woking","2-0",2,0,5,5,2,2,"H"
"2007-03-31",2006,"Oxford United","Burton Albion","0-0",0,0,5,5,0,0,"D"
"2007-03-31",2006,"Southport","Stafford Rangers","5-1",5,1,5,5,6,4,"H"
"2007-03-31",2006,"Tamworth","Dagenham and Redbridge","0-2",0,2,5,5,2,-2,"A"
"2007-03-31",2006,"York City","Ebbsfleet United","0-2",0,2,5,5,2,-2,"A"
"2007-04-03",2006,"Aldershot","Exeter City","3-2",3,2,5,5,5,1,"H"
"2007-04-03",2006,"Ebbsfleet United","Halifax Town","2-0",2,0,5,5,2,2,"H"
"2007-04-03",2006,"Forest Green Rovers","Grays Athletic","0-0",0,0,5,5,0,0,"D"
"2007-04-03",2006,"Rushden & Diamonds","Weymouth","4-1",4,1,5,5,5,3,"H"
"2007-04-03",2006,"St Albans","Morecambe","0-2",0,2,5,5,2,-2,"A"
"2007-04-03",2006,"Stevenage Borough","Kidderminster Harriers","1-2",1,2,5,5,3,-1,"A"
"2007-04-03",2006,"Tamworth","Northwich Victoria","0-1",0,1,5,5,1,-1,"A"
"2007-04-07",2006,"Burton Albion","York City","1-2",1,2,5,5,3,-1,"A"
"2007-04-07",2006,"Dagenham and Redbridge","Aldershot","2-1",2,1,5,5,3,1,"H"
"2007-04-07",2006,"Ebbsfleet United","Forest Green Rovers","1-1",1,1,5,5,2,0,"D"
"2007-04-07",2006,"Exeter City","Tamworth","1-0",1,0,5,5,1,1,"H"
"2007-04-07",2006,"Halifax Town","Cambridge United","1-0",1,0,5,5,1,1,"H"
"2007-04-07",2006,"Northwich Victoria","Oxford United","1-0",1,0,5,5,1,1,"H"
"2007-04-07",2006,"Rushden & Diamonds","Southport","2-3",2,3,5,5,5,-1,"A"
"2007-04-07",2006,"St Albans","Altrincham","1-5",1,5,5,5,6,-4,"A"
"2007-04-07",2006,"Stafford Rangers","Crawley Town","0-1",0,1,5,5,1,-1,"A"
"2007-04-07",2006,"Stevenage Borough","Morecambe","3-3",3,3,5,5,6,0,"D"
"2007-04-07",2006,"Weymouth","Kidderminster Harriers","1-1",1,1,5,5,2,0,"D"
"2007-04-07",2006,"Woking","Grays Athletic","1-0",1,0,5,5,1,1,"H"
"2007-04-09",2006,"Aldershot","Stafford Rangers","4-2",4,2,5,5,6,2,"H"
"2007-04-09",2006,"Altrincham","Ebbsfleet United","0-2",0,2,5,5,2,-2,"A"
"2007-04-09",2006,"Cambridge United","Dagenham and Redbridge","4-2",4,2,5,5,6,2,"H"
"2007-04-09",2006,"Crawley Town","Exeter City","0-3",0,3,5,5,3,-3,"A"
"2007-04-09",2006,"Forest Green Rovers","Stevenage Borough","4-4",4,4,5,5,8,0,"D"
"2007-04-09",2006,"Grays Athletic","Northwich Victoria","1-0",1,0,5,5,1,1,"H"
"2007-04-09",2006,"Kidderminster Harriers","Woking","0-1",0,1,5,5,1,-1,"A"
"2007-04-09",2006,"Morecambe","Halifax Town","4-0",4,0,5,5,4,4,"H"
"2007-04-09",2006,"Oxford United","Weymouth","4-1",4,1,5,5,5,3,"H"
"2007-04-09",2006,"Southport","Burton Albion","3-1",3,1,5,5,4,2,"H"
"2007-04-09",2006,"Tamworth","St Albans","1-1",1,1,5,5,2,0,"D"
"2007-04-10",2006,"York City","Rushden & Diamonds","3-1",3,1,5,5,4,2,"H"
"2007-04-11",2006,"Northwich Victoria","Dagenham and Redbridge","2-0",2,0,5,5,2,2,"H"
"2007-04-14",2006,"Burton Albion","Grays Athletic","3-0",3,0,5,5,3,3,"H"
"2007-04-14",2006,"Dagenham and Redbridge","Altrincham","4-1",4,1,5,5,5,3,"H"
"2007-04-14",2006,"Ebbsfleet United","Southport","0-4",0,4,5,5,4,-4,"A"
"2007-04-14",2006,"Exeter City","Cambridge United","2-0",2,0,5,5,2,2,"H"
"2007-04-14",2006,"Halifax Town","Aldershot","2-0",2,0,5,5,2,2,"H"
"2007-04-14",2006,"Northwich Victoria","Crawley Town","2-1",2,1,5,5,3,1,"H"
"2007-04-14",2006,"Rushden & Diamonds","Kidderminster Harriers","0-1",0,1,5,5,1,-1,"A"
"2007-04-14",2006,"St Albans","Oxford United","0-2",0,2,5,5,2,-2,"A"
"2007-04-14",2006,"Stafford Rangers","York City","0-0",0,0,5,5,0,0,"D"
"2007-04-14",2006,"Stevenage Borough","Tamworth","3-0",3,0,5,5,3,3,"H"
"2007-04-14",2006,"Weymouth","Morecambe","2-1",2,1,5,5,3,1,"H"
"2007-04-14",2006,"Woking","Forest Green Rovers","3-3",3,3,5,5,6,0,"D"
"2007-04-17",2006,"Burton Albion","Halifax Town","1-0",1,0,5,5,1,1,"H"
"2007-04-17",2006,"Kidderminster Harriers","Aldershot","0-0",0,0,5,5,0,0,"D"
"2007-04-17",2006,"Stafford Rangers","Northwich Victoria","2-0",2,0,5,5,2,2,"H"
"2007-04-17",2006,"Stevenage Borough","Rushden & Diamonds","1-0",1,0,5,5,1,1,"H"
"2007-04-19",2006,"Ebbsfleet United","Northwich Victoria","3-0",3,0,5,5,3,3,"H"
"2007-04-21",2006,"Aldershot","Cambridge United","0-1",0,1,5,5,1,-1,"A"
"2007-04-21",2006,"Ebbsfleet United","St Albans","3-2",3,2,5,5,5,1,"H"
"2007-04-21",2006,"Forest Green Rovers","Halifax Town","2-0",2,0,5,5,2,2,"H"
"2007-04-21",2006,"Grays Athletic","Crawley Town","0-0",0,0,5,5,0,0,"D"
"2007-04-21",2006,"Kidderminster Harriers","Morecambe","0-1",0,1,5,5,1,-1,"A"
"2007-04-21",2006,"Northwich Victoria","Burton Albion","0-3",0,3,5,5,3,-3,"A"
"2007-04-21",2006,"Oxford United","Stafford Rangers","2-0",2,0,5,5,2,2,"H"
"2007-04-21",2006,"Rushden & Diamonds","Woking","2-0",2,0,5,5,2,2,"H"
"2007-04-21",2006,"Southport","York City","0-1",0,1,5,5,1,-1,"A"
"2007-04-21",2006,"Stevenage Borough","Exeter City","0-0",0,0,5,5,0,0,"D"
"2007-04-21",2006,"Tamworth","Altrincham","1-0",1,0,5,5,1,1,"H"
"2007-04-21",2006,"Weymouth","Dagenham and Redbridge","1-1",1,1,5,5,2,0,"D"
"2007-04-23",2006,"Rushden & Diamonds","Northwich Victoria","1-0",1,0,5,5,1,1,"H"
"2007-04-24",2006,"Grays Athletic","Kidderminster Harriers","3-0",3,0,5,5,3,3,"H"
"2007-04-24",2006,"Halifax Town","Crawley Town","2-1",2,1,5,5,3,1,"H"
"2007-04-25",2006,"Northwich Victoria","Stevenage Borough","0-0",0,0,5,5,0,0,"D"
"2007-04-28",2006,"Altrincham","Aldershot","0-0",0,0,5,5,0,0,"D"
"2007-04-28",2006,"Burton Albion","Rushden & Diamonds","1-2",1,2,5,5,3,-1,"A"
"2007-04-28",2006,"Cambridge United","Tamworth","1-0",1,0,5,5,1,1,"H"
"2007-04-28",2006,"Crawley Town","Kidderminster Harriers","0-0",0,0,5,5,0,0,"D"
"2007-04-28",2006,"Dagenham and Redbridge","Ebbsfleet United","2-1",2,1,5,5,3,1,"H"
"2007-04-28",2006,"Exeter City","Southport","2-1",2,1,5,5,3,1,"H"
"2007-04-28",2006,"Halifax Town","Stevenage Borough","2-1",2,1,5,5,3,1,"H"
"2007-04-28",2006,"Morecambe","Grays Athletic","1-0",1,0,5,5,1,1,"H"
"2007-04-28",2006,"St Albans","Weymouth","1-0",1,0,5,5,1,1,"H"
"2007-04-28",2006,"Stafford Rangers","Forest Green Rovers","0-1",0,1,5,5,1,-1,"A"
"2007-04-28",2006,"Woking","Northwich Victoria","3-2",3,2,5,5,5,1,"H"
"2007-04-28",2006,"York City","Oxford United","1-0",1,0,5,5,1,1,"H"
"2007-08-11",2007,"Altrincham","Exeter City","1-4",1,4,5,5,5,-3,"A"
"2007-08-11",2007,"Crawley Town","Stevenage Borough","2-1",2,1,5,5,3,1,"H"
"2007-08-11",2007,"Droylsden","Salisbury","0-0",0,0,5,5,0,0,"D"
"2007-08-11",2007,"Ebbsfleet United","Northwich Victoria","2-1",2,1,5,5,3,1,"H"
"2007-08-11",2007,"Farsley","Stafford Rangers","1-0",1,0,5,5,1,1,"H"
"2007-08-11",2007,"Histon","Burton Albion","2-2",2,2,5,5,4,0,"D"
"2007-08-11",2007,"Kidderminster Harriers","Aldershot","1-2",1,2,5,5,3,-1,"A"
"2007-08-11",2007,"Oxford United","Forest Green Rovers","1-0",1,0,5,5,1,1,"H"
"2007-08-11",2007,"Weymouth","Halifax Town","2-1",2,1,5,5,3,1,"H"
"2007-08-11",2007,"Woking","Rushden & Diamonds","1-1",1,1,5,5,2,0,"D"
"2007-08-11",2007,"York City","Cambridge United","1-2",1,2,5,5,3,-1,"A"
"2007-08-12",2007,"Torquay United","Grays Athletic","0-0",0,0,5,5,0,0,"D"
"2007-08-14",2007,"Burton Albion","York City","4-3",4,3,5,5,7,1,"H"
"2007-08-14",2007,"Exeter City","Crawley Town","2-0",2,0,5,5,2,2,"H"
"2007-08-14",2007,"Forest Green Rovers","Weymouth","3-2",3,2,5,5,5,1,"H"
"2007-08-14",2007,"Halifax Town","Altrincham","2-2",2,2,5,5,4,0,"D"
"2007-08-14",2007,"Northwich Victoria","Droylsden","3-3",3,3,5,5,6,0,"D"
"2007-08-14",2007,"Rushden & Diamonds","Farsley","1-0",1,0,5,5,1,1,"H"
"2007-08-14",2007,"Salisbury","Ebbsfleet United","2-1",2,1,5,5,3,1,"H"
"2007-08-14",2007,"Stafford Rangers","Kidderminster Harriers","1-3",1,3,5,5,4,-2,"A"
"2007-08-14",2007,"Stevenage Borough","Histon","2-1",2,1,5,5,3,1,"H"
"2007-08-15",2007,"Aldershot","Torquay United","0-3",0,3,5,5,3,-3,"A"
"2007-08-15",2007,"Grays Athletic","Woking","1-1",1,1,5,5,2,0,"D"
"2007-08-16",2007,"Cambridge United","Oxford United","2-1",2,1,5,5,3,1,"H"
"2007-08-18",2007,"Aldershot","Droylsden","3-1",3,1,5,5,4,2,"H"
"2007-08-18",2007,"Forest Green Rovers","Altrincham","3-1",3,1,5,5,4,2,"H"
"2007-08-18",2007,"Grays Athletic","Kidderminster Harriers","5-1",5,1,5,5,6,4,"H"
"2007-08-18",2007,"Halifax Town","Histon","0-0",0,0,5,5,0,0,"D"
"2007-08-18",2007,"Northwich Victoria","Torquay United","1-3",1,3,5,5,4,-2,"A"
"2007-08-18",2007,"Rushden & Diamonds","Ebbsfleet United","0-1",0,1,5,5,1,-1,"A"
"2007-08-18",2007,"Salisbury","Crawley Town","4-1",4,1,5,5,5,3,"H"
"2007-08-18",2007,"Stafford Rangers","Woking","0-1",0,1,5,5,1,-1,"A"
"2007-08-18",2007,"Stevenage Borough","Weymouth","3-0",3,0,5,5,3,3,"H"
"2007-08-19",2007,"Burton Albion","Oxford United","1-2",1,2,5,5,3,-1,"A"
"2007-08-20",2007,"Exeter City","York City","1-1",1,1,5,5,2,0,"D"
"2007-08-21",2007,"Cambridge United","Farsley","5-1",5,1,5,5,6,4,"H"
"2007-08-23",2007,"Weymouth","Burton Albion","1-2",1,2,5,5,3,-1,"A"
"2007-08-24",2007,"Histon","Aldershot","1-2",1,2,5,5,3,-1,"A"
"2007-08-24",2007,"Kidderminster Harriers","Stevenage Borough","0-2",0,2,5,5,2,-2,"A"
"2007-08-24",2007,"York City","Forest Green Rovers","0-2",0,2,5,5,2,-2,"A"
"2007-08-25",2007,"Altrincham","Grays Athletic","0-1",0,1,5,5,1,-1,"A"
"2007-08-25",2007,"Crawley Town","Northwich Victoria","2-1",2,1,5,5,3,1,"H"
"2007-08-25",2007,"Droylsden","Exeter City","2-3",2,3,5,5,5,-1,"A"
"2007-08-25",2007,"Ebbsfleet United","Halifax Town","1-0",1,0,5,5,1,1,"H"
"2007-08-25",2007,"Farsley","Salisbury","2-2",2,2,5,5,4,0,"D"
"2007-08-25",2007,"Oxford United","Stafford Rangers","2-1",2,1,5,5,3,1,"H"
"2007-08-25",2007,"Torquay United","Rushden & Diamonds","3-2",3,2,5,5,5,1,"H"
"2007-08-25",2007,"Woking","Cambridge United","0-0",0,0,5,5,0,0,"D"
"2007-08-27",2007,"Aldershot","Crawley Town","0-1",0,1,5,5,1,-1,"A"
"2007-08-27",2007,"Burton Albion","Farsley","1-0",1,0,5,5,1,1,"H"
"2007-08-27",2007,"Cambridge United","Ebbsfleet United","1-1",1,1,5,5,2,0,"D"
"2007-08-27",2007,"Exeter City","Weymouth","0-0",0,0,5,5,0,0,"D"
"2007-08-27",2007,"Forest Green Rovers","Torquay United","2-2",2,2,5,5,4,0,"D"
"2007-08-27",2007,"Grays Athletic","Histon","0-1",0,1,5,5,1,-1,"A"
"2007-08-27",2007,"Halifax Town","Droylsden","3-0",3,0,5,5,3,3,"H"
"2007-08-27",2007,"Northwich Victoria","York City","0-1",0,1,5,5,1,-1,"A"
"2007-08-27",2007,"Rushden & Diamonds","Kidderminster Harriers","0-1",0,1,5,5,1,-1,"A"
"2007-08-27",2007,"Salisbury","Woking","2-1",2,1,5,5,3,1,"H"
"2007-08-27",2007,"Stafford Rangers","Altrincham","1-1",1,1,5,5,2,0,"D"
"2007-08-27",2007,"Stevenage Borough","Oxford United","0-0",0,0,5,5,0,0,"D"
"2007-08-30",2007,"York City","Rushden & Diamonds","2-3",2,3,5,5,5,-1,"A"
"2007-08-31",2007,"Weymouth","Cambridge United","2-2",2,2,5,5,4,0,"D"
"2007-09-01",2007,"Altrincham","Aldershot","1-2",1,2,5,5,3,-1,"A"
"2007-09-01",2007,"Crawley Town","Burton Albion","1-1",1,1,5,5,2,0,"D"
"2007-09-01",2007,"Droylsden","Grays Athletic","1-2",1,2,5,5,3,-1,"A"
"2007-09-01",2007,"Ebbsfleet United","Stevenage Borough","0-1",0,1,5,5,1,-1,"A"
"2007-09-01",2007,"Farsley","Northwich Victoria","2-1",2,1,5,5,3,1,"H"
"2007-09-01",2007,"Histon","Salisbury","2-0",2,0,5,5,2,2,"H"
"2007-09-01",2007,"Kidderminster Harriers","Exeter City","4-0",4,0,5,5,4,4,"H"
"2007-09-01",2007,"Oxford United","Halifax Town","1-1",1,1,5,5,2,0,"D"
"2007-09-01",2007,"Torquay United","Stafford Rangers","2-0",2,0,5,5,2,2,"H"
"2007-09-01",2007,"Woking","Forest Green Rovers","1-1",1,1,5,5,2,0,"D"
"2007-09-04",2007,"Cambridge United","Grays Athletic","1-0",1,0,5,5,1,1,"H"
"2007-09-04",2007,"Droylsden","Stevenage Borough","0-3",0,3,5,5,3,-3,"A"
"2007-09-04",2007,"Ebbsfleet United","Histon","0-1",0,1,5,5,1,-1,"A"
"2007-09-04",2007,"Farsley","Kidderminster Harriers","1-1",1,1,5,5,2,0,"D"
"2007-09-04",2007,"Forest Green Rovers","Aldershot","2-3",2,3,5,5,5,-1,"A"
"2007-09-04",2007,"Northwich Victoria","Burton Albion","0-2",0,2,5,5,2,-2,"A"
"2007-09-04",2007,"Oxford United","Exeter City","2-2",2,2,5,5,4,0,"D"
"2007-09-04",2007,"Rushden & Diamonds","Crawley Town","1-1",1,1,5,5,2,0,"D"
"2007-09-04",2007,"Torquay United","Salisbury","4-0",4,0,5,5,4,4,"H"
"2007-09-04",2007,"Woking","Weymouth","1-1",1,1,5,5,2,0,"D"
"2007-09-04",2007,"York City","Altrincham","2-2",2,2,5,5,4,0,"D"
"2007-09-06",2007,"Stafford Rangers","Halifax Town","2-3",2,3,5,5,5,-1,"A"
"2007-09-08",2007,"Aldershot","Northwich Victoria","5-0",5,0,5,5,5,5,"H"
"2007-09-08",2007,"Altrincham","Oxford United","1-3",1,3,5,5,4,-2,"A"
"2007-09-08",2007,"Crawley Town","Droylsden","5-0",5,0,5,5,5,5,"H"
"2007-09-08",2007,"Exeter City","Cambridge United","1-1",1,1,5,5,2,0,"D"
"2007-09-08",2007,"Grays Athletic","Forest Green Rovers","0-1",0,1,5,5,1,-1,"A"
"2007-09-08",2007,"Histon","Farsley","1-2",1,2,5,5,3,-1,"A"
"2007-09-08",2007,"Kidderminster Harriers","York City","3-0",3,0,5,5,3,3,"H"
"2007-09-08",2007,"Salisbury","Rushden & Diamonds","1-1",1,1,5,5,2,0,"D"
"2007-09-08",2007,"Weymouth","Ebbsfleet United","2-0",2,0,5,5,2,2,"H"
"2007-09-10",2007,"Burton Albion","Torquay United","3-1",3,1,5,5,4,2,"H"
"2007-09-10",2007,"Stevenage Borough","Stafford Rangers","3-0",3,0,5,5,3,3,"H"
"2007-09-11",2007,"Grays Athletic","Oxford United","0-0",0,0,5,5,0,0,"D"
"2007-09-11",2007,"Halifax Town","Woking","1-0",1,0,5,5,1,1,"H"
"2007-09-13",2007,"Forest Green Rovers","Salisbury","0-3",0,3,5,5,3,-3,"A"
"2007-09-14",2007,"Torquay United","Halifax Town","3-1",3,1,5,5,4,2,"H"
"2007-09-15",2007,"Cambridge United","Crawley Town","2-1",2,1,5,5,3,1,"H"
"2007-09-15",2007,"Droylsden","Weymouth","1-3",1,3,5,5,4,-2,"A"
"2007-09-15",2007,"Ebbsfleet United","Kidderminster Harriers","5-4",5,4,5,5,9,1,"H"
"2007-09-15",2007,"Farsley","Exeter City","0-2",0,2,5,5,2,-2,"A"
"2007-09-15",2007,"Northwich Victoria","Histon","1-3",1,3,5,5,4,-2,"A"
"2007-09-15",2007,"Oxford United","Aldershot","2-3",2,3,5,5,5,-1,"A"
"2007-09-15",2007,"Rushden & Diamonds","Burton Albion","0-0",0,0,5,5,0,0,"D"
"2007-09-15",2007,"Stafford Rangers","Grays Athletic","0-2",0,2,5,5,2,-2,"A"
"2007-09-15",2007,"Woking","Altrincham","2-0",2,0,5,5,2,2,"H"
"2007-09-15",2007,"York City","Stevenage Borough","0-2",0,2,5,5,2,-2,"A"
"2007-09-18",2007,"Aldershot","York City","2-0",2,0,5,5,2,2,"H"
"2007-09-18",2007,"Altrincham","Cambridge United","0-3",0,3,5,5,3,-3,"A"
"2007-09-18",2007,"Burton Albion","Ebbsfleet United","1-1",1,1,5,5,2,0,"D"
"2007-09-18",2007,"Crawley Town","Woking","5-3",5,3,5,5,8,2,"H"
"2007-09-18",2007,"Exeter City","Forest Green Rovers","3-3",3,3,5,5,6,0,"D"
"2007-09-18",2007,"Halifax Town","Northwich Victoria","3-1",3,1,5,5,4,2,"H"
"2007-09-18",2007,"Histon","Torquay United","4-5",4,5,5,5,9,-1,"A"
"2007-09-18",2007,"Kidderminster Harriers","Droylsden","3-1",3,1,5,5,4,2,"H"
"2007-09-18",2007,"Salisbury","Stafford Rangers","1-0",1,0,5,5,1,1,"H"
"2007-09-18",2007,"Stevenage Borough","Farsley","4-0",4,0,5,5,4,4,"H"
"2007-09-18",2007,"Weymouth","Rushden & Diamonds","1-2",1,2,5,5,3,-1,"A"
"2007-09-20",2007,"Histon","Oxford United","1-0",1,0,5,5,1,1,"H"
"2007-09-22",2007,"Aldershot","Farsley","4-3",4,3,5,5,7,1,"H"
"2007-09-22",2007,"Altrincham","Droylsden","3-2",3,2,5,5,5,1,"H"
"2007-09-22",2007,"Burton Albion","Woking","2-0",2,0,5,5,2,2,"H"
"2007-09-22",2007,"Crawley Town","Forest Green Rovers","3-0",3,0,5,5,3,3,"H"
"2007-09-22",2007,"Exeter City","Ebbsfleet United","1-1",1,1,5,5,2,0,"D"
"2007-09-22",2007,"Grays Athletic","York City","0-2",0,2,5,5,2,-2,"A"
"2007-09-22",2007,"Halifax Town","Rushden & Diamonds","1-1",1,1,5,5,2,0,"D"
"2007-09-22",2007,"Kidderminster Harriers","Torquay United","2-5",2,5,5,5,7,-3,"A"
"2007-09-22",2007,"Salisbury","Northwich Victoria","2-0",2,0,5,5,2,2,"H"
"2007-09-22",2007,"Stevenage Borough","Cambridge United","1-2",1,2,5,5,3,-1,"A"
"2007-09-22",2007,"Weymouth","Stafford Rangers","1-3",1,3,5,5,4,-2,"A"
"2007-09-25",2007,"Cambridge United","Aldershot","1-1",1,1,5,5,2,0,"D"
"2007-09-25",2007,"Droylsden","Burton Albion","0-2",0,2,5,5,2,-2,"A"
"2007-09-25",2007,"Ebbsfleet United","Crawley Town","1-0",1,0,5,5,1,1,"H"
"2007-09-25",2007,"Forest Green Rovers","Stevenage Borough","4-2",4,2,5,5,6,2,"H"
"2007-09-25",2007,"Oxford United","Salisbury","2-1",2,1,5,5,3,1,"H"
"2007-09-25",2007,"Rushden & Diamonds","Grays Athletic","1-1",1,1,5,5,2,0,"D"
"2007-09-25",2007,"Stafford Rangers","Histon","1-1",1,1,5,5,2,0,"D"
"2007-09-25",2007,"Torquay United","Weymouth","3-2",3,2,5,5,5,1,"H"
"2007-09-25",2007,"Woking","Exeter City","1-1",1,1,5,5,2,0,"D"
"2007-09-27",2007,"York City","Halifax Town","3-2",3,2,5,5,5,1,"H"
"2007-09-29",2007,"Crawley Town","Altrincham","0-1",0,1,5,5,1,-1,"A"
"2007-09-29",2007,"Farsley","Ebbsfleet United","1-1",1,1,5,5,2,0,"D"
"2007-09-29",2007,"Forest Green Rovers","Cambridge United","3-1",3,1,5,5,4,2,"H"
"2007-09-29",2007,"Grays Athletic","Stevenage Borough","0-2",0,2,5,5,2,-2,"A"
"2007-09-29",2007,"Histon","Weymouth","2-2",2,2,5,5,4,0,"D"
"2007-09-29",2007,"Northwich Victoria","Woking","1-3",1,3,5,5,4,-2,"A"
"2007-09-29",2007,"Rushden & Diamonds","Stafford Rangers","1-1",1,1,5,5,2,0,"D"
"2007-09-29",2007,"Salisbury","Kidderminster Harriers","0-1",0,1,5,5,1,-1,"A"
"2007-09-29",2007,"Torquay United","Droylsden","2-1",2,1,5,5,3,1,"H"
"2007-09-30",2007,"Oxford United","York City","1-1",1,1,5,5,2,0,"D"
"2007-10-02",2007,"Aldershot","Exeter City","2-0",2,0,5,5,2,2,"H"
"2007-10-02",2007,"Halifax Town","Burton Albion","2-2",2,2,5,5,4,0,"D"
"2007-10-02",2007,"Northwich Victoria","Kidderminster Harriers","1-1",1,1,5,5,2,0,"D"
"2007-10-04",2007,"Woking","Farsley","2-0",2,0,5,5,2,2,"H"
"2007-10-06",2007,"Altrincham","Rushden & Diamonds","1-2",1,2,5,5,3,-1,"A"
"2007-10-06",2007,"Burton Albion","Salisbury","4-3",4,3,5,5,7,1,"H"
"2007-10-06",2007,"Cambridge United","Halifax Town","2-2",2,2,5,5,4,0,"D"
"2007-10-06",2007,"Droylsden","Oxford United","3-1",3,1,5,5,4,2,"H"
"2007-10-06",2007,"Ebbsfleet United","Torquay United","2-1",2,1,5,5,3,1,"H"
"2007-10-06",2007,"Exeter City","Grays Athletic","1-0",1,0,5,5,1,1,"H"
"2007-10-06",2007,"Kidderminster Harriers","Crawley Town","1-1",1,1,5,5,2,0,"D"
"2007-10-06",2007,"Stafford Rangers","Forest Green Rovers","1-3",1,3,5,5,4,-2,"A"
"2007-10-06",2007,"Stevenage Borough","Aldershot","3-1",3,1,5,5,4,2,"H"
"2007-10-06",2007,"Weymouth","Northwich Victoria","2-0",2,0,5,5,2,2,"H"
"2007-10-06",2007,"York City","Histon","1-4",1,4,5,5,5,-3,"A"
"2007-10-09",2007,"Aldershot","Ebbsfleet United","2-0",2,0,5,5,2,2,"H"
"2007-10-09",2007,"Altrincham","Burton Albion","0-0",0,0,5,5,0,0,"D"
"2007-10-09",2007,"Cambridge United","Rushden & Diamonds","1-0",1,0,5,5,1,1,"H"
"2007-10-09",2007,"Crawley Town","Histon","1-0",1,0,5,5,1,1,"H"
"2007-10-09",2007,"Droylsden","Farsley","0-3",0,3,5,5,3,-3,"A"
"2007-10-09",2007,"Exeter City","Salisbury","4-2",4,2,5,5,6,2,"H"
"2007-10-09",2007,"Forest Green Rovers","Northwich Victoria","4-1",4,1,5,5,5,3,"H"
"2007-10-09",2007,"Grays Athletic","Weymouth","0-2",0,2,5,5,2,-2,"A"
"2007-10-09",2007,"Kidderminster Harriers","Halifax Town","1-0",1,0,5,5,1,1,"H"
"2007-10-09",2007,"Stevenage Borough","Woking","1-1",1,1,5,5,2,0,"D"
"2007-10-09",2007,"York City","Stafford Rangers","2-0",2,0,5,5,2,2,"H"
"2007-10-11",2007,"Oxford United","Torquay United","3-3",3,3,5,5,6,0,"D"
"2007-10-12",2007,"Rushden & Diamonds","Forest Green Rovers","1-2",1,2,5,5,3,-1,"A"
"2007-10-12",2007,"Weymouth","Crawley Town","1-2",1,2,5,5,3,-1,"A"
"2007-10-13",2007,"Burton Albion","Aldershot","2-0",2,0,5,5,2,2,"H"
"2007-10-13",2007,"Ebbsfleet United","Droylsden","2-0",2,0,5,5,2,2,"H"
"2007-10-13",2007,"Northwich Victoria","Exeter City","0-0",0,0,5,5,0,0,"D"
"2007-10-13",2007,"Salisbury","Altrincham","3-3",3,3,5,5,6,0,"D"
"2007-10-13",2007,"Stafford Rangers","Cambridge United","1-1",1,1,5,5,2,0,"D"
"2007-10-13",2007,"Woking","York City","0-3",0,3,5,5,3,-3,"A"
"2007-10-14",2007,"Farsley","Oxford United","0-1",0,1,5,5,1,-1,"A"
"2007-10-14",2007,"Histon","Kidderminster Harriers","2-1",2,1,5,5,3,1,"H"
"2007-10-14",2007,"Torquay United","Stevenage Borough","4-2",4,2,5,5,6,2,"H"
"2007-10-16",2007,"Halifax Town","Grays Athletic","0-0",0,0,5,5,0,0,"D"
"2007-10-18",2007,"Stevenage Borough","Burton Albion","3-3",3,3,5,5,6,0,"D"
"2007-10-20",2007,"Aldershot","Halifax Town","1-0",1,0,5,5,1,1,"H"
"2007-10-20",2007,"Altrincham","Ebbsfleet United","1-3",1,3,5,5,4,-2,"A"
"2007-10-20",2007,"Cambridge United","Salisbury","1-1",1,1,5,5,2,0,"D"
"2007-10-20",2007,"Crawley Town","Stafford Rangers","1-1",1,1,5,5,2,0,"D"
"2007-10-20",2007,"Droylsden","Histon","0-1",0,1,5,5,1,-1,"A"
"2007-10-20",2007,"Exeter City","Rushden & Diamonds","2-2",2,2,5,5,4,0,"D"
"2007-10-20",2007,"Forest Green Rovers","Farsley","2-2",2,2,5,5,4,0,"D"
"2007-10-20",2007,"Grays Athletic","Northwich Victoria","3-1",3,1,5,5,4,2,"H"
"2007-10-20",2007,"Kidderminster Harriers","Weymouth","0-2",0,2,5,5,2,-2,"A"
"2007-10-20",2007,"Oxford United","Woking","0-0",0,0,5,5,0,0,"D"
"2007-10-21",2007,"York City","Torquay United","0-1",0,1,5,5,1,-1,"A"
"2007-11-01",2007,"Rushden & Diamonds","Oxford United","5-0",5,0,5,5,5,5,"H"
"2007-11-02",2007,"Weymouth","Aldershot","0-2",0,2,5,5,2,-2,"A"
"2007-11-03",2007,"Burton Albion","Kidderminster Harriers","0-2",0,2,5,5,2,-2,"A"
"2007-11-03",2007,"Ebbsfleet United","Forest Green Rovers","0-2",0,2,5,5,2,-2,"A"
"2007-11-03",2007,"Halifax Town","Crawley Town","3-0",3,0,5,5,3,3,"H"
"2007-11-03",2007,"Histon","Altrincham","1-0",1,0,5,5,1,1,"H"
"2007-11-03",2007,"Northwich Victoria","Stevenage Borough","0-2",0,2,5,5,2,-2,"A"
"2007-11-03",2007,"Salisbury","Grays Athletic","0-1",0,1,5,5,1,-1,"A"
"2007-11-03",2007,"Stafford Rangers","Exeter City","1-5",1,5,5,5,6,-4,"A"
"2007-11-03",2007,"Torquay United","Cambridge United","1-2",1,2,5,5,3,-1,"A"
"2007-11-03",2007,"Woking","Droylsden","1-1",1,1,5,5,2,0,"D"
"2007-11-04",2007,"Farsley","York City","1-4",1,4,5,5,5,-3,"A"
"2007-11-10",2007,"Woking","Grays Athletic","0-1",0,1,5,5,1,-1,"A"
"2007-11-17",2007,"Aldershot","Rushden & Diamonds","2-1",2,1,5,5,3,1,"H"
"2007-11-17",2007,"Altrincham","Weymouth","3-2",3,2,5,5,5,1,"H"
"2007-11-17",2007,"Cambridge United","Northwich Victoria","2-1",2,1,5,5,3,1,"H"
"2007-11-17",2007,"Crawley Town","Torquay United","2-3",2,3,5,5,5,-1,"A"
"2007-11-17",2007,"Droylsden","Stafford Rangers","1-1",1,1,5,5,2,0,"D"
"2007-11-17",2007,"Exeter City","Burton Albion","1-4",1,4,5,5,5,-3,"A"
"2007-11-17",2007,"Forest Green Rovers","Histon","3-1",3,1,5,5,4,2,"H"
"2007-11-17",2007,"Grays Athletic","Farsley","1-0",1,0,5,5,1,1,"H"
"2007-11-17",2007,"Kidderminster Harriers","Woking","1-1",1,1,5,5,2,0,"D"
"2007-11-17",2007,"Oxford United","Ebbsfleet United","0-0",0,0,5,5,0,0,"D"
"2007-11-17",2007,"Stevenage Borough","Halifax Town","2-3",2,3,5,5,5,-1,"A"
"2007-11-17",2007,"York City","Salisbury","1-3",1,3,5,5,4,-2,"A"
"2007-11-20",2007,"Farsley","Altrincham","1-1",1,1,5,5,2,0,"D"
"2007-11-22",2007,"Aldershot","Grays Athletic","3-2",3,2,5,5,5,1,"H"
"2007-11-23",2007,"Burton Albion","Cambridge United","1-2",1,2,5,5,3,-1,"A"
"2007-11-24",2007,"Crawley Town","Farsley","4-1",4,1,5,5,5,3,"H"
"2007-11-24",2007,"Droylsden","Forest Green Rovers","5-3",5,3,5,5,8,2,"H"
"2007-11-24",2007,"Ebbsfleet United","Stafford Rangers","2-1",2,1,5,5,3,1,"H"
"2007-11-24",2007,"Halifax Town","Salisbury","1-1",1,1,5,5,2,0,"D"
"2007-11-24",2007,"Histon","Exeter City","2-2",2,2,5,5,4,0,"D"
"2007-11-24",2007,"Kidderminster Harriers","Oxford United","0-2",0,2,5,5,2,-2,"A"
"2007-11-24",2007,"Northwich Victoria","Rushden & Diamonds","1-0",1,0,5,5,1,1,"H"
"2007-11-24",2007,"Torquay United","Woking","2-0",2,0,5,5,2,2,"H"
"2007-11-24",2007,"Weymouth","York City","1-2",1,2,5,5,3,-1,"A"
"2007-11-26",2007,"Stevenage Borough","Altrincham","2-1",2,1,5,5,3,1,"H"
"2007-11-29",2007,"Woking","Ebbsfleet United","1-0",1,0,5,5,1,1,"H"
"2007-12-01",2007,"Altrincham","Histon","1-2",1,2,5,5,3,-1,"A"
"2007-12-01",2007,"Stafford Rangers","Northwich Victoria","0-0",0,0,5,5,0,0,"D"
"2007-12-01",2007,"York City","Crawley Town","1-1",1,1,5,5,2,0,"D"
"2007-12-02",2007,"Salisbury","Aldershot","0-4",0,4,5,5,4,-4,"A"
"2007-12-04",2007,"Rushden & Diamonds","Histon","2-3",2,3,5,5,5,-1,"A"
"2007-12-06",2007,"Kidderminster Harriers","Cambridge United","1-0",1,0,5,5,1,1,"H"
"2007-12-08",2007,"Aldershot","Stafford Rangers","4-3",4,3,5,5,7,1,"H"
"2007-12-08",2007,"Burton Albion","Forest Green Rovers","1-1",1,1,5,5,2,0,"D"
"2007-12-08",2007,"Droylsden","Rushden & Diamonds","1-4",1,4,5,5,5,-3,"A"
"2007-12-08",2007,"Ebbsfleet United","York City","1-2",1,2,5,5,3,-1,"A"
"2007-12-08",2007,"Halifax Town","Exeter City","0-3",0,3,5,5,3,-3,"A"
"2007-12-08",2007,"Histon","Woking","0-1",0,1,5,5,1,-1,"A"
"2007-12-08",2007,"Northwich Victoria","Oxford United","1-0",1,0,5,5,1,1,"H"
"2007-12-08",2007,"Stevenage Borough","Salisbury","3-1",3,1,5,5,4,2,"H"
"2007-12-12",2007,"Farsley","Torquay United","1-2",1,2,5,5,3,-1,"A"
"2007-12-26",2007,"Altrincham","Northwich Victoria","1-2",1,2,5,5,3,-1,"A"
"2007-12-26",2007,"Cambridge United","Histon","1-0",1,0,5,5,1,1,"H"
"2007-12-26",2007,"Exeter City","Torquay United","4-3",4,3,5,5,7,1,"H"
"2007-12-26",2007,"Farsley","Halifax Town","3-0",3,0,5,5,3,3,"H"
"2007-12-26",2007,"Forest Green Rovers","Kidderminster Harriers","2-2",2,2,5,5,4,0,"D"
"2007-12-26",2007,"Grays Athletic","Ebbsfleet United","1-1",1,1,5,5,2,0,"D"
"2007-12-26",2007,"Oxford United","Crawley Town","1-0",1,0,5,5,1,1,"H"
"2007-12-26",2007,"Rushden & Diamonds","Stevenage Borough","0-0",0,0,5,5,0,0,"D"
"2007-12-26",2007,"Salisbury","Weymouth","1-1",1,1,5,5,2,0,"D"
"2007-12-26",2007,"Stafford Rangers","Burton Albion","0-3",0,3,5,5,3,-3,"A"
"2007-12-26",2007,"Woking","Aldershot","0-1",0,1,5,5,1,-1,"A"
"2007-12-26",2007,"York City","Droylsden","2-1",2,1,5,5,3,1,"H"
"2007-12-29",2007,"Altrincham","Stevenage Borough","1-5",1,5,5,5,6,-4,"A"
"2007-12-29",2007,"Cambridge United","Burton Albion","0-0",0,0,5,5,0,0,"D"
"2007-12-29",2007,"Exeter City","Histon","2-1",2,1,5,5,3,1,"H"
"2007-12-29",2007,"Farsley","Crawley Town","1-5",1,5,5,5,6,-4,"A"
"2007-12-29",2007,"Forest Green Rovers","Droylsden","3-2",3,2,5,5,5,1,"H"
"2007-12-29",2007,"Grays Athletic","Aldershot","2-1",2,1,5,5,3,1,"H"
"2007-12-29",2007,"Oxford United","Kidderminster Harriers","0-0",0,0,5,5,0,0,"D"
"2007-12-29",2007,"Rushden & Diamonds","Northwich Victoria","1-0",1,0,5,5,1,1,"H"
"2007-12-29",2007,"Salisbury","Halifax Town","1-0",1,0,5,5,1,1,"H"
"2007-12-29",2007,"Stafford Rangers","Ebbsfleet United","0-1",0,1,5,5,1,-1,"A"
"2007-12-29",2007,"Woking","Torquay United","0-1",0,1,5,5,1,-1,"A"
"2007-12-29",2007,"York City","Weymouth","2-0",2,0,5,5,2,2,"H"
"2008-01-01",2007,"Aldershot","Woking","2-1",2,1,5,5,3,1,"H"
"2008-01-01",2007,"Burton Albion","Stafford Rangers","2-1",2,1,5,5,3,1,"H"
"2008-01-01",2007,"Crawley Town","Oxford United","2-0",2,0,5,5,2,2,"H"
"2008-01-01",2007,"Droylsden","York City","3-4",3,4,5,5,7,-1,"A"
"2008-01-01",2007,"Ebbsfleet United","Grays Athletic","4-1",4,1,5,5,5,3,"H"
"2008-01-01",2007,"Halifax Town","Farsley","2-0",2,0,5,5,2,2,"H"
"2008-01-01",2007,"Histon","Cambridge United","1-0",1,0,5,5,1,1,"H"
"2008-01-01",2007,"Kidderminster Harriers","Forest Green Rovers","1-0",1,0,5,5,1,1,"H"
"2008-01-01",2007,"Northwich Victoria","Altrincham","1-2",1,2,5,5,3,-1,"A"
"2008-01-01",2007,"Stevenage Borough","Rushden & Diamonds","2-1",2,1,5,5,3,1,"H"
"2008-01-01",2007,"Torquay United","Exeter City","1-0",1,0,5,5,1,1,"H"
"2008-01-01",2007,"Weymouth","Salisbury","0-3",0,3,5,5,3,-3,"A"
"2008-01-05",2007,"Droylsden","Crawley Town","1-2",1,2,5,5,3,-1,"A"
"2008-01-05",2007,"Ebbsfleet United","Weymouth","4-1",4,1,5,5,5,3,"H"
"2008-01-05",2007,"Farsley","Histon","1-3",1,3,5,5,4,-2,"A"
"2008-01-05",2007,"Forest Green Rovers","Grays Athletic","1-2",1,2,5,5,3,-1,"A"
"2008-01-05",2007,"Northwich Victoria","Aldershot","1-2",1,2,5,5,3,-1,"A"
"2008-01-05",2007,"Oxford United","Altrincham","4-0",4,0,5,5,4,4,"H"
"2008-01-05",2007,"Rushden & Diamonds","Salisbury","0-0",0,0,5,5,0,0,"D"
"2008-01-05",2007,"Stafford Rangers","Stevenage Borough","1-2",1,2,5,5,3,-1,"A"
"2008-01-05",2007,"Woking","Halifax Town","1-0",1,0,5,5,1,1,"H"
"2008-01-05",2007,"York City","Kidderminster Harriers","2-2",2,2,5,5,4,0,"D"
"2008-01-07",2007,"Torquay United","Burton Albion","1-2",1,2,5,5,3,-1,"A"
"2008-01-08",2007,"Altrincham","Kidderminster Harriers","2-1",2,1,5,5,3,1,"H"
"2008-01-08",2007,"Oxford United","Weymouth","0-1",0,1,5,5,1,-1,"A"
"2008-01-12",2007,"Salisbury","Oxford United","3-1",3,1,5,5,4,2,"H"
"2008-01-19",2007,"Aldershot","Forest Green Rovers","0-1",0,1,5,5,1,-1,"A"
"2008-01-19",2007,"Altrincham","York City","2-2",2,2,5,5,4,0,"D"
"2008-01-19",2007,"Burton Albion","Northwich Victoria","4-1",4,1,5,5,5,3,"H"
"2008-01-19",2007,"Crawley Town","Rushden & Diamonds","4-1",4,1,5,5,5,3,"H"
"2008-01-19",2007,"Grays Athletic","Cambridge United","2-1",2,1,5,5,3,1,"H"
"2008-01-19",2007,"Kidderminster Harriers","Farsley","2-1",2,1,5,5,3,1,"H"
"2008-01-19",2007,"Salisbury","Torquay United","0-0",0,0,5,5,0,0,"D"
"2008-01-19",2007,"Stevenage Borough","Droylsden","5-0",5,0,5,5,5,5,"H"
"2008-01-19",2007,"Weymouth","Woking","0-1",0,1,5,5,1,-1,"A"
"2008-01-20",2007,"Exeter City","Oxford United","2-0",2,0,5,5,2,2,"H"
"2008-01-22",2007,"Cambridge United","Droylsden","5-0",5,0,5,5,5,5,"H"
"2008-01-24",2007,"Farsley","Stevenage Borough","0-0",0,0,5,5,0,0,"D"
"2008-01-26",2007,"Cambridge United","Altrincham","2-1",2,1,5,5,3,1,"H"
"2008-01-26",2007,"Droylsden","Kidderminster Harriers","1-0",1,0,5,5,1,1,"H"
"2008-01-26",2007,"Ebbsfleet United","Burton Albion","2-1",2,1,5,5,3,1,"H"
"2008-01-26",2007,"Forest Green Rovers","Exeter City","1-1",1,1,5,5,2,0,"D"
"2008-01-26",2007,"Northwich Victoria","Halifax Town","2-2",2,2,5,5,4,0,"D"
"2008-01-26",2007,"Oxford United","Grays Athletic","0-0",0,0,5,5,0,0,"D"
"2008-01-26",2007,"Rushden & Diamonds","Weymouth","3-2",3,2,5,5,5,1,"H"
"2008-01-26",2007,"Stafford Rangers","Salisbury","1-5",1,5,5,5,6,-4,"A"
"2008-01-26",2007,"Woking","Crawley Town","1-1",1,1,5,5,2,0,"D"
"2008-01-26",2007,"York City","Aldershot","2-0",2,0,5,5,2,2,"H"
"2008-01-28",2007,"Torquay United","Histon","1-0",1,0,5,5,1,1,"H"
"2008-01-29",2007,"Aldershot","Oxford United","1-0",1,0,5,5,1,1,"H"
"2008-01-29",2007,"Burton Albion","Rushden & Diamonds","2-1",2,1,5,5,3,1,"H"
"2008-01-29",2007,"Cambridge United","Exeter City","0-1",0,1,5,5,1,-1,"A"
"2008-01-31",2007,"Altrincham","Woking","2-2",2,2,5,5,4,0,"D"
"2008-02-02",2007,"Exeter City","Stevenage Borough","4-0",4,0,5,5,4,4,"H"
"2008-02-02",2007,"Kidderminster Harriers","Northwich Victoria","0-0",0,0,5,5,0,0,"D"
"2008-02-02",2007,"Salisbury","Forest Green Rovers","0-0",0,0,5,5,0,0,"D"
"2008-02-09",2007,"Cambridge United","Stevenage Borough","2-1",2,1,5,5,3,1,"H"
"2008-02-09",2007,"Droylsden","Altrincham","0-2",0,2,5,5,2,-2,"A"
"2008-02-09",2007,"Ebbsfleet United","Exeter City","1-1",1,1,5,5,2,0,"D"
"2008-02-09",2007,"Farsley","Aldershot","1-3",1,3,5,5,4,-2,"A"
"2008-02-09",2007,"Northwich Victoria","Salisbury","0-1",0,1,5,5,1,-1,"A"
"2008-02-09",2007,"Oxford United","Histon","3-0",3,0,5,5,3,3,"H"
"2008-02-09",2007,"Rushden & Diamonds","Halifax Town","2-2",2,2,5,5,4,0,"D"
"2008-02-09",2007,"Stafford Rangers","Weymouth","2-1",2,1,5,5,3,1,"H"
"2008-02-09",2007,"Torquay United","Kidderminster Harriers","1-0",1,0,5,5,1,1,"H"
"2008-02-09",2007,"Woking","Burton Albion","2-1",2,1,5,5,3,1,"H"
"2008-02-09",2007,"York City","Grays Athletic","2-0",2,0,5,5,2,2,"H"
"2008-02-10",2007,"Forest Green Rovers","Crawley Town","1-0",1,0,5,5,1,1,"H"
"2008-02-12",2007,"Aldershot","Cambridge United","0-0",0,0,5,5,0,0,"D"
"2008-02-12",2007,"Altrincham","Farsley","0-0",0,0,5,5,0,0,"D"
"2008-02-12",2007,"Burton Albion","Droylsden","3-0",3,0,5,5,3,3,"H"
"2008-02-12",2007,"Exeter City","Woking","2-2",2,2,5,5,4,0,"D"
"2008-02-12",2007,"Halifax Town","York City","2-2",2,2,5,5,4,0,"D"
"2008-02-12",2007,"Weymouth","Torquay United","0-0",0,0,5,5,0,0,"D"
"2008-02-13",2007,"Stevenage Borough","Forest Green Rovers","0-0",0,0,5,5,0,0,"D"
"2008-02-14",2007,"Crawley Town","Ebbsfleet United","1-2",1,2,5,5,3,-1,"A"
"2008-02-16",2007,"Farsley","Woking","3-0",3,0,5,5,3,3,"H"
"2008-02-16",2007,"Forest Green Rovers","Stafford Rangers","1-2",1,2,5,5,3,-1,"A"
"2008-02-16",2007,"Grays Athletic","Exeter City","0-2",0,2,5,5,2,-2,"A"
"2008-02-16",2007,"Halifax Town","Cambridge United","1-2",1,2,5,5,3,-1,"A"
"2008-02-16",2007,"Histon","York City","3-1",3,1,5,5,4,2,"H"
"2008-02-16",2007,"Oxford United","Droylsden","1-0",1,0,5,5,1,1,"H"
"2008-02-16",2007,"Rushden & Diamonds","Altrincham","1-0",1,0,5,5,1,1,"H"
"2008-02-16",2007,"Salisbury","Burton Albion","2-0",2,0,5,5,2,2,"H"
"2008-02-16",2007,"Torquay United","Ebbsfleet United","3-1",3,1,5,5,4,2,"H"
"2008-02-17",2007,"Aldershot","Stevenage Borough","3-1",3,1,5,5,4,2,"H"
"2008-02-23",2007,"Cambridge United","Forest Green Rovers","2-0",2,0,5,5,2,2,"H"
"2008-02-23",2007,"Exeter City","Farsley","2-1",2,1,5,5,3,1,"H"
"2008-02-23",2007,"Halifax Town","Stafford Rangers","0-0",0,0,5,5,0,0,"D"
"2008-02-23",2007,"Kidderminster Harriers","Salisbury","1-2",1,2,5,5,3,-1,"A"
"2008-02-23",2007,"Stevenage Borough","Grays Athletic","0-0",0,0,5,5,0,0,"D"
"2008-02-23",2007,"Weymouth","Histon","0-1",0,1,5,5,1,-1,"A"
"2008-02-23",2007,"Woking","Northwich Victoria","2-3",2,3,5,5,5,-1,"A"
"2008-02-26",2007,"Histon","Stafford Rangers","3-3",3,3,5,5,6,0,"D"
"2008-02-26",2007,"Torquay United","Altrincham","1-1",1,1,5,5,2,0,"D"
"2008-03-01",2007,"Aldershot","Kidderminster Harriers","2-1",2,1,5,5,3,1,"H"
"2008-03-01",2007,"Burton Albion","Histon","1-3",1,3,5,5,4,-2,"A"
"2008-03-01",2007,"Cambridge United","York City","2-0",2,0,5,5,2,2,"H"
"2008-03-01",2007,"Exeter City","Altrincham","2-1",2,1,5,5,3,1,"H"
"2008-03-01",2007,"Forest Green Rovers","Oxford United","0-0",0,0,5,5,0,0,"D"
"2008-03-01",2007,"Grays Athletic","Torquay United","2-0",2,0,5,5,2,2,"H"
"2008-03-01",2007,"Halifax Town","Weymouth","2-1",2,1,5,5,3,1,"H"
"2008-03-01",2007,"Northwich Victoria","Ebbsfleet United","3-3",3,3,5,5,6,0,"D"
"2008-03-01",2007,"Rushden & Diamonds","Woking","2-1",2,1,5,5,3,1,"H"
"2008-03-01",2007,"Salisbury","Droylsden","3-1",3,1,5,5,4,2,"H"
"2008-03-01",2007,"Stafford Rangers","Farsley","0-2",0,2,5,5,2,-2,"A"
"2008-03-01",2007,"Stevenage Borough","Crawley Town","3-1",3,1,5,5,4,2,"H"
"2008-03-03",2007,"Torquay United","Aldershot","1-2",1,2,5,5,3,-1,"A"
"2008-03-04",2007,"Altrincham","Halifax Town","3-3",3,3,5,5,6,0,"D"
"2008-03-04",2007,"Crawley Town","Exeter City","2-2",2,2,5,5,4,0,"D"
"2008-03-04",2007,"Droylsden","Northwich Victoria","1-3",1,3,5,5,4,-2,"A"
"2008-03-04",2007,"Ebbsfleet United","Salisbury","2-1",2,1,5,5,3,1,"H"
"2008-03-04",2007,"Farsley","Rushden & Diamonds","0-1",0,1,5,5,1,-1,"A"
"2008-03-04",2007,"Histon","Stevenage Borough","1-4",1,4,5,5,5,-3,"A"
"2008-03-04",2007,"Kidderminster Harriers","Stafford Rangers","6-0",6,0,5,5,6,6,"H"
"2008-03-04",2007,"Oxford United","Cambridge United","1-2",1,2,5,5,3,-1,"A"
"2008-03-04",2007,"Weymouth","Forest Green Rovers","0-6",0,6,5,5,6,-6,"A"
"2008-03-04",2007,"York City","Burton Albion","0-0",0,0,5,5,0,0,"D"
"2008-03-08",2007,"Altrincham","Forest Green Rovers","1-0",1,0,5,5,1,1,"H"
"2008-03-08",2007,"Crawley Town","Salisbury","1-1",1,1,5,5,2,0,"D"
"2008-03-08",2007,"Farsley","Cambridge United","2-1",2,1,5,5,3,1,"H"
"2008-03-08",2007,"Histon","Halifax Town","1-3",1,3,5,5,4,-2,"A"
"2008-03-08",2007,"Kidderminster Harriers","Grays Athletic","1-0",1,0,5,5,1,1,"H"
"2008-03-08",2007,"Oxford United","Burton Albion","0-3",0,3,5,5,3,-3,"A"
"2008-03-08",2007,"Weymouth","Stevenage Borough","1-0",1,0,5,5,1,1,"H"
"2008-03-08",2007,"Woking","Stafford Rangers","2-2",2,2,5,5,4,0,"D"
"2008-03-10",2007,"York City","Exeter City","3-2",3,2,5,5,5,1,"H"
"2008-03-11",2007,"Aldershot","Histon","3-1",3,1,5,5,4,2,"H"
"2008-03-11",2007,"Altrincham","Crawley Town","2-3",2,3,5,5,5,-1,"A"
"2008-03-11",2007,"Ebbsfleet United","Rushden & Diamonds","0-3",0,3,5,5,3,-3,"A"
"2008-03-11",2007,"Grays Athletic","Burton Albion","0-0",0,0,5,5,0,0,"D"
"2008-03-11",2007,"Halifax Town","Torquay United","3-2",3,2,5,5,5,1,"H"
"2008-03-11",2007,"Weymouth","Farsley","0-0",0,0,5,5,0,0,"D"
"2008-03-13",2007,"Stevenage Borough","Kidderminster Harriers","2-1",2,1,5,5,3,1,"H"
"2008-03-15",2007,"Cambridge United","Woking","1-0",1,0,5,5,1,1,"H"
"2008-03-15",2007,"Forest Green Rovers","Halifax Town","2-0",2,0,5,5,2,2,"H"
"2008-03-15",2007,"Grays Athletic","Altrincham","1-0",1,0,5,5,1,1,"H"
"2008-03-15",2007,"Histon","Rushden & Diamonds","2-1",2,1,5,5,3,1,"H"
"2008-03-15",2007,"Northwich Victoria","Crawley Town","2-0",2,0,5,5,2,2,"H"
"2008-03-15",2007,"Salisbury","Farsley","1-1",1,1,5,5,2,0,"D"
"2008-03-15",2007,"Stafford Rangers","Oxford United","0-1",0,1,5,5,1,-1,"A"
"2008-03-16",2007,"Burton Albion","Weymouth","2-1",2,1,5,5,3,1,"H"
"2008-03-18",2007,"Crawley Town","Cambridge United","2-1",2,1,5,5,3,1,"H"
"2008-03-18",2007,"Forest Green Rovers","York City","1-2",1,2,5,5,3,-1,"A"
"2008-03-18",2007,"Histon","Ebbsfleet United","3-2",3,2,5,5,5,1,"H"
"2008-03-18",2007,"Northwich Victoria","Weymouth","2-2",2,2,5,5,4,0,"D"
"2008-03-20",2007,"Grays Athletic","Droylsden","3-1",3,1,5,5,4,2,"H"
"2008-03-21",2007,"Forest Green Rovers","Woking","2-1",2,1,5,5,3,1,"H"
"2008-03-21",2007,"Salisbury","Histon","3-3",3,3,5,5,6,0,"D"
"2008-03-21",2007,"Stevenage Borough","Ebbsfleet United","3-1",3,1,5,5,4,2,"H"
"2008-03-22",2007,"Aldershot","Altrincham","2-1",2,1,5,5,3,1,"H"
"2008-03-22",2007,"Burton Albion","Crawley Town","1-0",1,0,5,5,1,1,"H"
"2008-03-22",2007,"Cambridge United","Weymouth","0-0",0,0,5,5,0,0,"D"
"2008-03-22",2007,"Exeter City","Kidderminster Harriers","1-0",1,0,5,5,1,1,"H"
"2008-03-22",2007,"Halifax Town","Oxford United","0-3",0,3,5,5,3,-3,"A"
"2008-03-22",2007,"Northwich Victoria","Farsley","4-0",4,0,5,5,4,4,"H"
"2008-03-22",2007,"Rushden & Diamonds","York City","1-1",1,1,5,5,2,0,"D"
"2008-03-22",2007,"Stafford Rangers","Torquay United","0-2",0,2,5,5,2,-2,"A"
"2008-03-24",2007,"Altrincham","Stafford Rangers","2-0",2,0,5,5,2,2,"H"
"2008-03-24",2007,"Crawley Town","Aldershot","0-1",0,1,5,5,1,-1,"A"
"2008-03-24",2007,"Droylsden","Halifax Town","2-0",2,0,5,5,2,2,"H"
"2008-03-24",2007,"Ebbsfleet United","Cambridge United","2-1",2,1,5,5,3,1,"H"
"2008-03-24",2007,"Farsley","Burton Albion","0-1",0,1,5,5,1,-1,"A"
"2008-03-24",2007,"Histon","Grays Athletic","2-2",2,2,5,5,4,0,"D"
"2008-03-24",2007,"Kidderminster Harriers","Rushden & Diamonds","2-0",2,0,5,5,2,2,"H"
"2008-03-24",2007,"Oxford United","Stevenage Borough","2-1",2,1,5,5,3,1,"H"
"2008-03-24",2007,"Torquay United","Forest Green Rovers","1-0",1,0,5,5,1,1,"H"
"2008-03-24",2007,"Weymouth","Exeter City","3-1",3,1,5,5,4,2,"H"
"2008-03-24",2007,"Woking","Salisbury","3-2",3,2,5,5,5,1,"H"
"2008-03-25",2007,"York City","Northwich Victoria","1-1",1,1,5,5,2,0,"D"
"2008-03-27",2007,"Crawley Town","Kidderminster Harriers","0-4",0,4,5,5,4,-4,"A"
"2008-03-27",2007,"Droylsden","Aldershot","2-2",2,2,5,5,4,0,"D"
"2008-03-27",2007,"Salisbury","Stevenage Borough","1-0",1,0,5,5,1,1,"H"
"2008-03-29",2007,"Altrincham","Torquay United","1-1",1,1,5,5,2,0,"D"
"2008-03-29",2007,"Cambridge United","Kidderminster Harriers","0-3",0,3,5,5,3,-3,"A"
"2008-03-29",2007,"Exeter City","Halifax Town","1-0",1,0,5,5,1,1,"H"
"2008-03-29",2007,"Farsley","Weymouth","4-2",4,2,5,5,6,2,"H"
"2008-03-29",2007,"Grays Athletic","Crawley Town","2-1",2,1,5,5,3,1,"H"
"2008-03-29",2007,"Oxford United","Northwich Victoria","0-1",0,1,5,5,1,-1,"A"
"2008-03-29",2007,"Rushden & Diamonds","Droylsden","0-0",0,0,5,5,0,0,"D"
"2008-03-29",2007,"Stafford Rangers","Aldershot","1-2",1,2,5,5,3,-1,"A"
"2008-03-29",2007,"Woking","Histon","3-3",3,3,5,5,6,0,"D"
"2008-03-29",2007,"York City","Ebbsfleet United","0-1",0,1,5,5,1,-1,"A"
"2008-03-31",2007,"Forest Green Rovers","Burton Albion","3-1",3,1,5,5,4,2,"H"
"2008-04-01",2007,"Droylsden","Torquay United","1-2",1,2,5,5,3,-1,"A"
"2008-04-01",2007,"Grays Athletic","Stafford Rangers","5-1",5,1,5,5,6,4,"H"
"2008-04-01",2007,"Histon","Northwich Victoria","1-1",1,1,5,5,2,0,"D"
"2008-04-01",2007,"Kidderminster Harriers","Ebbsfleet United","2-1",2,1,5,5,3,1,"H"
"2008-04-01",2007,"Stevenage Borough","York City","3-2",3,2,5,5,5,1,"H"
"2008-04-03",2007,"Exeter City","Droylsden","1-1",1,1,5,5,2,0,"D"
"2008-04-05",2007,"Aldershot","Salisbury","2-1",2,1,5,5,3,1,"H"
"2008-04-05",2007,"Burton Albion","Grays Athletic","2-3",2,3,5,5,5,-1,"A"
"2008-04-05",2007,"Crawley Town","York City","6-1",6,1,5,5,7,5,"H"
"2008-04-05",2007,"Droylsden","Cambridge United","0-2",0,2,5,5,2,-2,"A"
"2008-04-05",2007,"Ebbsfleet United","Woking","1-1",1,1,5,5,2,0,"D"
"2008-04-05",2007,"Halifax Town","Forest Green Rovers","1-1",1,1,5,5,2,0,"D"
"2008-04-05",2007,"Kidderminster Harriers","Altrincham","1-1",1,1,5,5,2,0,"D"
"2008-04-05",2007,"Northwich Victoria","Stafford Rangers","4-3",4,3,5,5,7,1,"H"
"2008-04-05",2007,"Stevenage Borough","Exeter City","0-1",0,1,5,5,1,-1,"A"
"2008-04-05",2007,"Torquay United","Farsley","0-1",0,1,5,5,1,-1,"A"
"2008-04-05",2007,"Weymouth","Oxford United","0-1",0,1,5,5,1,-1,"A"
"2008-04-08",2007,"Burton Albion","Altrincham","2-1",2,1,5,5,3,1,"H"
"2008-04-08",2007,"Ebbsfleet United","Aldershot","2-2",2,2,5,5,4,0,"D"
"2008-04-08",2007,"Farsley","Droylsden","1-2",1,2,5,5,3,-1,"A"
"2008-04-08",2007,"Halifax Town","Kidderminster Harriers","1-6",1,6,5,5,7,-5,"A"
"2008-04-08",2007,"Histon","Crawley Town","3-0",3,0,5,5,3,3,"H"
"2008-04-08",2007,"Northwich Victoria","Forest Green Rovers","1-1",1,1,5,5,2,0,"D"
"2008-04-08",2007,"Rushden & Diamonds","Cambridge United","1-2",1,2,5,5,3,-1,"A"
"2008-04-08",2007,"Salisbury","Exeter City","2-0",2,0,5,5,2,2,"H"
"2008-04-08",2007,"Stafford Rangers","York City","0-4",0,4,5,5,4,-4,"A"
"2008-04-08",2007,"Torquay United","Oxford United","3-2",3,2,5,5,5,1,"H"
"2008-04-08",2007,"Weymouth","Grays Athletic","1-1",1,1,5,5,2,0,"D"
"2008-04-08",2007,"Woking","Stevenage Borough","0-2",0,2,5,5,2,-2,"A"
"2008-04-10",2007,"Halifax Town","Ebbsfleet United","1-0",1,0,5,5,1,1,"H"
"2008-04-12",2007,"Aldershot","Burton Albion","1-0",1,0,5,5,1,1,"H"
"2008-04-12",2007,"Altrincham","Salisbury","3-1",3,1,5,5,4,2,"H"
"2008-04-12",2007,"Cambridge United","Stafford Rangers","1-2",1,2,5,5,3,-1,"A"
"2008-04-12",2007,"Crawley Town","Weymouth","1-1",1,1,5,5,2,0,"D"
"2008-04-12",2007,"Exeter City","Northwich Victoria","2-1",2,1,5,5,3,1,"H"
"2008-04-12",2007,"Forest Green Rovers","Rushden & Diamonds","0-1",0,1,5,5,1,-1,"A"
"2008-04-12",2007,"Grays Athletic","Halifax Town","3-3",3,3,5,5,6,0,"D"
"2008-04-12",2007,"Kidderminster Harriers","Histon","1-1",1,1,5,5,2,0,"D"
"2008-04-12",2007,"Oxford United","Farsley","5-1",5,1,5,5,6,4,"H"
"2008-04-12",2007,"Stevenage Borough","Torquay United","1-3",1,3,5,5,4,-2,"A"
"2008-04-12",2007,"York City","Woking","2-3",2,3,5,5,5,-1,"A"
"2008-04-15",2007,"Burton Albion","Halifax Town","2-1",2,1,5,5,3,1,"H"
"2008-04-15",2007,"Crawley Town","Grays Athletic","2-1",2,1,5,5,3,1,"H"
"2008-04-15",2007,"Ebbsfleet United","Farsley","3-1",3,1,5,5,4,2,"H"
"2008-04-15",2007,"Exeter City","Aldershot","1-1",1,1,5,5,2,0,"D"
"2008-04-15",2007,"Stafford Rangers","Rushden & Diamonds","0-1",0,1,5,5,1,-1,"A"
"2008-04-15",2007,"Torquay United","Northwich Victoria","1-0",1,0,5,5,1,1,"H"
"2008-04-15",2007,"Weymouth","Droylsden","2-1",2,1,5,5,3,1,"H"
"2008-04-15",2007,"York City","Oxford United","0-1",0,1,5,5,1,-1,"A"
"2008-04-17",2007,"Droylsden","Ebbsfleet United","1-1",1,1,5,5,2,0,"D"
"2008-04-17",2007,"Rushden & Diamonds","Torquay United","2-1",2,1,5,5,3,1,"H"
"2008-04-18",2007,"Burton Albion","Stevenage Borough","3-0",3,0,5,5,3,3,"H"
"2008-04-19",2007,"Ebbsfleet United","Altrincham","2-0",2,0,5,5,2,2,"H"
"2008-04-19",2007,"Farsley","Forest Green Rovers","0-2",0,2,5,5,2,-2,"A"
"2008-04-19",2007,"Halifax Town","Aldershot","0-0",0,0,5,5,0,0,"D"
"2008-04-19",2007,"Histon","Droylsden","2-0",2,0,5,5,2,2,"H"
"2008-04-19",2007,"Northwich Victoria","Grays Athletic","1-0",1,0,5,5,1,1,"H"
"2008-04-19",2007,"Rushden & Diamonds","Exeter City","0-2",0,2,5,5,2,-2,"A"
"2008-04-19",2007,"Salisbury","Cambridge United","0-2",0,2,5,5,2,-2,"A"
"2008-04-19",2007,"Stafford Rangers","Crawley Town","1-3",1,3,5,5,4,-2,"A"
"2008-04-19",2007,"Torquay United","York City","0-0",0,0,5,5,0,0,"D"
"2008-04-19",2007,"Weymouth","Kidderminster Harriers","2-1",2,1,5,5,3,1,"H"
"2008-04-19",2007,"Woking","Oxford United","1-2",1,2,5,5,3,-1,"A"
"2008-04-22",2007,"Aldershot","Weymouth","0-0",0,0,5,5,0,0,"D"
"2008-04-22",2007,"Cambridge United","Torquay United","2-0",2,0,5,5,2,2,"H"
"2008-04-22",2007,"Crawley Town","Halifax Town","0-4",0,4,5,5,4,-4,"A"
"2008-04-22",2007,"Droylsden","Woking","1-1",1,1,5,5,2,0,"D"
"2008-04-22",2007,"Exeter City","Stafford Rangers","4-1",4,1,5,5,5,3,"H"
"2008-04-22",2007,"Forest Green Rovers","Ebbsfleet United","2-2",2,2,5,5,4,0,"D"
"2008-04-22",2007,"Grays Athletic","Salisbury","1-1",1,1,5,5,2,0,"D"
"2008-04-22",2007,"Kidderminster Harriers","Burton Albion","4-1",4,1,5,5,5,3,"H"
"2008-04-22",2007,"Oxford United","Rushden & Diamonds","1-0",1,0,5,5,1,1,"H"
"2008-04-22",2007,"Stevenage Borough","Northwich Victoria","1-2",1,2,5,5,3,-1,"A"
"2008-04-22",2007,"York City","Farsley","4-1",4,1,5,5,5,3,"H"
"2008-04-24",2007,"Grays Athletic","Rushden & Diamonds","3-0",3,0,5,5,3,3,"H"
"2008-04-26",2007,"Burton Albion","Exeter City","4-4",4,4,5,5,8,0,"D"
"2008-04-26",2007,"Ebbsfleet United","Oxford United","1-3",1,3,5,5,4,-2,"A"
"2008-04-26",2007,"Farsley","Grays Athletic","1-3",1,3,5,5,4,-2,"A"
"2008-04-26",2007,"Halifax Town","Stevenage Borough","1-2",1,2,5,5,3,-1,"A"
"2008-04-26",2007,"Histon","Forest Green Rovers","2-2",2,2,5,5,4,0,"D"
"2008-04-26",2007,"Northwich Victoria","Cambridge United","0-2",0,2,5,5,2,-2,"A"
"2008-04-26",2007,"Rushden & Diamonds","Aldershot","1-1",1,1,5,5,2,0,"D"
"2008-04-26",2007,"Salisbury","York City","3-0",3,0,5,5,3,3,"H"
"2008-04-26",2007,"Stafford Rangers","Droylsden","2-1",2,1,5,5,3,1,"H"
"2008-04-26",2007,"Torquay United","Crawley Town","1-2",1,2,5,5,3,-1,"A"
"2008-04-26",2007,"Weymouth","Altrincham","2-2",2,2,5,5,4,0,"D"
"2008-04-26",2007,"Woking","Kidderminster Harriers","3-0",3,0,5,5,3,3,"H"
"2008-08-08",2008,"Barrow","Oxford United","3-0",3,0,5,5,3,3,"H"
"2008-08-09",2008,"Crawley Town","York City","0-1",0,1,5,5,1,-1,"A"
"2008-08-09",2008,"Eastbourne Borough","Rushden & Diamonds","0-1",0,1,5,5,1,-1,"A"
"2008-08-09",2008,"Ebbsfleet United","Mansfield Town","2-2",2,2,5,5,4,0,"D"
"2008-08-09",2008,"Histon","Torquay United","1-1",1,1,5,5,2,0,"D"
"2008-08-09",2008,"Kettering Town","Forest Green Rovers","1-1",1,1,5,5,2,0,"D"
"2008-08-09",2008,"Kidderminster Harriers","Lewes","1-1",1,1,5,5,2,0,"D"
"2008-08-09",2008,"Northwich Victoria","Cambridge United","0-1",0,1,5,5,1,-1,"A"
"2008-08-09",2008,"Salisbury","Burton Albion","0-1",0,1,5,5,1,-1,"A"
"2008-08-09",2008,"Weymouth","Grays Athletic","3-1",3,1,5,5,4,2,"H"
"2008-08-09",2008,"Woking","Altrincham","1-2",1,2,5,5,3,-1,"A"
"2008-08-09",2008,"Wrexham","Stevenage Borough","5-0",5,0,5,5,5,5,"H"
"2008-08-12",2008,"Altrincham","Barrow","3-4",3,4,5,5,7,-1,"A"
"2008-08-12",2008,"Burton Albion","Northwich Victoria","1-1",1,1,5,5,2,0,"D"
"2008-08-12",2008,"Cambridge United","Kidderminster Harriers","2-1",2,1,5,5,3,1,"H"
"2008-08-12",2008,"Forest Green Rovers","Salisbury","1-2",1,2,5,5,3,-1,"A"
"2008-08-12",2008,"Grays Athletic","Kettering Town","1-1",1,1,5,5,2,0,"D"
"2008-08-12",2008,"Lewes","Crawley Town","0-3",0,3,5,5,3,-3,"A"
"2008-08-12",2008,"Mansfield Town","Histon","1-0",1,0,5,5,1,1,"H"
"2008-08-12",2008,"Oxford United","Weymouth","0-1",0,1,5,5,1,-1,"A"
"2008-08-12",2008,"Rushden & Diamonds","Ebbsfleet United","2-0",2,0,5,5,2,2,"H"
"2008-08-12",2008,"Stevenage Borough","Eastbourne Borough","1-3",1,3,5,5,4,-2,"A"
"2008-08-12",2008,"Torquay United","Woking","2-1",2,1,5,5,3,1,"H"
"2008-08-14",2008,"York City","Wrexham","1-0",1,0,5,5,1,1,"H"
"2008-08-16",2008,"Altrincham","Kettering Town","1-1",1,1,5,5,2,0,"D"
"2008-08-16",2008,"Burton Albion","Woking","3-2",3,2,5,5,5,1,"H"
"2008-08-16",2008,"Cambridge United","Barrow","2-1",2,1,5,5,3,1,"H"
"2008-08-16",2008,"Forest Green Rovers","Crawley Town","1-0",1,0,5,5,1,1,"H"
"2008-08-16",2008,"Grays Athletic","Northwich Victoria","2-1",2,1,5,5,3,1,"H"
"2008-08-16",2008,"Lewes","Salisbury","1-4",1,4,5,5,5,-3,"A"
"2008-08-16",2008,"Mansfield Town","Kidderminster Harriers","4-2",4,2,5,5,6,2,"H"
"2008-08-16",2008,"Oxford United","Eastbourne Borough","6-3",6,3,5,5,9,3,"H"
"2008-08-16",2008,"Stevenage Borough","Weymouth","1-1",1,1,5,5,2,0,"D"
"2008-08-16",2008,"York City","Histon","1-1",1,1,5,5,2,0,"D"
"2008-08-17",2008,"Rushden & Diamonds","Wrexham","1-1",1,1,5,5,2,0,"D"
"2008-08-18",2008,"Torquay United","Ebbsfleet United","0-2",0,2,5,5,2,-2,"A"
"2008-08-21",2008,"Wrexham","Oxford United","2-0",2,0,5,5,2,2,"H"
"2008-08-23",2008,"Barrow","Mansfield Town","2-1",2,1,5,5,3,1,"H"
"2008-08-23",2008,"Crawley Town","Torquay United","3-1",3,1,5,5,4,2,"H"
"2008-08-23",2008,"Eastbourne Borough","Cambridge United","0-3",0,3,5,5,3,-3,"A"
"2008-08-23",2008,"Ebbsfleet United","Stevenage Borough","4-0",4,0,5,5,4,4,"H"
"2008-08-23",2008,"Histon","Burton Albion","4-3",4,3,5,5,7,1,"H"
"2008-08-23",2008,"Kettering Town","Rushden & Diamonds","1-1",1,1,5,5,2,0,"D"
"2008-08-23",2008,"Kidderminster Harriers","Altrincham","4-0",4,0,5,5,4,4,"H"
"2008-08-23",2008,"Northwich Victoria","York City","2-2",2,2,5,5,4,0,"D"
"2008-08-23",2008,"Salisbury","Grays Athletic","1-0",1,0,5,5,1,1,"H"
"2008-08-23",2008,"Weymouth","Lewes","2-0",2,0,5,5,2,2,"H"
"2008-08-23",2008,"Woking","Forest Green Rovers","0-1",0,1,5,5,1,-1,"A"
"2008-08-25",2008,"Altrincham","Wrexham","1-1",1,1,5,5,2,0,"D"
"2008-08-25",2008,"Burton Albion","Kidderminster Harriers","2-2",2,2,5,5,4,0,"D"
"2008-08-25",2008,"Cambridge United","Kettering Town","0-2",0,2,5,5,2,-2,"A"
"2008-08-25",2008,"Forest Green Rovers","Weymouth","4-1",4,1,5,5,5,3,"H"
"2008-08-25",2008,"Grays Athletic","Eastbourne Borough","0-1",0,1,5,5,1,-1,"A"
"2008-08-25",2008,"Lewes","Ebbsfleet United","0-0",0,0,5,5,0,0,"D"
"2008-08-25",2008,"Mansfield Town","Northwich Victoria","3-2",3,2,5,5,5,1,"H"
"2008-08-25",2008,"Oxford United","Woking","0-0",0,0,5,5,0,0,"D"
"2008-08-25",2008,"Rushden & Diamonds","Histon","1-2",1,2,5,5,3,-1,"A"
"2008-08-25",2008,"Stevenage Borough","Crawley Town","1-1",1,1,5,5,2,0,"D"
"2008-08-25",2008,"Torquay United","Salisbury","0-1",0,1,5,5,1,-1,"A"
"2008-08-25",2008,"York City","Barrow","1-1",1,1,5,5,2,0,"D"
"2008-08-28",2008,"Torquay United","York City","1-1",1,1,5,5,2,0,"D"
"2008-08-30",2008,"Barrow","Stevenage Borough","1-3",1,3,5,5,4,-2,"A"
"2008-08-30",2008,"Burton Albion","Lewes","5-2",5,2,5,5,7,3,"H"
"2008-08-30",2008,"Crawley Town","Northwich Victoria","5-2",5,2,5,5,7,3,"H"
"2008-08-30",2008,"Eastbourne Borough","Altrincham","1-0",1,0,5,5,1,1,"H"
"2008-08-30",2008,"Ebbsfleet United","Oxford United","1-1",1,1,5,5,2,0,"D"
"2008-08-30",2008,"Histon","Forest Green Rovers","0-1",0,1,5,5,1,-1,"A"
"2008-08-30",2008,"Kettering Town","Woking","1-0",1,0,5,5,1,1,"H"
"2008-08-30",2008,"Kidderminster Harriers","Rushden & Diamonds","2-1",2,1,5,5,3,1,"H"
"2008-08-30",2008,"Mansfield Town","Grays Athletic","1-0",1,0,5,5,1,1,"H"
"2008-08-30",2008,"Salisbury","Wrexham","1-4",1,4,5,5,5,-3,"A"
"2008-08-30",2008,"Weymouth","Cambridge United","2-2",2,2,5,5,4,0,"D"
"2008-09-02",2008,"Barrow","Rushden & Diamonds","1-1",1,1,5,5,2,0,"D"
"2008-09-02",2008,"Crawley Town","Grays Athletic","2-1",2,1,5,5,3,1,"H"
"2008-09-02",2008,"Eastbourne Borough","Forest Green Rovers","1-0",1,0,5,5,1,1,"H"
"2008-09-02",2008,"Ebbsfleet United","Cambridge United","1-1",1,1,5,5,2,0,"D"
"2008-09-02",2008,"Histon","Altrincham","1-0",1,0,5,5,1,1,"H"
"2008-09-02",2008,"Kettering Town","Stevenage Borough","1-0",1,0,5,5,1,1,"H"
"2008-09-02",2008,"Northwich Victoria","Oxford United","1-2",1,2,5,5,3,-1,"A"
"2008-09-02",2008,"Salisbury","Weymouth","1-0",1,0,5,5,1,1,"H"
"2008-09-02",2008,"Woking","Lewes","1-1",1,1,5,5,2,0,"D"
"2008-09-02",2008,"Wrexham","Burton Albion","0-1",0,1,5,5,1,-1,"A"
"2008-09-02",2008,"York City","Mansfield Town","1-1",1,1,5,5,2,0,"D"
"2008-09-04",2008,"Kidderminster Harriers","Torquay United","1-0",1,0,5,5,1,1,"H"
"2008-09-06",2008,"Altrincham","Salisbury","0-0",0,0,5,5,0,0,"D"
"2008-09-06",2008,"Cambridge United","Wrexham","2-0",2,0,5,5,2,2,"H"
"2008-09-06",2008,"Forest Green Rovers","Ebbsfleet United","1-4",1,4,5,5,5,-3,"A"
"2008-09-06",2008,"Lewes","Barrow","0-3",0,3,5,5,3,-3,"A"
"2008-09-06",2008,"Mansfield Town","Eastbourne Borough","3-1",3,1,5,5,4,2,"H"
"2008-09-06",2008,"Oxford United","Kettering Town","1-1",1,1,5,5,2,0,"D"
"2008-09-06",2008,"Rushden & Diamonds","Crawley Town","0-1",0,1,5,5,1,-1,"A"
"2008-09-06",2008,"Stevenage Borough","Burton Albion","4-1",4,1,5,5,5,3,"H"
"2008-09-06",2008,"Weymouth","Histon","2-5",2,5,5,5,7,-3,"A"
"2008-09-06",2008,"York City","Woking","2-0",2,0,5,5,2,2,"H"
"2008-09-07",2008,"Grays Athletic","Kidderminster Harriers","3-2",3,2,5,5,5,1,"H"
"2008-09-07",2008,"Torquay United","Northwich Victoria","2-1",2,1,5,5,3,1,"H"
"2008-09-11",2008,"Lewes","Rushden & Diamonds","0-4",0,4,5,5,4,-4,"A"
"2008-09-13",2008,"Burton Albion","Weymouth","1-1",1,1,5,5,2,0,"D"
"2008-09-13",2008,"Cambridge United","Torquay United","0-1",0,1,5,5,1,-1,"A"
"2008-09-13",2008,"Crawley Town","Mansfield Town","2-1",2,1,5,5,3,1,"H"
"2008-09-13",2008,"Eastbourne Borough","Histon","1-1",1,1,5,5,2,0,"D"
"2008-09-13",2008,"Kettering Town","York City","4-2",4,2,5,5,6,2,"H"
"2008-09-13",2008,"Kidderminster Harriers","Oxford United","1-0",1,0,5,5,1,1,"H"
"2008-09-13",2008,"Northwich Victoria","Forest Green Rovers","0-0",0,0,5,5,0,0,"D"
"2008-09-13",2008,"Salisbury","Barrow","3-0",3,0,5,5,3,3,"H"
"2008-09-13",2008,"Stevenage Borough","Altrincham","3-0",3,0,5,5,3,3,"H"
"2008-09-13",2008,"Woking","Grays Athletic","3-1",3,1,5,5,4,2,"H"
"2008-09-13",2008,"Wrexham","Ebbsfleet United","3-2",3,2,5,5,5,1,"H"
"2008-09-20",2008,"Altrincham","Lewes","1-0",1,0,5,5,1,1,"H"
"2008-09-20",2008,"Barrow","Kettering Town","2-4",2,4,5,5,6,-2,"A"
"2008-09-20",2008,"Ebbsfleet United","Woking","2-0",2,0,5,5,2,2,"H"
"2008-09-20",2008,"Forest Green Rovers","Stevenage Borough","0-3",0,3,5,5,3,-3,"A"
"2008-09-20",2008,"Grays Athletic","Wrexham","2-1",2,1,5,5,3,1,"H"
"2008-09-20",2008,"Histon","Northwich Victoria","2-1",2,1,5,5,3,1,"H"
"2008-09-20",2008,"Mansfield Town","Cambridge United","1-1",1,1,5,5,2,0,"D"
"2008-09-20",2008,"Oxford United","Crawley Town","1-2",1,2,5,5,3,-1,"A"
"2008-09-20",2008,"Rushden & Diamonds","Burton Albion","2-1",2,1,5,5,3,1,"H"
"2008-09-20",2008,"Torquay United","Eastbourne Borough","2-0",2,0,5,5,2,2,"H"
"2008-09-20",2008,"Weymouth","Kidderminster Harriers","1-2",1,2,5,5,3,-1,"A"
"2008-09-20",2008,"York City","Salisbury","1-1",1,1,5,5,2,0,"D"
"2008-09-22",2008,"Kettering Town","Burton Albion","0-1",0,1,5,5,1,-1,"A"
"2008-09-23",2008,"Altrincham","Mansfield Town","1-0",1,0,5,5,1,1,"H"
"2008-09-23",2008,"Ebbsfleet United","Eastbourne Borough","1-1",1,1,5,5,2,0,"D"
"2008-09-23",2008,"Forest Green Rovers","Torquay United","1-2",1,2,5,5,3,-1,"A"
"2008-09-23",2008,"Histon","Lewes","1-1",1,1,5,5,2,0,"D"
"2008-09-23",2008,"Kidderminster Harriers","York City","2-0",2,0,5,5,2,2,"H"
"2008-09-23",2008,"Northwich Victoria","Barrow","2-1",2,1,5,5,3,1,"H"
"2008-09-23",2008,"Oxford United","Cambridge United","3-1",3,1,5,5,4,2,"H"
"2008-09-23",2008,"Weymouth","Crawley Town","2-2",2,2,5,5,4,0,"D"
"2008-09-23",2008,"Woking","Salisbury","1-0",1,0,5,5,1,1,"H"
"2008-09-23",2008,"Wrexham","Rushden & Diamonds","0-3",0,3,5,5,3,-3,"A"
"2008-09-25",2008,"Grays Athletic","Stevenage Borough","1-2",1,2,5,5,3,-1,"A"
"2008-09-27",2008,"Barrow","Ebbsfleet United","0-3",0,3,5,5,3,-3,"A"
"2008-09-27",2008,"Burton Albion","Forest Green Rovers","4-2",4,2,5,5,6,2,"H"
"2008-09-27",2008,"Crawley Town","Kettering Town","1-0",1,0,5,5,1,1,"H"
"2008-09-27",2008,"Eastbourne Borough","Kidderminster Harriers","2-3",2,3,5,5,5,-1,"A"
"2008-09-27",2008,"Lewes","Oxford United","2-1",2,1,5,5,3,1,"H"
"2008-09-27",2008,"Northwich Victoria","Weymouth","2-3",2,3,5,5,5,-1,"A"
"2008-09-27",2008,"Salisbury","Mansfield Town","2-3",2,3,5,5,5,-1,"A"
"2008-09-27",2008,"Woking","Histon","1-0",1,0,5,5,1,1,"H"
"2008-09-27",2008,"Wrexham","Torquay United","1-1",1,1,5,5,2,0,"D"
"2008-09-28",2008,"Cambridge United","Grays Athletic","1-0",1,0,5,5,1,1,"H"
"2008-09-28",2008,"Stevenage Borough","York City","3-3",3,3,5,5,6,0,"D"
"2008-09-29",2008,"Rushden & Diamonds","Altrincham","1-1",1,1,5,5,2,0,"D"
"2008-10-04",2008,"Altrincham","Ebbsfleet United","2-0",2,0,5,5,2,2,"H"
"2008-10-04",2008,"Burton Albion","Crawley Town","2-1",2,1,5,5,3,1,"H"
"2008-10-04",2008,"Forest Green Rovers","Wrexham","2-3",2,3,5,5,5,-1,"A"
"2008-10-04",2008,"Grays Athletic","Lewes","0-0",0,0,5,5,0,0,"D"
"2008-10-04",2008,"Histon","Salisbury","2-0",2,0,5,5,2,2,"H"
"2008-10-04",2008,"Kettering Town","Northwich Victoria","2-1",2,1,5,5,3,1,"H"
"2008-10-04",2008,"Kidderminster Harriers","Barrow","0-1",0,1,5,5,1,-1,"A"
"2008-10-04",2008,"Mansfield Town","Woking","0-1",0,1,5,5,1,-1,"A"
"2008-10-04",2008,"Oxford United","Rushden & Diamonds","2-1",2,1,5,5,3,1,"H"
"2008-10-04",2008,"Torquay United","Stevenage Borough","3-0",3,0,5,5,3,3,"H"
"2008-10-04",2008,"Weymouth","Eastbourne Borough","3-2",3,2,5,5,5,1,"H"
"2008-10-04",2008,"York City","Cambridge United","0-0",0,0,5,5,0,0,"D"
"2008-10-06",2008,"Ebbsfleet United","Histon","0-1",0,1,5,5,1,-1,"A"
"2008-10-07",2008,"Barrow","Burton Albion","0-0",0,0,5,5,0,0,"D"
"2008-10-07",2008,"Cambridge United","Lewes","1-0",1,0,5,5,1,1,"H"
"2008-10-07",2008,"Crawley Town","Forest Green Rovers","2-2",2,2,5,5,4,0,"D"
"2008-10-07",2008,"Eastbourne Borough","Kettering Town","1-2",1,2,5,5,3,-1,"A"
"2008-10-07",2008,"Northwich Victoria","Kidderminster Harriers","1-1",1,1,5,5,2,0,"D"
"2008-10-07",2008,"Rushden & Diamonds","Grays Athletic","1-0",1,0,5,5,1,1,"H"
"2008-10-07",2008,"Salisbury","Altrincham","1-3",1,3,5,5,4,-2,"A"
"2008-10-07",2008,"Stevenage Borough","Mansfield Town","3-2",3,2,5,5,5,1,"H"
"2008-10-07",2008,"Woking","Weymouth","1-1",1,1,5,5,2,0,"D"
"2008-10-07",2008,"Wrexham","York City","3-1",3,1,5,5,4,2,"H"
"2008-10-09",2008,"Torquay United","Oxford United","1-1",1,1,5,5,2,0,"D"
"2008-10-11",2008,"Cambridge United","Weymouth","1-0",1,0,5,5,1,1,"H"
"2008-10-11",2008,"Crawley Town","Barrow","4-0",4,0,5,5,4,4,"H"
"2008-10-11",2008,"Kidderminster Harriers","Ebbsfleet United","3-1",3,1,5,5,4,2,"H"
"2008-10-11",2008,"Lewes","Forest Green Rovers","3-2",3,2,5,5,5,1,"H"
"2008-10-11",2008,"Northwich Victoria","Grays Athletic","2-0",2,0,5,5,2,2,"H"
"2008-10-11",2008,"Salisbury","Kettering Town","1-2",1,2,5,5,3,-1,"A"
"2008-10-11",2008,"Woking","York City","0-2",0,2,5,5,2,-2,"A"
"2008-10-12",2008,"Altrincham","Oxford United","1-0",1,0,5,5,1,1,"H"
"2008-10-12",2008,"Eastbourne Borough","Stevenage Borough","2-1",2,1,5,5,3,1,"H"
"2008-10-12",2008,"Rushden & Diamonds","Torquay United","1-3",1,3,5,5,4,-2,"A"
"2008-10-13",2008,"Burton Albion","Mansfield Town","1-0",1,0,5,5,1,1,"H"
"2008-10-16",2008,"Forest Green Rovers","Cambridge United","2-2",2,2,5,5,4,0,"D"
"2008-10-18",2008,"Barrow","Eastbourne Borough","3-1",3,1,5,5,4,2,"H"
"2008-10-18",2008,"Ebbsfleet United","Torquay United","0-2",0,2,5,5,2,-2,"A"
"2008-10-18",2008,"Grays Athletic","Woking","1-1",1,1,5,5,2,0,"D"
"2008-10-18",2008,"Histon","Crawley Town","1-0",1,0,5,5,1,1,"H"
"2008-10-18",2008,"Kettering Town","Kidderminster Harriers","1-0",1,0,5,5,1,1,"H"
"2008-10-18",2008,"Lewes","Northwich Victoria","2-3",2,3,5,5,5,-1,"A"
"2008-10-18",2008,"Mansfield Town","Wrexham","1-2",1,2,5,5,3,-1,"A"
"2008-10-18",2008,"Oxford United","Burton Albion","2-1",2,1,5,5,3,1,"H"
"2008-10-18",2008,"Stevenage Borough","Salisbury","2-0",2,0,5,5,2,2,"H"
"2008-10-18",2008,"Weymouth","Altrincham","2-0",2,0,5,5,2,2,"H"
"2008-10-18",2008,"York City","Rushden & Diamonds","2-0",2,0,5,5,2,2,"H"
"2008-10-30",2008,"Salisbury","Crawley Town","2-0",2,0,5,5,2,2,"H"
"2008-11-01",2008,"Altrincham","Histon","0-1",0,1,5,5,1,-1,"A"
"2008-11-01",2008,"Barrow","Forest Green Rovers","3-1",3,1,5,5,4,2,"H"
"2008-11-01",2008,"Burton Albion","Ebbsfleet United","3-1",3,1,5,5,4,2,"H"
"2008-11-01",2008,"Cambridge United","Rushden & Diamonds","0-0",0,0,5,5,0,0,"D"
"2008-11-01",2008,"Kettering Town","Weymouth","0-1",0,1,5,5,1,-1,"A"
"2008-11-01",2008,"Kidderminster Harriers","Grays Athletic","2-0",2,0,5,5,2,2,"H"
"2008-11-01",2008,"Northwich Victoria","Eastbourne Borough","1-2",1,2,5,5,3,-1,"A"
"2008-11-01",2008,"Oxford United","York City","1-0",1,0,5,5,1,1,"H"
"2008-11-01",2008,"Torquay United","Mansfield Town","2-0",2,0,5,5,2,2,"H"
"2008-11-01",2008,"Woking","Stevenage Borough","0-1",0,1,5,5,1,-1,"A"
"2008-11-01",2008,"Wrexham","Lewes","2-0",2,0,5,5,2,2,"H"
"2008-11-08",2008,"Northwich Victoria","Burton Albion","0-1",0,1,5,5,1,-1,"A"
"2008-11-08",2008,"Rushden & Diamonds","Weymouth","1-0",1,0,5,5,1,1,"H"
"2008-11-15",2008,"Crawley Town","Cambridge United","2-2",2,2,5,5,4,0,"D"
"2008-11-15",2008,"Eastbourne Borough","Woking","0-0",0,0,5,5,0,0,"D"
"2008-11-15",2008,"Ebbsfleet United","Barrow","1-0",1,0,5,5,1,1,"H"
"2008-11-15",2008,"Forest Green Rovers","Altrincham","1-3",1,3,5,5,4,-2,"A"
"2008-11-15",2008,"Grays Athletic","Oxford United","2-0",2,0,5,5,2,2,"H"
"2008-11-15",2008,"Histon","Kettering Town","1-0",1,0,5,5,1,1,"H"
"2008-11-15",2008,"Lewes","Burton Albion","0-1",0,1,5,5,1,-1,"A"
"2008-11-15",2008,"Mansfield Town","Salisbury","3-0",3,0,5,5,3,3,"H"
"2008-11-15",2008,"Rushden & Diamonds","Kidderminster Harriers","0-1",0,1,5,5,1,-1,"A"
"2008-11-15",2008,"Stevenage Borough","Northwich Victoria","1-1",1,1,5,5,2,0,"D"
"2008-11-15",2008,"Weymouth","Wrexham","1-3",1,3,5,5,4,-2,"A"
"2008-11-15",2008,"York City","Torquay United","1-2",1,2,5,5,3,-1,"A"
"2008-11-18",2008,"Cambridge United","York City","1-0",1,0,5,5,1,1,"H"
"2008-11-18",2008,"Stevenage Borough","Histon","1-3",1,3,5,5,4,-2,"A"
"2008-11-18",2008,"Torquay United","Lewes","4-1",4,1,5,5,5,3,"H"
"2008-11-18",2008,"Weymouth","Woking","1-1",1,1,5,5,2,0,"D"
"2008-11-20",2008,"Crawley Town","Ebbsfleet United","1-2",1,2,5,5,3,-1,"A"
"2008-11-22",2008,"Altrincham","Cambridge United","1-0",1,0,5,5,1,1,"H"
"2008-11-22",2008,"Barrow","Weymouth","0-1",0,1,5,5,1,-1,"A"
"2008-11-22",2008,"Burton Albion","Stevenage Borough","2-0",2,0,5,5,2,2,"H"
"2008-11-22",2008,"Forest Green Rovers","Mansfield Town","1-0",1,0,5,5,1,1,"H"
"2008-11-22",2008,"Histon","Oxford United","5-2",5,2,5,5,7,3,"H"
"2008-11-22",2008,"Kidderminster Harriers","Wrexham","1-0",1,0,5,5,1,1,"H"
"2008-11-22",2008,"Lewes","Grays Athletic","2-0",2,0,5,5,2,2,"H"
"2008-11-22",2008,"Rushden & Diamonds","Eastbourne Borough","2-0",2,0,5,5,2,2,"H"
"2008-11-22",2008,"Salisbury","Northwich Victoria","1-1",1,1,5,5,2,0,"D"
"2008-11-22",2008,"Woking","Torquay United","2-2",2,2,5,5,4,0,"D"
"2008-11-23",2008,"Ebbsfleet United","Kettering Town","0-0",0,0,5,5,0,0,"D"
"2008-11-23",2008,"York City","Crawley Town","2-2",2,2,5,5,4,0,"D"
"2008-11-25",2008,"Oxford United","Kidderminster Harriers","1-0",1,0,5,5,1,1,"H"
"2008-11-29",2008,"Altrincham","Rushden & Diamonds","0-4",0,4,5,5,4,-4,"A"
"2008-11-29",2008,"Burton Albion","Eastbourne Borough","2-0",2,0,5,5,2,2,"H"
"2008-11-29",2008,"Cambridge United","Ebbsfleet United","1-0",1,0,5,5,1,1,"H"
"2008-11-29",2008,"Northwich Victoria","Crawley Town","0-1",0,1,5,5,1,-1,"A"
"2008-11-29",2008,"Salisbury","York City","1-1",1,1,5,5,2,0,"D"
"2008-11-29",2008,"Stevenage Borough","Wrexham","1-2",1,2,5,5,3,-1,"A"
"2008-11-29",2008,"Weymouth","Mansfield Town","1-1",1,1,5,5,2,0,"D"
"2008-12-04",2008,"Mansfield Town","Oxford United","1-3",1,3,5,5,4,-2,"A"
"2008-12-06",2008,"Crawley Town","Altrincham","4-0",4,0,5,5,4,4,"H"
"2008-12-06",2008,"Eastbourne Borough","Northwich Victoria","4-1",4,1,5,5,5,3,"H"
"2008-12-06",2008,"Ebbsfleet United","Weymouth","1-0",1,0,5,5,1,1,"H"
"2008-12-06",2008,"Forest Green Rovers","Burton Albion","2-3",2,3,5,5,5,-1,"A"
"2008-12-06",2008,"Histon","Woking","1-0",1,0,5,5,1,1,"H"
"2008-12-06",2008,"Kidderminster Harriers","Salisbury","3-2",3,2,5,5,5,1,"H"
"2008-12-06",2008,"Lewes","Stevenage Borough","0-2",0,2,5,5,2,-2,"A"
"2008-12-06",2008,"Rushden & Diamonds","Barrow","1-1",1,1,5,5,2,0,"D"
"2008-12-06",2008,"Torquay United","Cambridge United","0-0",0,0,5,5,0,0,"D"
"2008-12-06",2008,"Wrexham","Kettering Town","2-1",2,1,5,5,3,1,"H"
"2008-12-06",2008,"York City","Grays Athletic","0-1",0,1,5,5,1,-1,"A"
"2008-12-09",2008,"Barrow","Altrincham","2-2",2,2,5,5,4,0,"D"
"2008-12-09",2008,"Burton Albion","Cambridge United","3-1",3,1,5,5,4,2,"H"
"2008-12-09",2008,"Eastbourne Borough","Torquay United","4-2",4,2,5,5,6,2,"H"
"2008-12-09",2008,"Ebbsfleet United","Forest Green Rovers","0-1",0,1,5,5,1,-1,"A"
"2008-12-09",2008,"Histon","York City","1-1",1,1,5,5,2,0,"D"
"2008-12-09",2008,"Kidderminster Harriers","Mansfield Town","2-0",2,0,5,5,2,2,"H"
"2008-12-09",2008,"Salisbury","Lewes","1-2",1,2,5,5,3,-1,"A"
"2008-12-09",2008,"Stevenage Borough","Grays Athletic","0-0",0,0,5,5,0,0,"D"
"2008-12-09",2008,"Weymouth","Oxford United","2-2",2,2,5,5,4,0,"D"
"2008-12-09",2008,"Woking","Rushden & Diamonds","1-1",1,1,5,5,2,0,"D"
"2008-12-20",2008,"Altrincham","Burton Albion","1-3",1,3,5,5,4,-2,"A"
"2008-12-20",2008,"Cambridge United","Salisbury","4-0",4,0,5,5,4,4,"H"
"2008-12-20",2008,"Crawley Town","Kidderminster Harriers","2-0",2,0,5,5,2,2,"H"
"2008-12-20",2008,"Forest Green Rovers","Kettering Town","0-2",0,2,5,5,2,-2,"A"
"2008-12-20",2008,"Grays Athletic","Barrow","2-1",2,1,5,5,3,1,"H"
"2008-12-20",2008,"Lewes","Woking","0-2",0,2,5,5,2,-2,"A"
"2008-12-20",2008,"Mansfield Town","Weymouth","2-1",2,1,5,5,3,1,"H"
"2008-12-20",2008,"Oxford United","Stevenage Borough","1-1",1,1,5,5,2,0,"D"
"2008-12-20",2008,"Rushden & Diamonds","Northwich Victoria","2-1",2,1,5,5,3,1,"H"
"2008-12-20",2008,"Torquay United","Histon","4-1",4,1,5,5,5,3,"H"
"2008-12-20",2008,"Wrexham","Eastbourne Borough","5-0",5,0,5,5,5,5,"H"
"2008-12-20",2008,"York City","Ebbsfleet United","3-1",3,1,5,5,4,2,"H"
"2008-12-26",2008,"Barrow","Wrexham","1-1",1,1,5,5,2,0,"D"
"2008-12-26",2008,"Burton Albion","York City","2-1",2,1,5,5,3,1,"H"
"2008-12-26",2008,"Cambridge United","Histon","2-2",2,2,5,5,4,0,"D"
"2008-12-26",2008,"Eastbourne Borough","Lewes","1-0",1,0,5,5,1,1,"H"
"2008-12-26",2008,"Ebbsfleet United","Grays Athletic","0-1",0,1,5,5,1,-1,"A"
"2008-12-26",2008,"Kettering Town","Mansfield Town","1-3",1,3,5,5,4,-2,"A"
"2008-12-26",2008,"Kidderminster Harriers","Forest Green Rovers","1-1",1,1,5,5,2,0,"D"
"2008-12-26",2008,"Northwich Victoria","Altrincham","0-1",0,1,5,5,1,-1,"A"
"2008-12-26",2008,"Salisbury","Oxford United","2-1",2,1,5,5,3,1,"H"
"2008-12-26",2008,"Stevenage Borough","Rushden & Diamonds","3-1",3,1,5,5,4,2,"H"
"2008-12-26",2008,"Weymouth","Torquay United","0-1",0,1,5,5,1,-1,"A"
"2008-12-26",2008,"Woking","Crawley Town","0-0",0,0,5,5,0,0,"D"
"2008-12-28",2008,"Cambridge United","Stevenage Borough","1-1",1,1,5,5,2,0,"D"
"2008-12-28",2008,"Crawley Town","Eastbourne Borough","1-0",1,0,5,5,1,1,"H"
"2008-12-28",2008,"Forest Green Rovers","Barrow","2-1",2,1,5,5,3,1,"H"
"2008-12-28",2008,"Grays Athletic","Histon","1-4",1,4,5,5,5,-3,"A"
"2008-12-28",2008,"Oxford United","Ebbsfleet United","5-1",5,1,5,5,6,4,"H"
"2008-12-28",2008,"Torquay United","Kidderminster Harriers","0-1",0,1,5,5,1,-1,"A"
"2008-12-28",2008,"Wrexham","Woking","1-1",1,1,5,5,2,0,"D"
"2008-12-28",2008,"York City","Altrincham","1-2",1,2,5,5,3,-1,"A"
"2008-12-29",2008,"Mansfield Town","Burton Albion","0-2",0,2,5,5,2,-2,"A"
"2009-01-01",2008,"Crawley Town","Woking","2-2",2,2,5,5,4,0,"D"
"2009-01-01",2008,"Grays Athletic","Ebbsfleet United","3-1",3,1,5,5,4,2,"H"
"2009-01-01",2008,"Lewes","Eastbourne Borough","0-2",0,2,5,5,2,-2,"A"
"2009-01-01",2008,"Oxford United","Salisbury","2-0",2,0,5,5,2,2,"H"
"2009-01-01",2008,"Rushden & Diamonds","Stevenage Borough","1-1",1,1,5,5,2,0,"D"
"2009-01-01",2008,"York City","Burton Albion","1-3",1,3,5,5,4,-2,"A"
"2009-01-03",2008,"Stevenage Borough","Lewes","3-0",3,0,5,5,3,3,"H"
"2009-01-16",2008,"Torquay United","Wrexham","1-1",1,1,5,5,2,0,"D"
"2009-01-17",2008,"Cambridge United","Woking","4-1",4,1,5,5,5,3,"H"
"2009-01-17",2008,"Ebbsfleet United","Rushden & Diamonds","1-0",1,0,5,5,1,1,"H"
"2009-01-17",2008,"Forest Green Rovers","Eastbourne Borough","1-2",1,2,5,5,3,-1,"A"
"2009-01-17",2008,"Grays Athletic","Burton Albion","0-1",0,1,5,5,1,-1,"A"
"2009-01-17",2008,"Kettering Town","Salisbury","1-0",1,0,5,5,1,1,"H"
"2009-01-17",2008,"Kidderminster Harriers","Weymouth","0-2",0,2,5,5,2,-2,"A"
"2009-01-17",2008,"Mansfield Town","Crawley Town","1-0",1,0,5,5,1,1,"H"
"2009-01-17",2008,"Northwich Victoria","Histon","1-2",1,2,5,5,3,-1,"A"
"2009-01-17",2008,"Oxford United","Altrincham","1-0",1,0,5,5,1,1,"H"
"2009-01-17",2008,"Stevenage Borough","Barrow","3-0",3,0,5,5,3,3,"H"
"2009-01-17",2008,"York City","Lewes","3-0",3,0,5,5,3,3,"H"
"2009-01-20",2008,"Oxford United","Forest Green Rovers","2-1",2,1,5,5,3,1,"H"
"2009-01-22",2008,"Wrexham","Cambridge United","2-0",2,0,5,5,2,2,"H"
"2009-01-23",2008,"Rushden & Diamonds","Forest Green Rovers","2-2",2,2,5,5,4,0,"D"
"2009-01-24",2008,"Barrow","Kidderminster Harriers","1-0",1,0,5,5,1,1,"H"
"2009-01-24",2008,"Burton Albion","Altrincham","1-1",1,1,5,5,2,0,"D"
"2009-01-24",2008,"Crawley Town","Oxford United","0-1",0,1,5,5,1,-1,"A"
"2009-01-24",2008,"Eastbourne Borough","York City","2-1",2,1,5,5,3,1,"H"
"2009-01-24",2008,"Lewes","Mansfield Town","0-1",0,1,5,5,1,-1,"A"
"2009-01-24",2008,"Salisbury","Stevenage Borough","2-4",2,4,5,5,6,-2,"A"
"2009-01-24",2008,"Weymouth","Northwich Victoria","3-0",3,0,5,5,3,3,"H"
"2009-01-24",2008,"Woking","Ebbsfleet United","1-0",1,0,5,5,1,1,"H"
"2009-01-26",2008,"Burton Albion","Barrow","2-1",2,1,5,5,3,1,"H"
"2009-01-27",2008,"Altrincham","York City","1-1",1,1,5,5,2,0,"D"
"2009-01-27",2008,"Ebbsfleet United","Crawley Town","4-4",4,4,5,5,8,0,"D"
"2009-01-27",2008,"Grays Athletic","Weymouth","1-1",1,1,5,5,2,0,"D"
"2009-01-27",2008,"Kidderminster Harriers","Histon","2-0",2,0,5,5,2,2,"H"
"2009-01-27",2008,"Lewes","Torquay United","0-2",0,2,5,5,2,-2,"A"
"2009-01-27",2008,"Mansfield Town","Rushden & Diamonds","0-0",0,0,5,5,0,0,"D"
"2009-01-27",2008,"Salisbury","Forest Green Rovers","2-2",2,2,5,5,4,0,"D"
"2009-01-27",2008,"Stevenage Borough","Kettering Town","2-1",2,1,5,5,3,1,"H"
"2009-01-27",2008,"Woking","Eastbourne Borough","0-4",0,4,5,5,4,-4,"A"
"2009-01-27",2008,"Wrexham","Northwich Victoria","3-3",3,3,5,5,6,0,"D"
"2009-01-29",2008,"Cambridge United","Oxford United","1-1",1,1,5,5,2,0,"D"
"2009-01-31",2008,"Barrow","Salisbury","0-0",0,0,5,5,0,0,"D"
"2009-01-31",2008,"Eastbourne Borough","Mansfield Town","1-2",1,2,5,5,3,-1,"A"
"2009-01-31",2008,"Woking","Northwich Victoria","4-1",4,1,5,5,5,3,"H"
"2009-02-01",2008,"Oxford United","Lewes","2-1",2,1,5,5,3,1,"H"
"2009-02-01",2008,"Rushden & Diamonds","Cambridge United","1-2",1,2,5,5,3,-1,"A"
"2009-02-03",2008,"Altrincham","Northwich Victoria","1-0",1,0,5,5,1,1,"H"
"2009-02-03",2008,"Forest Green Rovers","Histon","2-2",2,2,5,5,4,0,"D"
"2009-02-07",2008,"Lewes","Wrexham","0-2",0,2,5,5,2,-2,"A"
"2009-02-07",2008,"Mansfield Town","York City","1-0",1,0,5,5,1,1,"H"
"2009-02-09",2008,"Burton Albion","Rushden & Diamonds","3-0",3,0,5,5,3,3,"H"
"2009-02-10",2008,"Torquay United","Weymouth","0-2",0,2,5,5,2,-2,"A"
"2009-02-14",2008,"Oxford United","Barrow","3-0",3,0,5,5,3,3,"H"
"2009-02-14",2008,"Salisbury","Histon","0-4",0,4,5,5,4,-4,"A"
"2009-02-14",2008,"Torquay United","Altrincham","3-1",3,1,5,5,4,2,"H"
"2009-02-14",2008,"Weymouth","Stevenage Borough","0-3",0,3,5,5,3,-3,"A"
"2009-02-14",2008,"Woking","Kettering Town","0-1",0,1,5,5,1,-1,"A"
"2009-02-14",2008,"Wrexham","Grays Athletic","3-2",3,2,5,5,5,1,"H"
"2009-02-15",2008,"Kidderminster Harriers","Northwich Victoria","1-2",1,2,5,5,3,-1,"A"
"2009-02-17",2008,"Burton Albion","Wrexham","2-1",2,1,5,5,3,1,"H"
"2009-02-17",2008,"Kidderminster Harriers","Cambridge United","1-3",1,3,5,5,4,-2,"A"
"2009-02-17",2008,"Mansfield Town","Kettering Town","0-0",0,0,5,5,0,0,"D"
"2009-02-17",2008,"Salisbury","Woking","1-0",1,0,5,5,1,1,"H"
"2009-02-18",2008,"Forest Green Rovers","Northwich Victoria","3-0",3,0,5,5,3,3,"H"
"2009-02-21",2008,"Altrincham","Woking","1-0",1,0,5,5,1,1,"H"
"2009-02-21",2008,"Barrow","Grays Athletic","1-1",1,1,5,5,2,0,"D"
"2009-02-21",2008,"Crawley Town","Salisbury","0-3",0,3,5,5,3,-3,"A"
"2009-02-21",2008,"Histon","Eastbourne Borough","3-3",3,3,5,5,6,0,"D"
"2009-02-21",2008,"Kettering Town","Torquay United","2-1",2,1,5,5,3,1,"H"
"2009-02-21",2008,"Lewes","Cambridge United","0-2",0,2,5,5,2,-2,"A"
"2009-02-21",2008,"Oxford United","Mansfield Town","1-0",1,0,5,5,1,1,"H"
"2009-02-21",2008,"Weymouth","Rushden & Diamonds","0-9",0,9,5,5,9,-9,"A"
"2009-02-24",2008,"Crawley Town","Lewes","5-1",5,1,5,5,6,4,"H"
"2009-02-24",2008,"Grays Athletic","Cambridge United","0-1",0,1,5,5,1,-1,"A"
"2009-02-24",2008,"Histon","Barrow","2-0",2,0,5,5,2,2,"H"
"2009-02-24",2008,"Northwich Victoria","Kettering Town","0-0",0,0,5,5,0,0,"D"
"2009-02-24",2008,"Rushden & Diamonds","York City","2-0",2,0,5,5,2,2,"H"
"2009-02-24",2008,"Stevenage Borough","Woking","1-0",1,0,5,5,1,1,"H"
"2009-02-24",2008,"Torquay United","Forest Green Rovers","3-3",3,3,5,5,6,0,"D"
"2009-02-28",2008,"Altrincham","Stevenage Borough","1-2",1,2,5,5,3,-1,"A"
"2009-02-28",2008,"Barrow","Northwich Victoria","0-0",0,0,5,5,0,0,"D"
"2009-02-28",2008,"Cambridge United","Crawley Town","1-1",1,1,5,5,2,0,"D"
"2009-02-28",2008,"Forest Green Rovers","Grays Athletic","1-1",1,1,5,5,2,0,"D"
"2009-02-28",2008,"Kidderminster Harriers","Eastbourne Borough","2-0",2,0,5,5,2,2,"H"
"2009-02-28",2008,"Lewes","Histon","0-3",0,3,5,5,3,-3,"A"
"2009-02-28",2008,"Oxford United","Torquay United","0-2",0,2,5,5,2,-2,"A"
"2009-02-28",2008,"Rushden & Diamonds","Mansfield Town","0-1",0,1,5,5,1,-1,"A"
"2009-02-28",2008,"Woking","Burton Albion","0-0",0,0,5,5,0,0,"D"
"2009-02-28",2008,"Wrexham","Salisbury","1-1",1,1,5,5,2,0,"D"
"2009-02-28",2008,"York City","Weymouth","2-0",2,0,5,5,2,2,"H"
"2009-03-02",2008,"Histon","Cambridge United","1-1",1,1,5,5,2,0,"D"
"2009-03-03",2008,"Crawley Town","Wrexham","1-0",1,0,5,5,1,1,"H"
"2009-03-03",2008,"Eastbourne Borough","Oxford United","0-3",0,3,5,5,3,-3,"A"
"2009-03-03",2008,"Grays Athletic","Torquay United","1-2",1,2,5,5,3,-1,"A"
"2009-03-03",2008,"Kettering Town","Altrincham","3-1",3,1,5,5,4,2,"H"
"2009-03-03",2008,"Stevenage Borough","Forest Green Rovers","1-1",1,1,5,5,2,0,"D"
"2009-03-07",2008,"Cambridge United","Burton Albion","2-0",2,0,5,5,2,2,"H"
"2009-03-07",2008,"Eastbourne Borough","Wrexham","1-0",1,0,5,5,1,1,"H"
"2009-03-07",2008,"Forest Green Rovers","Oxford United","3-3",3,3,5,5,6,0,"D"
"2009-03-07",2008,"Grays Athletic","Altrincham","2-1",2,1,5,5,3,1,"H"
"2009-03-07",2008,"Kettering Town","Histon","1-0",1,0,5,5,1,1,"H"
"2009-03-07",2008,"Mansfield Town","Lewes","1-0",1,0,5,5,1,1,"H"
"2009-03-07",2008,"Northwich Victoria","Stevenage Borough","0-1",0,1,5,5,1,-1,"A"
"2009-03-07",2008,"Salisbury","Kidderminster Harriers","0-0",0,0,5,5,0,0,"D"
"2009-03-07",2008,"Torquay United","Rushden & Diamonds","1-1",1,1,5,5,2,0,"D"
"2009-03-07",2008,"Woking","Barrow","1-0",1,0,5,5,1,1,"H"
"2009-03-08",2008,"Crawley Town","Weymouth","4-2",4,2,5,5,6,2,"H"
"2009-03-08",2008,"Ebbsfleet United","York City","0-0",0,0,5,5,0,0,"D"
"2009-03-10",2008,"Altrincham","Torquay United","0-1",0,1,5,5,1,-1,"A"
"2009-03-10",2008,"Barrow","Histon","1-0",1,0,5,5,1,1,"H"
"2009-03-10",2008,"Cambridge United","Mansfield Town","2-1",2,1,5,5,3,1,"H"
"2009-03-10",2008,"Kettering Town","Grays Athletic","0-0",0,0,5,5,0,0,"D"
"2009-03-10",2008,"Kidderminster Harriers","Crawley Town","2-0",2,0,5,5,2,2,"H"
"2009-03-10",2008,"Rushden & Diamonds","Lewes","2-1",2,1,5,5,3,1,"H"
"2009-03-10",2008,"Weymouth","Salisbury","0-4",0,4,5,5,4,-4,"A"
"2009-03-10",2008,"Wrexham","Forest Green Rovers","1-1",1,1,5,5,2,0,"D"
"2009-03-11",2008,"Ebbsfleet United","Burton Albion","2-1",2,1,5,5,3,1,"H"
"2009-03-14",2008,"Altrincham","Weymouth","4-0",4,0,5,5,4,4,"H"
"2009-03-14",2008,"Burton Albion","Salisbury","1-2",1,2,5,5,3,-1,"A"
"2009-03-14",2008,"Cambridge United","Northwich Victoria","4-1",4,1,5,5,5,3,"H"
"2009-03-14",2008,"Crawley Town","Rushden & Diamonds","0-0",0,0,5,5,0,0,"D"
"2009-03-14",2008,"Kettering Town","Eastbourne Borough","0-1",0,1,5,5,1,-1,"A"
"2009-03-14",2008,"Lewes","Kidderminster Harriers","0-1",0,1,5,5,1,-1,"A"
"2009-03-14",2008,"Mansfield Town","Forest Green Rovers","3-0",3,0,5,5,3,3,"H"
"2009-03-14",2008,"Oxford United","Grays Athletic","4-1",4,1,5,5,5,3,"H"
"2009-03-14",2008,"Torquay United","Barrow","4-1",4,1,5,5,5,3,"H"
"2009-03-14",2008,"Woking","Wrexham","1-1",1,1,5,5,2,0,"D"
"2009-03-17",2008,"Barrow","Cambridge United","0-2",0,2,5,5,2,-2,"A"
"2009-03-17",2008,"Eastbourne Borough","Salisbury","0-0",0,0,5,5,0,0,"D"
"2009-03-17",2008,"Forest Green Rovers","York City","1-1",1,1,5,5,2,0,"D"
"2009-03-17",2008,"Histon","Grays Athletic","4-1",4,1,5,5,5,3,"H"
"2009-03-17",2008,"Kettering Town","Lewes","1-0",1,0,5,5,1,1,"H"
"2009-03-17",2008,"Northwich Victoria","Wrexham","1-2",1,2,5,5,3,-1,"A"
"2009-03-17",2008,"Weymouth","Burton Albion","0-5",0,5,5,5,5,-5,"A"
"2009-03-19",2008,"Kettering Town","Oxford United","1-2",1,2,5,5,3,-1,"A"
"2009-03-21",2008,"Altrincham","Forest Green Rovers","2-5",2,5,5,5,7,-3,"A"
"2009-03-21",2008,"Barrow","Lewes","2-0",2,0,5,5,2,2,"H"
"2009-03-21",2008,"Eastbourne Borough","Burton Albion","1-2",1,2,5,5,3,-1,"A"
"2009-03-21",2008,"Grays Athletic","Mansfield Town","2-1",2,1,5,5,3,1,"H"
"2009-03-21",2008,"Kidderminster Harriers","Woking","3-0",3,0,5,5,3,3,"H"
"2009-03-21",2008,"Northwich Victoria","Torquay United","2-3",2,3,5,5,5,-1,"A"
"2009-03-21",2008,"Salisbury","Rushden & Diamonds","1-1",1,1,5,5,2,0,"D"
"2009-03-21",2008,"Weymouth","Kettering Town","0-2",0,2,5,5,2,-2,"A"
"2009-03-21",2008,"Wrexham","Crawley Town","0-2",0,2,5,5,2,-2,"A"
"2009-03-23",2008,"Wrexham","Kidderminster Harriers","0-1",0,1,5,5,1,-1,"A"
"2009-03-24",2008,"Histon","Stevenage Borough","0-0",0,0,5,5,0,0,"D"
"2009-03-24",2008,"Rushden & Diamonds","Oxford United","1-3",1,3,5,5,4,-2,"A"
"2009-03-24",2008,"Salisbury","Ebbsfleet United","1-0",1,0,5,5,1,1,"H"
"2009-03-24",2008,"Torquay United","Grays Athletic","1-1",1,1,5,5,2,0,"D"
"2009-03-24",2008,"York City","Kettering Town","0-0",0,0,5,5,0,0,"D"
"2009-03-28",2008,"Altrincham","Crawley Town","2-2",2,2,5,5,4,0,"D"
"2009-03-28",2008,"Burton Albion","Grays Athletic","4-0",4,0,5,5,4,4,"H"
"2009-03-28",2008,"Forest Green Rovers","Lewes","4-1",4,1,5,5,5,3,"H"
"2009-03-28",2008,"Histon","Wrexham","1-0",1,0,5,5,1,1,"H"
"2009-03-28",2008,"Kettering Town","Ebbsfleet United","2-1",2,1,5,5,3,1,"H"
"2009-03-28",2008,"Mansfield Town","Torquay United","1-1",1,1,5,5,2,0,"D"
"2009-03-28",2008,"Northwich Victoria","Rushden & Diamonds","4-2",4,2,5,5,6,2,"H"
"2009-03-28",2008,"Salisbury","Eastbourne Borough","2-0",2,0,5,5,2,2,"H"
"2009-03-28",2008,"Stevenage Borough","Oxford United","1-1",1,1,5,5,2,0,"D"
"2009-03-28",2008,"York City","Kidderminster Harriers","0-0",0,0,5,5,0,0,"D"
"2009-03-29",2008,"Weymouth","Barrow","0-3",0,3,5,5,3,-3,"A"
"2009-03-30",2008,"Woking","Cambridge United","0-1",0,1,5,5,1,-1,"A"
"2009-03-31",2008,"Burton Albion","Kettering Town","1-1",1,1,5,5,2,0,"D"
"2009-03-31",2008,"Eastbourne Borough","Crawley Town","2-1",2,1,5,5,3,1,"H"
"2009-03-31",2008,"Ebbsfleet United","Altrincham","1-0",1,0,5,5,1,1,"H"
"2009-03-31",2008,"Grays Athletic","Rushden & Diamonds","0-0",0,0,5,5,0,0,"D"
"2009-03-31",2008,"Histon","Mansfield Town","3-0",3,0,5,5,3,3,"H"
"2009-03-31",2008,"Northwich Victoria","Salisbury","1-1",1,1,5,5,2,0,"D"
"2009-03-31",2008,"York City","Stevenage Borough","0-2",0,2,5,5,2,-2,"A"
"2009-04-01",2008,"Woking","Kidderminster Harriers","1-5",1,5,5,5,6,-4,"A"
"2009-04-02",2008,"Eastbourne Borough","Ebbsfleet United","0-1",0,1,5,5,1,-1,"A"
"2009-04-02",2008,"Wrexham","Barrow","1-1",1,1,5,5,2,0,"D"
"2009-04-04",2008,"Barrow","Woking","0-1",0,1,5,5,1,-1,"A"
"2009-04-04",2008,"Cambridge United","Forest Green Rovers","0-1",0,1,5,5,1,-1,"A"
"2009-04-04",2008,"Crawley Town","Burton Albion","4-0",4,0,5,5,4,4,"H"
"2009-04-04",2008,"Eastbourne Borough","Weymouth","3-0",3,0,5,5,3,3,"H"
"2009-04-04",2008,"Ebbsfleet United","Northwich Victoria","1-0",1,0,5,5,1,1,"H"
"2009-04-04",2008,"Grays Athletic","York City","1-0",1,0,5,5,1,1,"H"
"2009-04-04",2008,"Kidderminster Harriers","Stevenage Borough","4-2",4,2,5,5,6,2,"H"
"2009-04-04",2008,"Lewes","Altrincham","2-0",2,0,5,5,2,2,"H"
"2009-04-04",2008,"Oxford United","Histon","2-1",2,1,5,5,3,1,"H"
"2009-04-04",2008,"Rushden & Diamonds","Salisbury","2-1",2,1,5,5,3,1,"H"
"2009-04-04",2008,"Torquay United","Kettering Town","2-0",2,0,5,5,2,2,"H"
"2009-04-04",2008,"Wrexham","Mansfield Town","2-0",2,0,5,5,2,2,"H"
"2009-04-06",2008,"Burton Albion","Torquay United","0-1",0,1,5,5,1,-1,"A"
"2009-04-07",2008,"Altrincham","Eastbourne Borough","2-2",2,2,5,5,4,0,"D"
"2009-04-07",2008,"Forest Green Rovers","Kidderminster Harriers","2-2",2,2,5,5,4,0,"D"
"2009-04-07",2008,"Kettering Town","Barrow","0-0",0,0,5,5,0,0,"D"
"2009-04-07",2008,"Mansfield Town","Ebbsfleet United","2-0",2,0,5,5,2,2,"H"
"2009-04-07",2008,"Northwich Victoria","Woking","2-0",2,0,5,5,2,2,"H"
"2009-04-07",2008,"Stevenage Borough","Cambridge United","2-1",2,1,5,5,3,1,"H"
"2009-04-07",2008,"Wrexham","Histon","0-0",0,0,5,5,0,0,"D"
"2009-04-07",2008,"York City","Oxford United","0-0",0,0,5,5,0,0,"D"
"2009-04-09",2008,"Ebbsfleet United","Kidderminster Harriers","1-1",1,1,5,5,2,0,"D"
"2009-04-11",2008,"Altrincham","Kidderminster Harriers","2-2",2,2,5,5,4,0,"D"
"2009-04-11",2008,"Burton Albion","Histon","3-1",3,1,5,5,4,2,"H"
"2009-04-11",2008,"Cambridge United","Eastbourne Borough","2-1",2,1,5,5,3,1,"H"
"2009-04-11",2008,"Forest Green Rovers","Woking","0-2",0,2,5,5,2,-2,"A"
"2009-04-11",2008,"Grays Athletic","Salisbury","3-1",3,1,5,5,4,2,"H"
"2009-04-11",2008,"Lewes","Weymouth","1-0",1,0,5,5,1,1,"H"
"2009-04-11",2008,"Mansfield Town","Barrow","2-2",2,2,5,5,4,0,"D"
"2009-04-11",2008,"Oxford United","Wrexham","1-0",1,0,5,5,1,1,"H"
"2009-04-11",2008,"Rushden & Diamonds","Kettering Town","1-0",1,0,5,5,1,1,"H"
"2009-04-11",2008,"Stevenage Borough","Ebbsfleet United","1-0",1,0,5,5,1,1,"H"
"2009-04-11",2008,"Torquay United","Crawley Town","0-2",0,2,5,5,2,-2,"A"
"2009-04-11",2008,"York City","Northwich Victoria","1-2",1,2,5,5,3,-1,"A"
"2009-04-13",2008,"Barrow","York City","0-0",0,0,5,5,0,0,"D"
"2009-04-13",2008,"Crawley Town","Stevenage Borough","0-2",0,2,5,5,2,-2,"A"
"2009-04-13",2008,"Eastbourne Borough","Grays Athletic","2-1",2,1,5,5,3,1,"H"
"2009-04-13",2008,"Ebbsfleet United","Lewes","2-1",2,1,5,5,3,1,"H"
"2009-04-13",2008,"Histon","Rushden & Diamonds","0-0",0,0,5,5,0,0,"D"
"2009-04-13",2008,"Kettering Town","Cambridge United","1-2",1,2,5,5,3,-1,"A"
"2009-04-13",2008,"Kidderminster Harriers","Burton Albion","2-1",2,1,5,5,3,1,"H"
"2009-04-13",2008,"Northwich Victoria","Mansfield Town","2-0",2,0,5,5,2,2,"H"
"2009-04-13",2008,"Salisbury","Torquay United","2-2",2,2,5,5,4,0,"D"
"2009-04-13",2008,"Weymouth","Forest Green Rovers","1-1",1,1,5,5,2,0,"D"
"2009-04-13",2008,"Woking","Oxford United","0-2",0,2,5,5,2,-2,"A"
"2009-04-13",2008,"Wrexham","Altrincham","0-1",0,1,5,5,1,-1,"A"
"2009-04-15",2008,"Kettering Town","Crawley Town","1-1",1,1,5,5,2,0,"D"
"2009-04-16",2008,"Histon","Ebbsfleet United","5-2",5,2,5,5,7,3,"H"
"2009-04-17",2008,"Burton Albion","Oxford United","0-1",0,1,5,5,1,-1,"A"
"2009-04-18",2008,"Altrincham","Grays Athletic","2-0",2,0,5,5,2,2,"H"
"2009-04-18",2008,"Barrow","Crawley Town","3-3",3,3,5,5,6,0,"D"
"2009-04-18",2008,"Forest Green Rovers","Rushden & Diamonds","4-0",4,0,5,5,4,4,"H"
"2009-04-18",2008,"Histon","Kidderminster Harriers","1-1",1,1,5,5,2,0,"D"
"2009-04-18",2008,"Kettering Town","Wrexham","1-0",1,0,5,5,1,1,"H"
"2009-04-18",2008,"Northwich Victoria","Lewes","3-0",3,0,5,5,3,3,"H"
"2009-04-18",2008,"Salisbury","Cambridge United","1-2",1,2,5,5,3,-1,"A"
"2009-04-18",2008,"Stevenage Borough","Torquay United","0-0",0,0,5,5,0,0,"D"
"2009-04-18",2008,"Weymouth","Ebbsfleet United","0-2",0,2,5,5,2,-2,"A"
"2009-04-18",2008,"Woking","Mansfield Town","2-2",2,2,5,5,4,0,"D"
"2009-04-18",2008,"York City","Eastbourne Borough","1-0",1,0,5,5,1,1,"H"
"2009-04-21",2008,"Barrow","Torquay United","1-1",1,1,5,5,2,0,"D"
"2009-04-21",2008,"Ebbsfleet United","Wrexham","1-0",1,0,5,5,1,1,"H"
"2009-04-21",2008,"Grays Athletic","Crawley Town","1-0",1,0,5,5,1,1,"H"
"2009-04-21",2008,"Histon","Weymouth","1-0",1,0,5,5,1,1,"H"
"2009-04-21",2008,"Lewes","Kettering Town","1-2",1,2,5,5,3,-1,"A"
"2009-04-21",2008,"Mansfield Town","Altrincham","2-0",2,0,5,5,2,2,"H"
"2009-04-21",2008,"Stevenage Borough","Kidderminster Harriers","3-1",3,1,5,5,4,2,"H"
"2009-04-21",2008,"York City","Forest Green Rovers","2-1",2,1,5,5,3,1,"H"
"2009-04-23",2008,"Northwich Victoria","Ebbsfleet United","2-0",2,0,5,5,2,2,"H"
"2009-04-24",2008,"Weymouth","York City","1-2",1,2,5,5,3,-1,"A"
"2009-04-26",2008,"Cambridge United","Altrincham","0-0",0,0,5,5,0,0,"D"
"2009-04-26",2008,"Crawley Town","Histon","3-3",3,3,5,5,6,0,"D"
"2009-04-26",2008,"Eastbourne Borough","Barrow","0-2",0,2,5,5,2,-2,"A"
"2009-04-26",2008,"Ebbsfleet United","Salisbury","2-2",2,2,5,5,4,0,"D"
"2009-04-26",2008,"Grays Athletic","Forest Green Rovers","2-1",2,1,5,5,3,1,"H"
"2009-04-26",2008,"Kidderminster Harriers","Kettering Town","0-1",0,1,5,5,1,-1,"A"
"2009-04-26",2008,"Lewes","York City","1-1",1,1,5,5,2,0,"D"
"2009-04-26",2008,"Mansfield Town","Stevenage Borough","2-1",2,1,5,5,3,1,"H"
"2009-04-26",2008,"Oxford United","Northwich Victoria","1-2",1,2,5,5,3,-1,"A"
"2009-04-26",2008,"Rushden & Diamonds","Woking","3-1",3,1,5,5,4,2,"H"
"2009-04-26",2008,"Torquay United","Burton Albion","2-1",2,1,5,5,3,1,"H"
"2009-04-26",2008,"Wrexham","Weymouth","2-0",2,0,5,5,2,2,"H"
"2009-08-08",2009,"AFC Wimbledon","Luton Town","1-1",1,1,5,5,2,0,"D"
"2009-08-08",2009,"Altrincham","Ebbsfleet United","1-1",1,1,5,5,2,0,"D"
"2009-08-08",2009,"Cambridge United","Barrow","0-2",0,2,5,5,2,-2,"A"
"2009-08-08",2009,"Forest Green Rovers","Kettering Town","1-2",1,2,5,5,3,-1,"A"
"2009-08-08",2009,"Gateshead","Histon","0-3",0,3,5,5,3,-3,"A"
"2009-08-08",2009,"Kidderminster Harriers","Hayes & Yeading","1-0",1,0,5,5,1,1,"H"
"2009-08-08",2009,"Mansfield Town","Crawley Town","4-0",4,0,5,5,4,4,"H"
"2009-08-08",2009,"Oxford United","York City","2-1",2,1,5,5,3,1,"H"
"2009-08-08",2009,"Rushden & Diamonds","Salisbury","0-2",0,2,5,5,2,-2,"A"
"2009-08-08",2009,"Stevenage Borough","Tamworth","1-1",1,1,5,5,2,0,"D"
"2009-08-08",2009,"Wrexham","Eastbourne Borough","3-0",3,0,5,5,3,3,"H"
"2009-08-11",2009,"Barrow","Altrincham","0-3",0,3,5,5,3,-3,"A"
"2009-08-11",2009,"Crawley Town","Forest Green Rovers","3-1",3,1,5,5,4,2,"H"
"2009-08-11",2009,"Eastbourne Borough","AFC Wimbledon","1-0",1,0,5,5,1,1,"H"
"2009-08-11",2009,"Ebbsfleet United","Cambridge United","1-3",1,3,5,5,4,-2,"A"
"2009-08-11",2009,"Hayes & Yeading","Stevenage Borough","1-1",1,1,5,5,2,0,"D"
"2009-08-11",2009,"Histon","Grays Athletic","0-0",0,0,5,5,0,0,"D"
"2009-08-11",2009,"Kettering Town","Oxford United","1-1",1,1,5,5,2,0,"D"
"2009-08-11",2009,"Luton Town","Mansfield Town","4-1",4,1,5,5,5,3,"H"
"2009-08-11",2009,"Salisbury","Kidderminster Harriers","1-0",1,0,5,5,1,1,"H"
"2009-08-11",2009,"York City","Rushden & Diamonds","0-0",0,0,5,5,0,0,"D"
"2009-08-15",2009,"Barrow","Stevenage Borough","0-0",0,0,5,5,0,0,"D"
"2009-08-15",2009,"Crawley Town","Wrexham","1-0",1,0,5,5,1,1,"H"
"2009-08-15",2009,"Eastbourne Borough","Rushden & Diamonds","1-1",1,1,5,5,2,0,"D"
"2009-08-15",2009,"Ebbsfleet United","Kidderminster Harriers","0-0",0,0,5,5,0,0,"D"
"2009-08-15",2009,"Hayes & Yeading","Altrincham","1-2",1,2,5,5,3,-1,"A"
"2009-08-15",2009,"Histon","Oxford United","3-4",3,4,5,5,7,-1,"A"
"2009-08-15",2009,"Kettering Town","AFC Wimbledon","1-2",1,2,5,5,3,-1,"A"
"2009-08-15",2009,"Luton Town","Gateshead","2-1",2,1,5,5,3,1,"H"
"2009-08-15",2009,"Salisbury","Mansfield Town","0-1",0,1,5,5,1,-1,"A"
"2009-08-15",2009,"Tamworth","Grays Athletic","2-1",2,1,5,5,3,1,"H"
"2009-08-15",2009,"York City","Forest Green Rovers","2-0",2,0,5,5,2,2,"H"
"2009-08-18",2009,"AFC Wimbledon","Salisbury","4-0",4,0,5,5,4,4,"H"
"2009-08-18",2009,"Altrincham","Histon","2-1",2,1,5,5,3,1,"H"
"2009-08-18",2009,"Cambridge United","Crawley Town","0-1",0,1,5,5,1,-1,"A"
"2009-08-18",2009,"Forest Green Rovers","Luton Town","0-1",0,1,5,5,1,-1,"A"
"2009-08-18",2009,"Gateshead","Tamworth","1-1",1,1,5,5,2,0,"D"
"2009-08-18",2009,"Grays Athletic","Eastbourne Borough","1-0",1,0,5,5,1,1,"H"
"2009-08-18",2009,"Kidderminster Harriers","Kettering Town","0-1",0,1,5,5,1,-1,"A"
"2009-08-18",2009,"Mansfield Town","Barrow","4-1",4,1,5,5,5,3,"H"
"2009-08-18",2009,"Rushden & Diamonds","Hayes & Yeading","2-1",2,1,5,5,3,1,"H"
"2009-08-18",2009,"Stevenage Borough","Ebbsfleet United","3-0",3,0,5,5,3,3,"H"
"2009-08-18",2009,"Wrexham","York City","1-0",1,0,5,5,1,1,"H"
"2009-08-22",2009,"Altrincham","AFC Wimbledon","0-1",0,1,5,5,1,-1,"A"
"2009-08-22",2009,"Crawley Town","Gateshead","1-4",1,4,5,5,5,-3,"A"
"2009-08-22",2009,"Eastbourne Borough","Barrow","2-1",2,1,5,5,3,1,"H"
"2009-08-22",2009,"Grays Athletic","Kidderminster Harriers","1-3",1,3,5,5,4,-2,"A"
"2009-08-22",2009,"Hayes & Yeading","York City","1-1",1,1,5,5,2,0,"D"
"2009-08-22",2009,"Histon","Salisbury","2-0",2,0,5,5,2,2,"H"
"2009-08-22",2009,"Mansfield Town","Ebbsfleet United","3-0",3,0,5,5,3,3,"H"
"2009-08-22",2009,"Oxford United","Stevenage Borough","2-1",2,1,5,5,3,1,"H"
"2009-08-22",2009,"Rushden & Diamonds","Forest Green Rovers","4-2",4,2,5,5,6,2,"H"
"2009-08-22",2009,"Tamworth","Cambridge United","0-0",0,0,5,5,0,0,"D"
"2009-08-22",2009,"Wrexham","Kettering Town","1-2",1,2,5,5,3,-1,"A"
"2009-08-25",2009,"Gateshead","York City","1-2",1,2,5,5,3,-1,"A"
"2009-08-25",2009,"Tamworth","Wrexham","2-1",2,1,5,5,3,1,"H"
"2009-08-29",2009,"AFC Wimbledon","Oxford United","0-1",0,1,5,5,1,-1,"A"
"2009-08-29",2009,"Barrow","Tamworth","1-0",1,0,5,5,1,1,"H"
"2009-08-29",2009,"Cambridge United","Gateshead","3-0",3,0,5,5,3,3,"H"
"2009-08-29",2009,"Crawley Town","Grays Athletic","1-1",1,1,5,5,2,0,"D"
"2009-08-29",2009,"Ebbsfleet United","Hayes & Yeading","1-2",1,2,5,5,3,-1,"A"
"2009-08-29",2009,"Forest Green Rovers","Wrexham","0-2",0,2,5,5,2,-2,"A"
"2009-08-29",2009,"Kettering Town","Luton Town","0-0",0,0,5,5,0,0,"D"
"2009-08-29",2009,"Kidderminster Harriers","Altrincham","3-0",3,0,5,5,3,3,"H"
"2009-08-29",2009,"Salisbury","Eastbourne Borough","1-1",1,1,5,5,2,0,"D"
"2009-08-29",2009,"Stevenage Borough","Rushden & Diamonds","2-1",2,1,5,5,3,1,"H"
"2009-08-29",2009,"York City","Histon","3-1",3,1,5,5,4,2,"H"
"2009-08-31",2009,"Eastbourne Borough","Ebbsfleet United","1-2",1,2,5,5,3,-1,"A"
"2009-08-31",2009,"Grays Athletic","AFC Wimbledon","2-4",2,4,5,5,6,-2,"A"
"2009-08-31",2009,"Hayes & Yeading","Salisbury","3-4",3,4,5,5,7,-1,"A"
"2009-08-31",2009,"Histon","Stevenage Borough","0-2",0,2,5,5,2,-2,"A"
"2009-08-31",2009,"Mansfield Town","Kettering Town","0-0",0,0,5,5,0,0,"D"
"2009-08-31",2009,"Oxford United","Forest Green Rovers","0-0",0,0,5,5,0,0,"D"
"2009-08-31",2009,"Rushden & Diamonds","Cambridge United","1-1",1,1,5,5,2,0,"D"
"2009-08-31",2009,"Tamworth","Kidderminster Harriers","2-1",2,1,5,5,3,1,"H"
"2009-08-31",2009,"Wrexham","Barrow","0-0",0,0,5,5,0,0,"D"
"2009-09-01",2009,"Luton Town","Crawley Town","3-0",3,0,5,5,3,3,"H"
"2009-09-05",2009,"Barrow","Rushden & Diamonds","1-6",1,6,5,5,7,-5,"A"
"2009-09-05",2009,"Cambridge United","Forest Green Rovers","7-0",7,0,5,5,7,7,"H"
"2009-09-05",2009,"Ebbsfleet United","Oxford United","0-2",0,2,5,5,2,-2,"A"
"2009-09-05",2009,"Gateshead","Hayes & Yeading","0-0",0,0,5,5,0,0,"D"
"2009-09-05",2009,"Grays Athletic","Mansfield Town","1-1",1,1,5,5,2,0,"D"
"2009-09-05",2009,"Kettering Town","Altrincham","2-0",2,0,5,5,2,2,"H"
"2009-09-05",2009,"Kidderminster Harriers","Eastbourne Borough","0-2",0,2,5,5,2,-2,"A"
"2009-09-05",2009,"Salisbury","Luton Town","1-1",1,1,5,5,2,0,"D"
"2009-09-05",2009,"Tamworth","AFC Wimbledon","2-2",2,2,5,5,4,0,"D"
"2009-09-05",2009,"York City","Crawley Town","2-0",2,0,5,5,2,2,"H"
"2009-09-08",2009,"Barrow","York City","0-0",0,0,5,5,0,0,"D"
"2009-09-08",2009,"Cambridge United","Altrincham","0-0",0,0,5,5,0,0,"D"
"2009-09-08",2009,"Crawley Town","Histon","2-0",2,0,5,5,2,2,"H"
"2009-09-08",2009,"Ebbsfleet United","Rushden & Diamonds","0-0",0,0,5,5,0,0,"D"
"2009-09-08",2009,"Forest Green Rovers","Hayes & Yeading","0-0",0,0,5,5,0,0,"D"
"2009-09-08",2009,"Kettering Town","Gateshead","4-0",4,0,5,5,4,4,"H"
"2009-09-08",2009,"Kidderminster Harriers","Mansfield Town","3-1",3,1,5,5,4,2,"H"
"2009-09-08",2009,"Oxford United","Luton Town","2-0",2,0,5,5,2,2,"H"
"2009-09-08",2009,"Salisbury","Grays Athletic","2-0",2,0,5,5,2,2,"H"
"2009-09-08",2009,"Stevenage Borough","Eastbourne Borough","2-0",2,0,5,5,2,2,"H"
"2009-09-12",2009,"AFC Wimbledon","Cambridge United","0-0",0,0,5,5,0,0,"D"
"2009-09-12",2009,"Altrincham","Crawley Town","0-0",0,0,5,5,0,0,"D"
"2009-09-12",2009,"Forest Green Rovers","Ebbsfleet United","0-0",0,0,5,5,0,0,"D"
"2009-09-12",2009,"Gateshead","Salisbury","2-1",2,1,5,5,3,1,"H"
"2009-09-12",2009,"Hayes & Yeading","Tamworth","2-2",2,2,5,5,4,0,"D"
"2009-09-12",2009,"Histon","Kidderminster Harriers","1-1",1,1,5,5,2,0,"D"
"2009-09-12",2009,"Luton Town","Barrow","1-0",1,0,5,5,1,1,"H"
"2009-09-12",2009,"Mansfield Town","Stevenage Borough","2-3",2,3,5,5,5,-1,"A"
"2009-09-12",2009,"Rushden & Diamonds","Grays Athletic","5-4",5,4,5,5,9,1,"H"
"2009-09-12",2009,"Wrexham","Oxford United","0-1",0,1,5,5,1,-1,"A"
"2009-09-12",2009,"York City","Kettering Town","2-0",2,0,5,5,2,2,"H"
"2009-09-19",2009,"Barrow","Forest Green Rovers","1-1",1,1,5,5,2,0,"D"
"2009-09-19",2009,"Cambridge United","Wrexham","2-0",2,0,5,5,2,2,"H"
"2009-09-19",2009,"Crawley Town","Kettering Town","2-1",2,1,5,5,3,1,"H"
"2009-09-19",2009,"Ebbsfleet United","AFC Wimbledon","2-2",2,2,5,5,4,0,"D"
"2009-09-19",2009,"Grays Athletic","Altrincham","0-3",0,3,5,5,3,-3,"A"
"2009-09-19",2009,"Hayes & Yeading","Histon","0-2",0,2,5,5,2,-2,"A"
"2009-09-19",2009,"Kidderminster Harriers","Gateshead","3-2",3,2,5,5,5,1,"H"
"2009-09-19",2009,"Oxford United","Eastbourne Borough","4-0",4,0,5,5,4,4,"H"
"2009-09-19",2009,"Rushden & Diamonds","Mansfield Town","1-0",1,0,5,5,1,1,"H"
"2009-09-19",2009,"Tamworth","Salisbury","2-0",2,0,5,5,2,2,"H"
"2009-09-22",2009,"AFC Wimbledon","Crawley Town","1-1",1,1,5,5,2,0,"D"
"2009-09-22",2009,"Altrincham","Tamworth","0-0",0,0,5,5,0,0,"D"
"2009-09-22",2009,"Eastbourne Borough","Hayes & Yeading","3-1",3,1,5,5,4,2,"H"
"2009-09-22",2009,"Forest Green Rovers","Kidderminster Harriers","1-1",1,1,5,5,2,0,"D"
"2009-09-22",2009,"Gateshead","Rushden & Diamonds","0-0",0,0,5,5,0,0,"D"
"2009-09-22",2009,"Histon","Ebbsfleet United","1-0",1,0,5,5,1,1,"H"
"2009-09-22",2009,"Kettering Town","Barrow","2-1",2,1,5,5,3,1,"H"
"2009-09-22",2009,"Mansfield Town","Oxford United","2-1",2,1,5,5,3,1,"H"
"2009-09-22",2009,"Stevenage Borough","Grays Athletic","1-1",1,1,5,5,2,0,"D"
"2009-09-22",2009,"Wrexham","Luton Town","3-0",3,0,5,5,3,3,"H"
"2009-09-22",2009,"York City","Cambridge United","2-2",2,2,5,5,4,0,"D"
"2009-09-26",2009,"AFC Wimbledon","Histon","4-0",4,0,5,5,4,4,"H"
"2009-09-26",2009,"Cambridge United","Luton Town","3-4",3,4,5,5,7,-1,"A"
"2009-09-26",2009,"Crawley Town","Rushden & Diamonds","2-1",2,1,5,5,3,1,"H"
"2009-09-26",2009,"Eastbourne Borough","Tamworth","1-1",1,1,5,5,2,0,"D"
"2009-09-26",2009,"Forest Green Rovers","Grays Athletic","2-1",2,1,5,5,3,1,"H"
"2009-09-26",2009,"Gateshead","Oxford United","0-1",0,1,5,5,1,-1,"A"
"2009-09-26",2009,"Kettering Town","Ebbsfleet United","3-0",3,0,5,5,3,3,"H"
"2009-09-26",2009,"Mansfield Town","Hayes & Yeading","3-1",3,1,5,5,4,2,"H"
"2009-09-26",2009,"Salisbury","Barrow","3-0",3,0,5,5,3,3,"H"
"2009-09-26",2009,"Stevenage Borough","Altrincham","1-1",1,1,5,5,2,0,"D"
"2009-09-26",2009,"York City","Kidderminster Harriers","3-2",3,2,5,5,5,1,"H"
"2009-09-29",2009,"Altrincham","Gateshead","3-2",3,2,5,5,5,1,"H"
"2009-09-29",2009,"Barrow","Mansfield Town","3-1",3,1,5,5,4,2,"H"
"2009-09-29",2009,"Ebbsfleet United","Salisbury","1-2",1,2,5,5,3,-1,"A"
"2009-09-29",2009,"Grays Athletic","Cambridge United","2-0",2,0,5,5,2,2,"H"
"2009-09-29",2009,"Hayes & Yeading","Kettering Town","1-2",1,2,5,5,3,-1,"A"
"2009-09-29",2009,"Histon","Eastbourne Borough","2-0",2,0,5,5,2,2,"H"
"2009-09-29",2009,"Kidderminster Harriers","Wrexham","2-0",2,0,5,5,2,2,"H"
"2009-09-29",2009,"Luton Town","Stevenage Borough","0-1",0,1,5,5,1,-1,"A"
"2009-09-29",2009,"Oxford United","Crawley Town","3-1",3,1,5,5,4,2,"H"
"2009-09-29",2009,"Rushden & Diamonds","AFC Wimbledon","0-1",0,1,5,5,1,-1,"A"
"2009-10-03",2009,"AFC Wimbledon","Kidderminster Harriers","0-1",0,1,5,5,1,-1,"A"
"2009-10-03",2009,"Barrow","Oxford United","1-1",1,1,5,5,2,0,"D"
"2009-10-03",2009,"Eastbourne Borough","Kettering Town","0-1",0,1,5,5,1,-1,"A"
"2009-10-03",2009,"Ebbsfleet United","Crawley Town","0-0",0,0,5,5,0,0,"D"
"2009-10-03",2009,"Grays Athletic","Gateshead","0-0",0,0,5,5,0,0,"D"
"2009-10-03",2009,"Luton Town","Tamworth","2-1",2,1,5,5,3,1,"H"
"2009-10-03",2009,"Mansfield Town","Forest Green Rovers","1-0",1,0,5,5,1,1,"H"
"2009-10-03",2009,"Rushden & Diamonds","Altrincham","0-1",0,1,5,5,1,-1,"A"
"2009-10-03",2009,"Wrexham","Salisbury","1-2",1,2,5,5,3,-1,"A"
"2009-10-03",2009,"York City","Stevenage Borough","1-1",1,1,5,5,2,0,"D"
"2009-10-04",2009,"Histon","Cambridge United","1-1",1,1,5,5,2,0,"D"
"2009-10-06",2009,"Tamworth","York City","2-3",2,3,5,5,5,-1,"A"
"2009-10-10",2009,"Altrincham","Mansfield Town","1-2",1,2,5,5,3,-1,"A"
"2009-10-10",2009,"Cambridge United","Ebbsfleet United","4-0",4,0,5,5,4,4,"H"
"2009-10-10",2009,"Crawley Town","Barrow","0-1",0,1,5,5,1,-1,"A"
"2009-10-10",2009,"Forest Green Rovers","AFC Wimbledon","2-5",2,5,5,5,7,-3,"A"
"2009-10-10",2009,"Gateshead","Eastbourne Borough","3-0",3,0,5,5,3,3,"H"
"2009-10-10",2009,"Kidderminster Harriers","Luton Town","1-2",1,2,5,5,3,-1,"A"
"2009-10-10",2009,"Oxford United","Grays Athletic","5-0",5,0,5,5,5,5,"H"
"2009-10-10",2009,"Salisbury","York City","1-0",1,0,5,5,1,1,"H"
"2009-10-10",2009,"Stevenage Borough","Hayes & Yeading","4-0",4,0,5,5,4,4,"H"
"2009-10-10",2009,"Tamworth","Histon","1-3",1,3,5,5,4,-2,"A"
"2009-10-17",2009,"AFC Wimbledon","Kettering Town","1-2",1,2,5,5,3,-1,"A"
"2009-10-17",2009,"Altrincham","Luton Town","0-1",0,1,5,5,1,-1,"A"
"2009-10-17",2009,"Barrow","Ebbsfleet United","2-0",2,0,5,5,2,2,"H"
"2009-10-17",2009,"Eastbourne Borough","Mansfield Town","1-2",1,2,5,5,3,-1,"A"
"2009-10-17",2009,"Hayes & Yeading","Cambridge United","3-0",3,0,5,5,3,3,"H"
"2009-10-17",2009,"Histon","Forest Green Rovers","5-2",5,2,5,5,7,3,"H"
"2009-10-17",2009,"Kidderminster Harriers","Crawley Town","1-0",1,0,5,5,1,1,"H"
"2009-10-17",2009,"Rushden & Diamonds","Tamworth","3-2",3,2,5,5,5,1,"H"
"2009-10-17",2009,"Stevenage Borough","Salisbury","3-1",3,1,5,5,4,2,"H"
"2009-10-17",2009,"Wrexham","Grays Athletic","2-1",2,1,5,5,3,1,"H"
"2009-10-17",2009,"York City","Oxford United","1-1",1,1,5,5,2,0,"D"
"2009-10-20",2009,"Luton Town","York City","1-1",1,1,5,5,2,0,"D"
"2009-10-20",2009,"Stevenage Borough","Wrexham","0-0",0,0,5,5,0,0,"D"
"2009-10-31",2009,"Cambridge United","Kidderminster Harriers","2-0",2,0,5,5,2,2,"H"
"2009-10-31",2009,"Crawley Town","York City","3-1",3,1,5,5,4,2,"H"
"2009-10-31",2009,"Ebbsfleet United","Wrexham","0-1",0,1,5,5,1,-1,"A"
"2009-10-31",2009,"Forest Green Rovers","Eastbourne Borough","1-1",1,1,5,5,2,0,"D"
"2009-10-31",2009,"Grays Athletic","Barrow","3-3",3,3,5,5,6,0,"D"
"2009-10-31",2009,"Kettering Town","Stevenage Borough","1-1",1,1,5,5,2,0,"D"
"2009-10-31",2009,"Luton Town","Rushden & Diamonds","0-2",0,2,5,5,2,-2,"A"
"2009-10-31",2009,"Mansfield Town","Histon","1-1",1,1,5,5,2,0,"D"
"2009-10-31",2009,"Oxford United","Altrincham","1-0",1,0,5,5,1,1,"H"
"2009-10-31",2009,"Salisbury","Gateshead","0-1",0,1,5,5,1,-1,"A"
"2009-10-31",2009,"Tamworth","Hayes & Yeading","0-2",0,2,5,5,2,-2,"A"
"2009-11-03",2009,"Kettering Town","Wrexham","2-2",2,2,5,5,4,0,"D"
"2009-11-14",2009,"Altrincham","Forest Green Rovers","2-2",2,2,5,5,4,0,"D"
"2009-11-14",2009,"Barrow","AFC Wimbledon","2-2",2,2,5,5,4,0,"D"
"2009-11-14",2009,"Cambridge United","Kettering Town","0-2",0,2,5,5,2,-2,"A"
"2009-11-14",2009,"Crawley Town","Mansfield Town","0-2",0,2,5,5,2,-2,"A"
"2009-11-14",2009,"Eastbourne Borough","Salisbury","0-1",0,1,5,5,1,-1,"A"
"2009-11-14",2009,"Grays Athletic","Luton Town","0-2",0,2,5,5,2,-2,"A"
"2009-11-14",2009,"Kidderminster Harriers","Oxford United","3-1",3,1,5,5,4,2,"H"
"2009-11-14",2009,"Rushden & Diamonds","Histon","2-1",2,1,5,5,3,1,"H"
"2009-11-14",2009,"Stevenage Borough","Gateshead","5-3",5,3,5,5,8,2,"H"
"2009-11-14",2009,"Wrexham","Hayes & Yeading","0-2",0,2,5,5,2,-2,"A"
"2009-11-14",2009,"York City","Ebbsfleet United","1-0",1,0,5,5,1,1,"H"
"2009-11-21",2009,"AFC Wimbledon","York City","0-1",0,1,5,5,1,-1,"A"
"2009-11-21",2009,"Ebbsfleet United","Tamworth","0-1",0,1,5,5,1,-1,"A"
"2009-11-21",2009,"Forest Green Rovers","Stevenage Borough","0-1",0,1,5,5,1,-1,"A"
"2009-11-21",2009,"Gateshead","Grays Athletic","3-0",3,0,5,5,3,3,"H"
"2009-11-21",2009,"Hayes & Yeading","Crawley Town","2-1",2,1,5,5,3,1,"H"
"2009-11-21",2009,"Histon","Wrexham","0-0",0,0,5,5,0,0,"D"
"2009-11-21",2009,"Kettering Town","Kidderminster Harriers","0-2",0,2,5,5,2,-2,"A"
"2009-11-21",2009,"Luton Town","Cambridge United","2-2",2,2,5,5,4,0,"D"
"2009-11-21",2009,"Mansfield Town","Eastbourne Borough","1-1",1,1,5,5,2,0,"D"
"2009-11-21",2009,"Oxford United","Barrow","1-0",1,0,5,5,1,1,"H"
"2009-11-21",2009,"Salisbury","Rushden & Diamonds","1-3",1,3,5,5,4,-2,"A"
"2009-11-24",2009,"AFC Wimbledon","Ebbsfleet United","3-0",3,0,5,5,3,3,"H"
"2009-11-24",2009,"Barrow","Grays Athletic","2-2",2,2,5,5,4,0,"D"
"2009-11-24",2009,"Cambridge United","Rushden & Diamonds","2-2",2,2,5,5,4,0,"D"
"2009-11-24",2009,"Crawley Town","Salisbury","2-0",2,0,5,5,2,2,"H"
"2009-11-24",2009,"Eastbourne Borough","Histon","1-1",1,1,5,5,2,0,"D"
"2009-11-24",2009,"Forest Green Rovers","Oxford United","0-1",0,1,5,5,1,-1,"A"
"2009-11-24",2009,"Kettering Town","Hayes & Yeading","0-1",0,1,5,5,1,-1,"A"
"2009-11-24",2009,"Tamworth","Altrincham","0-2",0,2,5,5,2,-2,"A"
"2009-11-24",2009,"Wrexham","Kidderminster Harriers","2-2",2,2,5,5,4,0,"D"
"2009-11-24",2009,"York City","Gateshead","1-0",1,0,5,5,1,1,"H"
"2009-11-28",2009,"Ebbsfleet United","Mansfield Town","2-1",2,1,5,5,3,1,"H"
"2009-11-28",2009,"Gateshead","Crawley Town","2-1",2,1,5,5,3,1,"H"
"2009-11-28",2009,"Grays Athletic","Tamworth","1-0",1,0,5,5,1,1,"H"
"2009-11-28",2009,"Kidderminster Harriers","AFC Wimbledon","0-1",0,1,5,5,1,-1,"A"
"2009-11-28",2009,"Salisbury","Stevenage Borough","0-1",0,1,5,5,1,-1,"A"
"2009-12-01",2009,"Altrincham","Barrow","0-1",0,1,5,5,1,-1,"A"
"2009-12-01",2009,"Crawley Town","Oxford United","1-2",1,2,5,5,3,-1,"A"
"2009-12-01",2009,"Ebbsfleet United","Stevenage Borough","2-1",2,1,5,5,3,1,"H"
"2009-12-01",2009,"Gateshead","Mansfield Town","1-3",1,3,5,5,4,-2,"A"
"2009-12-01",2009,"Grays Athletic","Histon","0-1",0,1,5,5,1,-1,"A"
"2009-12-01",2009,"Hayes & Yeading","Eastbourne Borough","1-1",1,1,5,5,2,0,"D"
"2009-12-01",2009,"Kidderminster Harriers","Tamworth","0-0",0,0,5,5,0,0,"D"
"2009-12-01",2009,"Rushden & Diamonds","York City","0-1",0,1,5,5,1,-1,"A"
"2009-12-01",2009,"Salisbury","AFC Wimbledon","0-2",0,2,5,5,2,-2,"A"
"2009-12-01",2009,"Wrexham","Forest Green Rovers","1-0",1,0,5,5,1,1,"H"
"2009-12-02",2009,"Luton Town","Kettering Town","0-1",0,1,5,5,1,-1,"A"
"2009-12-05",2009,"AFC Wimbledon","Gateshead","2-0",2,0,5,5,2,2,"H"
"2009-12-05",2009,"Barrow","Hayes & Yeading","1-1",1,1,5,5,2,0,"D"
"2009-12-05",2009,"Eastbourne Borough","Cambridge United","2-2",2,2,5,5,4,0,"D"
"2009-12-05",2009,"Forest Green Rovers","Rushden & Diamonds","1-0",1,0,5,5,1,1,"H"
"2009-12-05",2009,"Histon","Altrincham","0-0",0,0,5,5,0,0,"D"
"2009-12-05",2009,"Kettering Town","Salisbury","1-2",1,2,5,5,3,-1,"A"
"2009-12-05",2009,"Mansfield Town","Grays Athletic","0-0",0,0,5,5,0,0,"D"
"2009-12-05",2009,"Oxford United","Ebbsfleet United","4-2",4,2,5,5,6,2,"H"
"2009-12-05",2009,"Stevenage Borough","Kidderminster Harriers","2-0",2,0,5,5,2,2,"H"
"2009-12-05",2009,"Tamworth","Crawley Town","0-1",0,1,5,5,1,-1,"A"
"2009-12-05",2009,"York City","Wrexham","2-1",2,1,5,5,3,1,"H"
"2009-12-26",2009,"AFC Wimbledon","Hayes & Yeading","5-0",5,0,5,5,5,5,"H"
"2009-12-26",2009,"Barrow","Gateshead","3-3",3,3,5,5,6,0,"D"
"2009-12-26",2009,"Cambridge United","Stevenage Borough","1-3",1,3,5,5,4,-2,"A"
"2009-12-26",2009,"Crawley Town","Eastbourne Borough","2-2",2,2,5,5,4,0,"D"
"2009-12-26",2009,"Ebbsfleet United","Grays Athletic","2-1",2,1,5,5,3,1,"H"
"2009-12-26",2009,"Forest Green Rovers","Salisbury","3-1",3,1,5,5,4,2,"H"
"2009-12-26",2009,"Kettering Town","Tamworth","0-0",0,0,5,5,0,0,"D"
"2009-12-26",2009,"York City","Mansfield Town","3-0",3,0,5,5,3,3,"H"
"2009-12-28",2009,"Grays Athletic","Crawley Town","2-3",2,3,5,5,5,-1,"A"
"2009-12-28",2009,"Hayes & Yeading","Ebbsfleet United","4-2",4,2,5,5,6,2,"H"
"2009-12-28",2009,"Histon","Kettering Town","1-0",1,0,5,5,1,1,"H"
"2009-12-28",2009,"Luton Town","Eastbourne Borough","4-1",4,1,5,5,5,3,"H"
"2009-12-28",2009,"Mansfield Town","Cambridge United","2-1",2,1,5,5,3,1,"H"
"2009-12-28",2009,"Rushden & Diamonds","Kidderminster Harriers","2-1",2,1,5,5,3,1,"H"
"2009-12-28",2009,"Salisbury","Oxford United","1-1",1,1,5,5,2,0,"D"
"2009-12-28",2009,"Stevenage Borough","AFC Wimbledon","0-0",0,0,5,5,0,0,"D"
"2009-12-28",2009,"Tamworth","Forest Green Rovers","0-0",0,0,5,5,0,0,"D"
"2010-01-01",2009,"Eastbourne Borough","Crawley Town","0-2",0,2,5,5,2,-2,"A"
"2010-01-01",2009,"Grays Athletic","Ebbsfleet United","0-3",0,3,5,5,3,-3,"A"
"2010-01-01",2009,"Hayes & Yeading","AFC Wimbledon","1-0",1,0,5,5,1,1,"H"
"2010-01-01",2009,"Stevenage Borough","Cambridge United","4-1",4,1,5,5,5,3,"H"
"2010-01-16",2009,"AFC Wimbledon","Mansfield Town","2-0",2,0,5,5,2,2,"H"
"2010-01-16",2009,"Cambridge United","Eastbourne Borough","0-1",0,1,5,5,1,-1,"A"
"2010-01-16",2009,"Ebbsfleet United","Altrincham","1-2",1,2,5,5,3,-1,"A"
"2010-01-16",2009,"Forest Green Rovers","Gateshead","1-0",1,0,5,5,1,1,"H"
"2010-01-16",2009,"Oxford United","Tamworth","0-1",0,1,5,5,1,-1,"A"
"2010-01-16",2009,"York City","Hayes & Yeading","4-1",4,1,5,5,5,3,"H"
"2010-01-19",2009,"Ebbsfleet United","Kettering Town","1-2",1,2,5,5,3,-1,"A"
"2010-01-23",2009,"Altrincham","Hayes & Yeading","3-2",3,2,5,5,5,1,"H"
"2010-01-23",2009,"Cambridge United","York City","0-1",0,1,5,5,1,-1,"A"
"2010-01-23",2009,"Crawley Town","Kidderminster Harriers","2-2",2,2,5,5,4,0,"D"
"2010-01-23",2009,"Ebbsfleet United","Forest Green Rovers","4-3",4,3,5,5,7,1,"H"
"2010-01-23",2009,"Gateshead","Luton Town","0-1",0,1,5,5,1,-1,"A"
"2010-01-23",2009,"Grays Athletic","Oxford United","0-4",0,4,5,5,4,-4,"A"
"2010-01-23",2009,"Rushden & Diamonds","Barrow","4-1",4,1,5,5,5,3,"H"
"2010-01-23",2009,"Salisbury","Histon","3-0",3,0,5,5,3,3,"H"
"2010-01-23",2009,"Stevenage Borough","Kettering Town","2-0",2,0,5,5,2,2,"H"
"2010-01-23",2009,"Tamworth","Eastbourne Borough","1-1",1,1,5,5,2,0,"D"
"2010-01-23",2009,"Wrexham","AFC Wimbledon","1-0",1,0,5,5,1,1,"H"
"2010-01-26",2009,"Gateshead","Kettering Town","0-2",0,2,5,5,2,-2,"A"
"2010-01-26",2009,"Hayes & Yeading","Forest Green Rovers","2-3",2,3,5,5,5,-1,"A"
"2010-01-26",2009,"Kidderminster Harriers","Grays Athletic","4-1",4,1,5,5,5,3,"H"
"2010-01-26",2009,"Rushden & Diamonds","Wrexham","0-0",0,0,5,5,0,0,"D"
"2010-01-27",2009,"Histon","Luton Town","0-2",0,2,5,5,2,-2,"A"
"2010-01-30",2009,"Altrincham","Wrexham","1-3",1,3,5,5,4,-2,"A"
"2010-01-30",2009,"Forest Green Rovers","Mansfield Town","1-4",1,4,5,5,5,-3,"A"
"2010-01-30",2009,"Hayes & Yeading","Rushden & Diamonds","1-6",1,6,5,5,7,-5,"A"
"2010-01-30",2009,"Luton Town","Ebbsfleet United","2-3",2,3,5,5,5,-1,"A"
"2010-02-02",2009,"Histon","York City","1-1",1,1,5,5,2,0,"D"
"2010-02-02",2009,"Wrexham","Mansfield Town","2-1",2,1,5,5,3,1,"H"
"2010-02-06",2009,"AFC Wimbledon","Forest Green Rovers","2-0",2,0,5,5,2,2,"H"
"2010-02-06",2009,"Altrincham","Salisbury","5-0",5,0,5,5,5,5,"H"
"2010-02-06",2009,"Barrow","Luton Town","0-1",0,1,5,5,1,-1,"A"
"2010-02-06",2009,"Crawley Town","Cambridge United","1-0",1,0,5,5,1,1,"H"
"2010-02-06",2009,"Eastbourne Borough","Wrexham","2-1",2,1,5,5,3,1,"H"
"2010-02-06",2009,"Grays Athletic","Rushden & Diamonds","0-3",0,3,5,5,3,-3,"A"
"2010-02-06",2009,"Histon","Hayes & Yeading","3-3",3,3,5,5,6,0,"D"
"2010-02-06",2009,"Kettering Town","York City","0-1",0,1,5,5,1,-1,"A"
"2010-02-06",2009,"Mansfield Town","Gateshead","0-2",0,2,5,5,2,-2,"A"
"2010-02-06",2009,"Oxford United","Kidderminster Harriers","0-0",0,0,5,5,0,0,"D"
"2010-02-06",2009,"Tamworth","Stevenage Borough","1-0",1,0,5,5,1,1,"H"
"2010-02-09",2009,"Ebbsfleet United","Histon","0-1",0,1,5,5,1,-1,"A"
"2010-02-09",2009,"Hayes & Yeading","Grays Athletic","4-0",4,0,5,5,4,4,"H"
"2010-02-09",2009,"Luton Town","Oxford United","2-1",2,1,5,5,3,1,"H"
"2010-02-09",2009,"Rushden & Diamonds","Eastbourne Borough","2-0",2,0,5,5,2,2,"H"
"2010-02-09",2009,"Stevenage Borough","Mansfield Town","3-1",3,1,5,5,4,2,"H"
"2010-02-09",2009,"Wrexham","Tamworth","0-0",0,0,5,5,0,0,"D"
"2010-02-13",2009,"Barrow","Kettering Town","0-2",0,2,5,5,2,-2,"A"
"2010-02-13",2009,"Cambridge United","AFC Wimbledon","2-2",2,2,5,5,4,0,"D"
"2010-02-13",2009,"Crawley Town","Altrincham","1-0",1,0,5,5,1,1,"H"
"2010-02-13",2009,"Eastbourne Borough","Luton Town","0-1",0,1,5,5,1,-1,"A"
"2010-02-13",2009,"Ebbsfleet United","York City","1-0",1,0,5,5,1,1,"H"
"2010-02-13",2009,"Grays Athletic","Salisbury","0-2",0,2,5,5,2,-2,"A"
"2010-02-13",2009,"Hayes & Yeading","Gateshead","3-2",3,2,5,5,5,1,"H"
"2010-02-13",2009,"Kidderminster Harriers","Forest Green Rovers","2-1",2,1,5,5,3,1,"H"
"2010-02-13",2009,"Oxford United","Histon","2-0",2,0,5,5,2,2,"H"
"2010-02-13",2009,"Rushden & Diamonds","Stevenage Borough","1-0",1,0,5,5,1,1,"H"
"2010-02-13",2009,"Tamworth","Mansfield Town","2-4",2,4,5,5,6,-2,"A"
"2010-02-16",2009,"Altrincham","Eastbourne Borough","3-0",3,0,5,5,3,3,"H"
"2010-02-16",2009,"Gateshead","Barrow","2-1",2,1,5,5,3,1,"H"
"2010-02-16",2009,"Oxford United","Rushden & Diamonds","1-0",1,0,5,5,1,1,"H"
"2010-02-16",2009,"Salisbury","Tamworth","1-0",1,0,5,5,1,1,"H"
"2010-02-16",2009,"York City","Luton Town","0-0",0,0,5,5,0,0,"D"
"2010-02-20",2009,"Eastbourne Borough","Altrincham","2-2",2,2,5,5,4,0,"D"
"2010-02-20",2009,"Forest Green Rovers","Cambridge United","1-1",1,1,5,5,2,0,"D"
"2010-02-20",2009,"Gateshead","Ebbsfleet United","1-3",1,3,5,5,4,-2,"A"
"2010-02-20",2009,"Luton Town","AFC Wimbledon","1-2",1,2,5,5,3,-1,"A"
"2010-02-20",2009,"Wrexham","Crawley Town","2-0",2,0,5,5,2,2,"H"
"2010-02-23",2009,"Gateshead","Altrincham","1-0",1,0,5,5,1,1,"H"
"2010-02-23",2009,"Oxford United","AFC Wimbledon","2-0",2,0,5,5,2,2,"H"
"2010-02-23",2009,"Tamworth","Kettering Town","1-3",1,3,5,5,4,-2,"A"
"2010-02-24",2009,"Wrexham","Stevenage Borough","0-1",0,1,5,5,1,-1,"A"
"2010-02-27",2009,"Altrincham","Grays Athletic","1-1",1,1,5,5,2,0,"D"
"2010-02-27",2009,"Crawley Town","Luton Town","2-1",2,1,5,5,3,1,"H"
"2010-02-27",2009,"Ebbsfleet United","Barrow","1-4",1,4,5,5,5,-3,"A"
"2010-02-27",2009,"Hayes & Yeading","Mansfield Town","1-1",1,1,5,5,2,0,"D"
"2010-02-27",2009,"Kidderminster Harriers","Histon","3-0",3,0,5,5,3,3,"H"
"2010-02-27",2009,"Rushden & Diamonds","Kettering Town","0-0",0,0,5,5,0,0,"D"
"2010-02-27",2009,"Salisbury","Wrexham","1-1",1,1,5,5,2,0,"D"
"2010-02-27",2009,"York City","Eastbourne Borough","0-1",0,1,5,5,1,-1,"A"
"2010-03-02",2009,"Cambridge United","Oxford United","1-1",1,1,5,5,2,0,"D"
"2010-03-02",2009,"Eastbourne Borough","Stevenage Borough","0-6",0,6,5,5,6,-6,"A"
"2010-03-02",2009,"Kidderminster Harriers","Ebbsfleet United","2-2",2,2,5,5,4,0,"D"
"2010-03-02",2009,"Mansfield Town","Luton Town","0-0",0,0,5,5,0,0,"D"
"2010-03-02",2009,"Salisbury","Crawley Town","2-2",2,2,5,5,4,0,"D"
"2010-03-02",2009,"Tamworth","Gateshead","1-0",1,0,5,5,1,1,"H"
"2010-03-03",2009,"Histon","Rushden & Diamonds","0-1",0,1,5,5,1,-1,"A"
"2010-03-06",2009,"AFC Wimbledon","Altrincham","1-1",1,1,5,5,2,0,"D"
"2010-03-06",2009,"Barrow","Cambridge United","0-1",0,1,5,5,1,-1,"A"
"2010-03-06",2009,"Eastbourne Borough","Kidderminster Harriers","0-0",0,0,5,5,0,0,"D"
"2010-03-06",2009,"Forest Green Rovers","York City","2-1",2,1,5,5,3,1,"H"
"2010-03-06",2009,"Hayes & Yeading","Luton Town","2-3",2,3,5,5,5,-1,"A"
"2010-03-06",2009,"Histon","Gateshead","0-0",0,0,5,5,0,0,"D"
"2010-03-06",2009,"Kettering Town","Grays Athletic","2-0",2,0,5,5,2,2,"H"
"2010-03-06",2009,"Mansfield Town","Salisbury","4-2",4,2,5,5,6,2,"H"
"2010-03-06",2009,"Stevenage Borough","Crawley Town","2-0",2,0,5,5,2,2,"H"
"2010-03-06",2009,"Tamworth","Rushden & Diamonds","0-1",0,1,5,5,1,-1,"A"
"2010-03-06",2009,"Wrexham","Ebbsfleet United","1-1",1,1,5,5,2,0,"D"
"2010-03-09",2009,"Crawley Town","AFC Wimbledon","2-1",2,1,5,5,3,1,"H"
"2010-03-09",2009,"Histon","Tamworth","1-0",1,0,5,5,1,1,"H"
"2010-03-09",2009,"Kettering Town","Cambridge United","0-1",0,1,5,5,1,-1,"A"
"2010-03-09",2009,"Luton Town","Forest Green Rovers","2-1",2,1,5,5,3,1,"H"
"2010-03-09",2009,"Oxford United","Hayes & Yeading","1-2",1,2,5,5,3,-1,"A"
"2010-03-09",2009,"Stevenage Borough","Barrow","4-0",4,0,5,5,4,4,"H"
"2010-03-09",2009,"Wrexham","Altrincham","1-1",1,1,5,5,2,0,"D"
"2010-03-09",2009,"York City","Salisbury","1-2",1,2,5,5,3,-1,"A"
"2010-03-13",2009,"AFC Wimbledon","Eastbourne Borough","2-0",2,0,5,5,2,2,"H"
"2010-03-13",2009,"Altrincham","York City","0-0",0,0,5,5,0,0,"D"
"2010-03-13",2009,"Cambridge United","Histon","2-1",2,1,5,5,3,1,"H"
"2010-03-13",2009,"Crawley Town","Ebbsfleet United","2-1",2,1,5,5,3,1,"H"
"2010-03-13",2009,"Grays Athletic","Hayes & Yeading","0-0",0,0,5,5,0,0,"D"
"2010-03-13",2009,"Luton Town","Wrexham","1-0",1,0,5,5,1,1,"H"
"2010-03-13",2009,"Mansfield Town","Tamworth","0-0",0,0,5,5,0,0,"D"
"2010-03-13",2009,"Oxford United","Kettering Town","1-1",1,1,5,5,2,0,"D"
"2010-03-13",2009,"Rushden & Diamonds","Gateshead","8-0",8,0,5,5,8,8,"H"
"2010-03-16",2009,"Altrincham","Kettering Town","2-0",2,0,5,5,2,2,"H"
"2010-03-16",2009,"Barrow","Wrexham","2-1",2,1,5,5,3,1,"H"
"2010-03-16",2009,"Cambridge United","Salisbury","3-1",3,1,5,5,4,2,"H"
"2010-03-16",2009,"Gateshead","Forest Green Rovers","3-1",3,1,5,5,4,2,"H"
"2010-03-16",2009,"Luton Town","Kidderminster Harriers","3-1",3,1,5,5,4,2,"H"
"2010-03-16",2009,"Mansfield Town","York City","0-1",0,1,5,5,1,-1,"A"
"2010-03-16",2009,"Stevenage Borough","Histon","1-0",1,0,5,5,1,1,"H"
"2010-03-20",2009,"Altrincham","Rushden & Diamonds","2-2",2,2,5,5,4,0,"D"
"2010-03-20",2009,"Eastbourne Borough","Grays Athletic","2-2",2,2,5,5,4,0,"D"
"2010-03-20",2009,"Ebbsfleet United","Luton Town","1-6",1,6,5,5,7,-5,"A"
"2010-03-20",2009,"Histon","Mansfield Town","0-5",0,5,5,5,5,-5,"A"
"2010-03-20",2009,"Kettering Town","Forest Green Rovers","0-2",0,2,5,5,2,-2,"A"
"2010-03-20",2009,"Wrexham","Cambridge United","2-2",2,2,5,5,4,0,"D"
"2010-03-21",2009,"Tamworth","Oxford United","0-0",0,0,5,5,0,0,"D"
"2010-03-23",2009,"AFC Wimbledon","Barrow","0-2",0,2,5,5,2,-2,"A"
"2010-03-23",2009,"Gateshead","Wrexham","1-0",1,0,5,5,1,1,"H"
"2010-03-23",2009,"Grays Athletic","Stevenage Borough","1-2",1,2,5,5,3,-1,"A"
"2010-03-23",2009,"Kidderminster Harriers","York City","0-1",0,1,5,5,1,-1,"A"
"2010-03-23",2009,"Mansfield Town","Altrincham","1-1",1,1,5,5,2,0,"D"
"2010-03-23",2009,"Salisbury","Forest Green Rovers","1-3",1,3,5,5,4,-2,"A"
"2010-03-24",2009,"Cambridge United","Tamworth","2-0",2,0,5,5,2,2,"H"
"2010-03-24",2009,"Rushden & Diamonds","Oxford United","1-1",1,1,5,5,2,0,"D"
"2010-03-27",2009,"AFC Wimbledon","Rushden & Diamonds","0-1",0,1,5,5,1,-1,"A"
"2010-03-27",2009,"Barrow","Eastbourne Borough","3-2",3,2,5,5,5,1,"H"
"2010-03-27",2009,"Cambridge United","Grays Athletic","3-0",3,0,5,5,3,3,"H"
"2010-03-27",2009,"Crawley Town","Stevenage Borough","0-3",0,3,5,5,3,-3,"A"
"2010-03-27",2009,"Forest Green Rovers","Altrincham","4-3",4,3,5,5,7,1,"H"
"2010-03-27",2009,"Kettering Town","Mansfield Town","2-2",2,2,5,5,4,0,"D"
"2010-03-27",2009,"Kidderminster Harriers","Salisbury","0-1",0,1,5,5,1,-1,"A"
"2010-03-27",2009,"Luton Town","Hayes & Yeading","8-0",8,0,5,5,8,8,"H"
"2010-03-27",2009,"Oxford United","Gateshead","2-1",2,1,5,5,3,1,"H"
"2010-03-27",2009,"Wrexham","Histon","3-0",3,0,5,5,3,3,"H"
"2010-03-27",2009,"York City","Tamworth","1-1",1,1,5,5,2,0,"D"
"2010-03-29",2009,"Barrow","Histon","0-0",0,0,5,5,0,0,"D"
"2010-03-30",2009,"AFC Wimbledon","Wrexham","2-2",2,2,5,5,4,0,"D"
"2010-03-30",2009,"Eastbourne Borough","Gateshead","2-1",2,1,5,5,3,1,"H"
"2010-03-30",2009,"Grays Athletic","York City","0-4",0,4,5,5,4,-4,"A"
"2010-03-30",2009,"Kettering Town","Rushden & Diamonds","0-3",0,3,5,5,3,-3,"A"
"2010-03-30",2009,"Kidderminster Harriers","Cambridge United","1-0",1,0,5,5,1,1,"H"
"2010-03-30",2009,"Luton Town","Salisbury","4-0",4,0,5,5,4,4,"H"
"2010-03-30",2009,"Stevenage Borough","Oxford United","1-0",1,0,5,5,1,1,"H"
"2010-03-31",2009,"Forest Green Rovers","Barrow","1-0",1,0,5,5,1,1,"H"
"2010-04-02",2009,"Hayes & Yeading","Oxford United","2-1",2,1,5,5,3,1,"H"
"2010-04-02",2009,"Rushden & Diamonds","Crawley Town","1-1",1,1,5,5,2,0,"D"
"2010-04-02",2009,"Salisbury","Ebbsfleet United","3-1",3,1,5,5,4,2,"H"
"2010-04-03",2009,"Altrincham","Kidderminster Harriers","3-2",3,2,5,5,5,1,"H"
"2010-04-03",2009,"Eastbourne Borough","Forest Green Rovers","1-0",1,0,5,5,1,1,"H"
"2010-04-03",2009,"Gateshead","Cambridge United","2-0",2,0,5,5,2,2,"H"
"2010-04-03",2009,"Grays Athletic","Kettering Town","0-0",0,0,5,5,0,0,"D"
"2010-04-03",2009,"Histon","AFC Wimbledon","1-3",1,3,5,5,4,-2,"A"
"2010-04-03",2009,"Mansfield Town","Wrexham","0-1",0,1,5,5,1,-1,"A"
"2010-04-03",2009,"Stevenage Borough","Luton Town","0-1",0,1,5,5,1,-1,"A"
"2010-04-03",2009,"Tamworth","Barrow","3-0",3,0,5,5,3,3,"H"
"2010-04-05",2009,"AFC Wimbledon","Stevenage Borough","0-3",0,3,5,5,3,-3,"A"
"2010-04-05",2009,"Cambridge United","Mansfield Town","3-2",3,2,5,5,5,1,"H"
"2010-04-05",2009,"Crawley Town","Hayes & Yeading","1-0",1,0,5,5,1,1,"H"
"2010-04-05",2009,"Ebbsfleet United","Eastbourne Borough","3-2",3,2,5,5,5,1,"H"
"2010-04-05",2009,"Forest Green Rovers","Tamworth","3-4",3,4,5,5,7,-1,"A"
"2010-04-05",2009,"Kettering Town","Histon","1-1",1,1,5,5,2,0,"D"
"2010-04-05",2009,"Kidderminster Harriers","Rushden & Diamonds","1-1",1,1,5,5,2,0,"D"
"2010-04-05",2009,"Luton Town","Grays Athletic","6-0",6,0,5,5,6,6,"H"
"2010-04-05",2009,"Oxford United","Salisbury","1-0",1,0,5,5,1,1,"H"
"2010-04-05",2009,"Wrexham","Gateshead","0-0",0,0,5,5,0,0,"D"
"2010-04-05",2009,"York City","Altrincham","2-1",2,1,5,5,3,1,"H"
"2010-04-07",2009,"York City","AFC Wimbledon","5-0",5,0,5,5,5,5,"H"
"2010-04-08",2009,"Barrow","Kidderminster Harriers","1-0",1,0,5,5,1,1,"H"
"2010-04-10",2009,"Altrincham","Oxford United","0-1",0,1,5,5,1,-1,"A"
"2010-04-10",2009,"Eastbourne Borough","York City","3-1",3,1,5,5,4,2,"H"
"2010-04-10",2009,"Gateshead","Kidderminster Harriers","0-2",0,2,5,5,2,-2,"A"
"2010-04-10",2009,"Grays Athletic","Wrexham","0-2",0,2,5,5,2,-2,"A"
"2010-04-10",2009,"Hayes & Yeading","Barrow","1-1",1,1,5,5,2,0,"D"
"2010-04-10",2009,"Histon","Crawley Town","0-1",0,1,5,5,1,-1,"A"
"2010-04-10",2009,"Mansfield Town","AFC Wimbledon","0-1",0,1,5,5,1,-1,"A"
"2010-04-10",2009,"Rushden & Diamonds","Ebbsfleet United","2-0",2,0,5,5,2,2,"H"
"2010-04-10",2009,"Salisbury","Cambridge United","2-1",2,1,5,5,3,1,"H"
"2010-04-10",2009,"Stevenage Borough","Forest Green Rovers","2-0",2,0,5,5,2,2,"H"
"2010-04-10",2009,"Tamworth","Luton Town","1-1",1,1,5,5,2,0,"D"
"2010-04-13",2009,"AFC Wimbledon","Grays Athletic","0-2",0,2,5,5,2,-2,"A"
"2010-04-13",2009,"Forest Green Rovers","Crawley Town","1-0",1,0,5,5,1,1,"H"
"2010-04-13",2009,"Luton Town","Histon","6-3",6,3,5,5,9,3,"H"
"2010-04-13",2009,"Mansfield Town","Rushden & Diamonds","3-2",3,2,5,5,5,1,"H"
"2010-04-13",2009,"Oxford United","Cambridge United","0-0",0,0,5,5,0,0,"D"
"2010-04-13",2009,"Salisbury","Hayes & Yeading","3-1",3,1,5,5,4,2,"H"
"2010-04-13",2009,"York City","Barrow","3-0",3,0,5,5,3,3,"H"
"2010-04-14",2009,"Altrincham","Stevenage Borough","0-1",0,1,5,5,1,-1,"A"
"2010-04-15",2009,"Barrow","Crawley Town","4-1",4,1,5,5,5,3,"H"
"2010-04-15",2009,"Hayes & Yeading","Kidderminster Harriers","2-2",2,2,5,5,4,0,"D"
"2010-04-17",2009,"Barrow","Salisbury","0-1",0,1,5,5,1,-1,"A"
"2010-04-17",2009,"Cambridge United","Hayes & Yeading","4-1",4,1,5,5,5,3,"H"
"2010-04-17",2009,"Crawley Town","Tamworth","2-0",2,0,5,5,2,2,"H"
"2010-04-17",2009,"Ebbsfleet United","Gateshead","2-0",2,0,5,5,2,2,"H"
"2010-04-17",2009,"Forest Green Rovers","Histon","2-0",2,0,5,5,2,2,"H"
"2010-04-17",2009,"Kettering Town","Eastbourne Borough","4-0",4,0,5,5,4,4,"H"
"2010-04-17",2009,"Kidderminster Harriers","Stevenage Borough","0-2",0,2,5,5,2,-2,"A"
"2010-04-17",2009,"Luton Town","Altrincham","0-0",0,0,5,5,0,0,"D"
"2010-04-17",2009,"Oxford United","Mansfield Town","2-0",2,0,5,5,2,2,"H"
"2010-04-17",2009,"Wrexham","Rushden & Diamonds","0-1",0,1,5,5,1,-1,"A"
"2010-04-17",2009,"York City","Grays Athletic","1-1",1,1,5,5,2,0,"D"
"2010-04-20",2009,"AFC Wimbledon","Tamworth","0-1",0,1,5,5,1,-1,"A"
"2010-04-20",2009,"Gateshead","Stevenage Borough","0-1",0,1,5,5,1,-1,"A"
"2010-04-20",2009,"Kettering Town","Crawley Town","1-1",1,1,5,5,2,0,"D"
"2010-04-20",2009,"Kidderminster Harriers","Barrow","1-2",1,2,5,5,3,-1,"A"
"2010-04-20",2009,"Oxford United","Wrexham","1-0",1,0,5,5,1,1,"H"
"2010-04-20",2009,"Salisbury","Altrincham","4-1",4,1,5,5,5,3,"H"
"2010-04-24",2009,"Altrincham","Cambridge United","0-2",0,2,5,5,2,-2,"A"
"2010-04-24",2009,"Eastbourne Borough","Oxford United","1-0",1,0,5,5,1,1,"H"
"2010-04-24",2009,"Gateshead","AFC Wimbledon","1-0",1,0,5,5,1,1,"H"
"2010-04-24",2009,"Grays Athletic","Forest Green Rovers","2-1",2,1,5,5,3,1,"H"
"2010-04-24",2009,"Hayes & Yeading","Wrexham","0-1",0,1,5,5,1,-1,"A"
"2010-04-24",2009,"Histon","Barrow","2-2",2,2,5,5,4,0,"D"
"2010-04-24",2009,"Mansfield Town","Kidderminster Harriers","3-3",3,3,5,5,6,0,"D"
"2010-04-24",2009,"Rushden & Diamonds","Luton Town","1-1",1,1,5,5,2,0,"D"
"2010-04-24",2009,"Salisbury","Kettering Town","2-0",2,0,5,5,2,2,"H"
"2010-04-24",2009,"Stevenage Borough","York City","1-0",1,0,5,5,1,1,"H"
"2010-04-24",2009,"Tamworth","Ebbsfleet United","3-4",3,4,5,5,7,-1,"A"
"2010-08-14",2010,"Crawley Town","Grimsby Town","0-1",0,1,5,5,1,-1,"A"
"2010-08-14",2010,"Darlington","Newport County","1-0",1,0,5,5,1,1,"H"
"2010-08-14",2010,"Gateshead","Kettering Town","0-0",0,0,5,5,0,0,"D"
"2010-08-14",2010,"Hayes & Yeading","Bath City","2-1",2,1,5,5,3,1,"H"
"2010-08-14",2010,"Histon","Barrow","3-1",3,1,5,5,4,2,"H"
"2010-08-14",2010,"Luton Town","Altrincham","2-1",2,1,5,5,3,1,"H"
"2010-08-14",2010,"Mansfield Town","Forest Green Rovers","3-1",3,1,5,5,4,2,"H"
"2010-08-14",2010,"Rushden & Diamonds","Fleetwood Town","1-1",1,1,5,5,2,0,"D"
"2010-08-14",2010,"Southport","AFC Wimbledon","0-1",0,1,5,5,1,-1,"A"
"2010-08-14",2010,"Tamworth","Eastbourne Borough","4-2",4,2,5,5,6,2,"H"
"2010-08-14",2010,"Wrexham","Cambridge United","1-0",1,0,5,5,1,1,"H"
"2010-08-14",2010,"York City","Kidderminster Harriers","1-2",1,2,5,5,3,-1,"A"
"2010-08-17",2010,"AFC Wimbledon","Histon","2-0",2,0,5,5,2,2,"H"
"2010-08-17",2010,"Altrincham","Darlington","2-2",2,2,5,5,4,0,"D"
"2010-08-17",2010,"Barrow","Gateshead","1-3",1,3,5,5,4,-2,"A"
"2010-08-17",2010,"Bath City","Rushden & Diamonds","2-1",2,1,5,5,3,1,"H"
"2010-08-17",2010,"Cambridge United","Crawley Town","2-2",2,2,5,5,4,0,"D"
"2010-08-17",2010,"Eastbourne Borough","Hayes & Yeading","5-0",5,0,5,5,5,5,"H"
"2010-08-17",2010,"Fleetwood Town","Mansfield Town","3-0",3,0,5,5,3,3,"H"
"2010-08-17",2010,"Forest Green Rovers","Wrexham","3-0",3,0,5,5,3,3,"H"
"2010-08-17",2010,"Grimsby Town","York City","0-0",0,0,5,5,0,0,"D"
"2010-08-17",2010,"Kettering Town","Luton Town","1-3",1,3,5,5,4,-2,"A"
"2010-08-17",2010,"Kidderminster Harriers","Southport","3-4",3,4,5,5,7,-1,"A"
"2010-08-17",2010,"Newport County","Tamworth","1-1",1,1,5,5,2,0,"D"
"2010-08-21",2010,"AFC Wimbledon","Tamworth","3-0",3,0,5,5,3,3,"H"
"2010-08-21",2010,"Altrincham","Crawley Town","0-1",0,1,5,5,1,-1,"A"
"2010-08-21",2010,"Barrow","Rushden & Diamonds","2-0",2,0,5,5,2,2,"H"
"2010-08-21",2010,"Bath City","York City","2-2",2,2,5,5,4,0,"D"
"2010-08-21",2010,"Cambridge United","Southport","0-0",0,0,5,5,0,0,"D"
"2010-08-21",2010,"Eastbourne Borough","Wrexham","4-3",4,3,5,5,7,1,"H"
"2010-08-21",2010,"Fleetwood Town","Luton Town","0-3",0,3,5,5,3,-3,"A"
"2010-08-21",2010,"Forest Green Rovers","Gateshead","1-1",1,1,5,5,2,0,"D"
"2010-08-21",2010,"Grimsby Town","Hayes & Yeading","1-2",1,2,5,5,3,-1,"A"
"2010-08-21",2010,"Kettering Town","Darlington","0-0",0,0,5,5,0,0,"D"
"2010-08-21",2010,"Kidderminster Harriers","Mansfield Town","1-3",1,3,5,5,4,-2,"A"
"2010-08-21",2010,"Newport County","Histon","2-2",2,2,5,5,4,0,"D"
"2010-08-24",2010,"Crawley Town","Bath City","2-1",2,1,5,5,3,1,"H"
"2010-08-24",2010,"Darlington","Grimsby Town","0-1",0,1,5,5,1,-1,"A"
"2010-08-24",2010,"Gateshead","Fleetwood Town","0-2",0,2,5,5,2,-2,"A"
"2010-08-24",2010,"Hayes & Yeading","Forest Green Rovers","3-4",3,4,5,5,7,-1,"A"
"2010-08-24",2010,"Histon","Eastbourne Borough","1-1",1,1,5,5,2,0,"D"
"2010-08-24",2010,"Luton Town","Newport County","1-1",1,1,5,5,2,0,"D"
"2010-08-24",2010,"Mansfield Town","Kettering Town","1-1",1,1,5,5,2,0,"D"
"2010-08-24",2010,"Rushden & Diamonds","AFC Wimbledon","1-0",1,0,5,5,1,1,"H"
"2010-08-24",2010,"Southport","Altrincham","1-0",1,0,5,5,1,1,"H"
"2010-08-24",2010,"Tamworth","Cambridge United","1-1",1,1,5,5,2,0,"D"
"2010-08-24",2010,"Wrexham","Kidderminster Harriers","2-2",2,2,5,5,4,0,"D"
"2010-08-24",2010,"York City","Barrow","0-0",0,0,5,5,0,0,"D"
"2010-08-28",2010,"Darlington","Gateshead","2-0",2,0,5,5,2,2,"H"
"2010-08-28",2010,"Eastbourne Borough","AFC Wimbledon","2-3",2,3,5,5,5,-1,"A"
"2010-08-28",2010,"Forest Green Rovers","Bath City","0-0",0,0,5,5,0,0,"D"
"2010-08-28",2010,"Hayes & Yeading","Crawley Town","0-3",0,3,5,5,3,-3,"A"
"2010-08-28",2010,"Histon","Kettering Town","0-3",0,3,5,5,3,-3,"A"
"2010-08-28",2010,"Mansfield Town","Cambridge United","1-0",1,0,5,5,1,1,"H"
"2010-08-28",2010,"Newport County","Kidderminster Harriers","3-0",3,0,5,5,3,3,"H"
"2010-08-28",2010,"Rushden & Diamonds","Grimsby Town","4-1",4,1,5,5,5,3,"H"
"2010-08-28",2010,"Southport","Fleetwood Town","1-0",1,0,5,5,1,1,"H"
"2010-08-28",2010,"Tamworth","Luton Town","3-1",3,1,5,5,4,2,"H"
"2010-08-28",2010,"Wrexham","Barrow","1-1",1,1,5,5,2,0,"D"
"2010-08-28",2010,"York City","Altrincham","3-0",3,0,5,5,3,3,"H"
"2010-08-30",2010,"AFC Wimbledon","Newport County","2-2",2,2,5,5,4,0,"D"
"2010-08-30",2010,"Altrincham","Mansfield Town","0-4",0,4,5,5,4,-4,"A"
"2010-08-30",2010,"Barrow","Darlington","1-1",1,1,5,5,2,0,"D"
"2010-08-30",2010,"Bath City","Wrexham","0-2",0,2,5,5,2,-2,"A"
"2010-08-30",2010,"Cambridge United","Eastbourne Borough","2-0",2,0,5,5,2,2,"H"
"2010-08-30",2010,"Crawley Town","Forest Green Rovers","1-0",1,0,5,5,1,1,"H"
"2010-08-30",2010,"Fleetwood Town","York City","2-1",2,1,5,5,3,1,"H"
"2010-08-30",2010,"Grimsby Town","Histon","2-1",2,1,5,5,3,1,"H"
"2010-08-30",2010,"Kettering Town","Rushden & Diamonds","0-1",0,1,5,5,1,-1,"A"
"2010-08-30",2010,"Kidderminster Harriers","Tamworth","2-2",2,2,5,5,4,0,"D"
"2010-08-30",2010,"Luton Town","Hayes & Yeading","1-1",1,1,5,5,2,0,"D"
"2010-09-04",2010,"Altrincham","Kidderminster Harriers","1-2",1,2,5,5,3,-1,"A"
"2010-09-04",2010,"Bath City","Barrow","1-1",1,1,5,5,2,0,"D"
"2010-09-04",2010,"Cambridge United","Gateshead","5-0",5,0,5,5,5,5,"H"
"2010-09-04",2010,"Crawley Town","Fleetwood Town","1-1",1,1,5,5,2,0,"D"
"2010-09-04",2010,"Eastbourne Borough","Darlington","1-1",1,1,5,5,2,0,"D"
"2010-09-04",2010,"Forest Green Rovers","Southport","0-0",0,0,5,5,0,0,"D"
"2010-09-04",2010,"Grimsby Town","Luton Town","2-0",2,0,5,5,2,2,"H"
"2010-09-04",2010,"Hayes & Yeading","Histon","1-2",1,2,5,5,3,-1,"A"
"2010-09-04",2010,"Kettering Town","AFC Wimbledon","1-2",1,2,5,5,3,-1,"A"
"2010-09-04",2010,"Mansfield Town","Tamworth","0-1",0,1,5,5,1,-1,"A"
"2010-09-04",2010,"York City","Rushden & Diamonds","2-0",2,0,5,5,2,2,"H"
"2010-09-05",2010,"Newport County","Wrexham","1-1",1,1,5,5,2,0,"D"
"2010-09-07",2010,"Gateshead","Southport","1-0",1,0,5,5,1,1,"H"
"2010-09-11",2010,"AFC Wimbledon","Bath City","4-0",4,0,5,5,4,4,"H"
"2010-09-11",2010,"Barrow","Eastbourne Borough","4-0",4,0,5,5,4,4,"H"
"2010-09-11",2010,"Darlington","Forest Green Rovers","3-0",3,0,5,5,3,3,"H"
"2010-09-11",2010,"Fleetwood Town","Kettering Town","4-1",4,1,5,5,5,3,"H"
"2010-09-11",2010,"Gateshead","Altrincham","2-0",2,0,5,5,2,2,"H"
"2010-09-11",2010,"Histon","Crawley Town","0-2",0,2,5,5,2,-2,"A"
"2010-09-11",2010,"Kidderminster Harriers","Hayes & Yeading","3-1",3,1,5,5,4,2,"H"
"2010-09-11",2010,"Luton Town","Cambridge United","2-0",2,0,5,5,2,2,"H"
"2010-09-11",2010,"Rushden & Diamonds","Newport County","0-1",0,1,5,5,1,-1,"A"
"2010-09-11",2010,"Southport","Mansfield Town","1-2",1,2,5,5,3,-1,"A"
"2010-09-11",2010,"Tamworth","Grimsby Town","2-1",2,1,5,5,3,1,"H"
"2010-09-11",2010,"Wrexham","York City","1-1",1,1,5,5,2,0,"D"
"2010-09-17",2010,"Luton Town","AFC Wimbledon","3-0",3,0,5,5,3,3,"H"
"2010-09-18",2010,"Barrow","Forest Green Rovers","3-0",3,0,5,5,3,3,"H"
"2010-09-18",2010,"Bath City","Darlington","2-2",2,2,5,5,4,0,"D"
"2010-09-18",2010,"Crawley Town","Gateshead","2-1",2,1,5,5,3,1,"H"
"2010-09-18",2010,"Eastbourne Borough","Altrincham","5-0",5,0,5,5,5,5,"H"
"2010-09-18",2010,"Grimsby Town","Fleetwood Town","1-2",1,2,5,5,3,-1,"A"
"2010-09-18",2010,"Histon","Tamworth","1-2",1,2,5,5,3,-1,"A"
"2010-09-18",2010,"Kettering Town","Wrexham","1-1",1,1,5,5,2,0,"D"
"2010-09-18",2010,"Kidderminster Harriers","Cambridge United","0-0",0,0,5,5,0,0,"D"
"2010-09-18",2010,"Newport County","Mansfield Town","1-0",1,0,5,5,1,1,"H"
"2010-09-18",2010,"Southport","Rushden & Diamonds","2-2",2,2,5,5,4,0,"D"
"2010-09-18",2010,"York City","Hayes & Yeading","2-0",2,0,5,5,2,2,"H"
"2010-09-21",2010,"Altrincham","Barrow","2-0",2,0,5,5,2,2,"H"
"2010-09-21",2010,"Cambridge United","Kettering Town","3-0",3,0,5,5,3,3,"H"
"2010-09-21",2010,"Darlington","Luton Town","2-2",2,2,5,5,4,0,"D"
"2010-09-21",2010,"Fleetwood Town","Kidderminster Harriers","1-1",1,1,5,5,2,0,"D"
"2010-09-21",2010,"Forest Green Rovers","Eastbourne Borough","3-4",3,4,5,5,7,-1,"A"
"2010-09-21",2010,"Gateshead","Grimsby Town","0-0",0,0,5,5,0,0,"D"
"2010-09-21",2010,"Hayes & Yeading","Newport County","1-2",1,2,5,5,3,-1,"A"
"2010-09-21",2010,"Mansfield Town","York City","5-0",5,0,5,5,5,5,"H"
"2010-09-21",2010,"Rushden & Diamonds","Histon","2-0",2,0,5,5,2,2,"H"
"2010-09-21",2010,"Tamworth","Bath City","2-2",2,2,5,5,4,0,"D"
"2010-09-21",2010,"Wrexham","Southport","2-1",2,1,5,5,3,1,"H"
"2010-09-23",2010,"AFC Wimbledon","Crawley Town","2-1",2,1,5,5,3,1,"H"
"2010-09-25",2010,"Altrincham","Grimsby Town","2-2",2,2,5,5,4,0,"D"
"2010-09-25",2010,"Cambridge United","Newport County","0-1",0,1,5,5,1,-1,"A"
"2010-09-25",2010,"Darlington","Southport","1-0",1,0,5,5,1,1,"H"
"2010-09-25",2010,"Fleetwood Town","Bath City","2-1",2,1,5,5,3,1,"H"
"2010-09-25",2010,"Forest Green Rovers","Kettering Town","0-2",0,2,5,5,2,-2,"A"
"2010-09-25",2010,"Gateshead","Luton Town","1-0",1,0,5,5,1,1,"H"
"2010-09-25",2010,"Hayes & Yeading","Barrow","2-0",2,0,5,5,2,2,"H"
"2010-09-25",2010,"Mansfield Town","Eastbourne Borough","4-0",4,0,5,5,4,4,"H"
"2010-09-25",2010,"Tamworth","York City","1-3",1,3,5,5,4,-2,"A"
"2010-09-25",2010,"Wrexham","Histon","4-0",4,0,5,5,4,4,"H"
"2010-09-26",2010,"Kidderminster Harriers","AFC Wimbledon","2-0",2,0,5,5,2,2,"H"
"2010-09-26",2010,"Rushden & Diamonds","Crawley Town","0-1",0,1,5,5,1,-1,"A"
"2010-09-27",2010,"York City","Darlington","0-0",0,0,5,5,0,0,"D"
"2010-09-28",2010,"Barrow","Fleetwood Town","0-2",0,2,5,5,2,-2,"A"
"2010-09-28",2010,"Bath City","Kidderminster Harriers","2-0",2,0,5,5,2,2,"H"
"2010-09-28",2010,"Grimsby Town","Wrexham","2-1",2,1,5,5,3,1,"H"
"2010-09-28",2010,"Histon","Gateshead","1-3",1,3,5,5,4,-2,"A"
"2010-09-28",2010,"Kettering Town","Altrincham","3-3",3,3,5,5,6,0,"D"
"2010-09-28",2010,"Luton Town","Mansfield Town","2-0",2,0,5,5,2,2,"H"
"2010-09-28",2010,"Newport County","Forest Green Rovers","3-1",3,1,5,5,4,2,"H"
"2010-09-28",2010,"Southport","Hayes & Yeading","0-0",0,0,5,5,0,0,"D"
"2010-09-29",2010,"AFC Wimbledon","Cambridge United","3-0",3,0,5,5,3,3,"H"
"2010-09-29",2010,"Crawley Town","Tamworth","3-1",3,1,5,5,4,2,"H"
"2010-09-29",2010,"Eastbourne Borough","Rushden & Diamonds","0-2",0,2,5,5,2,-2,"A"
"2010-10-02",2010,"AFC Wimbledon","Forest Green Rovers","1-1",1,1,5,5,2,0,"D"
"2010-10-02",2010,"Altrincham","Rushden & Diamonds","2-2",2,2,5,5,4,0,"D"
"2010-10-02",2010,"Barrow","Luton Town","0-1",0,1,5,5,1,-1,"A"
"2010-10-02",2010,"Cambridge United","Bath City","1-2",1,2,5,5,3,-1,"A"
"2010-10-02",2010,"Crawley Town","Kidderminster Harriers","2-0",2,0,5,5,2,2,"H"
"2010-10-02",2010,"Darlington","Wrexham","0-1",0,1,5,5,1,-1,"A"
"2010-10-02",2010,"Eastbourne Borough","York City","2-1",2,1,5,5,3,1,"H"
"2010-10-02",2010,"Fleetwood Town","Histon","1-1",1,1,5,5,2,0,"D"
"2010-10-02",2010,"Gateshead","Mansfield Town","1-1",1,1,5,5,2,0,"D"
"2010-10-02",2010,"Grimsby Town","Newport County","2-0",2,0,5,5,2,2,"H"
"2010-10-02",2010,"Kettering Town","Hayes & Yeading","2-1",2,1,5,5,3,1,"H"
"2010-10-02",2010,"Southport","Tamworth","2-1",2,1,5,5,3,1,"H"
"2010-10-05",2010,"Hayes & Yeading","Cambridge United","2-0",2,0,5,5,2,2,"H"
"2010-10-05",2010,"Histon","Southport","2-1",2,1,5,5,3,1,"H"
"2010-10-05",2010,"Kidderminster Harriers","Gateshead","2-1",2,1,5,5,3,1,"H"
"2010-10-05",2010,"Luton Town","Crawley Town","1-2",1,2,5,5,3,-1,"A"
"2010-10-05",2010,"Mansfield Town","AFC Wimbledon","2-5",2,5,5,5,7,-3,"A"
"2010-10-05",2010,"Newport County","Eastbourne Borough","3-3",3,3,5,5,6,0,"D"
"2010-10-05",2010,"Rushden & Diamonds","Darlington","2-1",2,1,5,5,3,1,"H"
"2010-10-05",2010,"Tamworth","Barrow","2-2",2,2,5,5,4,0,"D"
"2010-10-05",2010,"Wrexham","Fleetwood Town","0-0",0,0,5,5,0,0,"D"
"2010-10-05",2010,"York City","Kettering Town","0-1",0,1,5,5,1,-1,"A"
"2010-10-07",2010,"Forest Green Rovers","Grimsby Town","3-3",3,3,5,5,6,0,"D"
"2010-10-09",2010,"Barrow","Crawley Town","1-1",1,1,5,5,2,0,"D"
"2010-10-09",2010,"Bath City","Eastbourne Borough","1-1",1,1,5,5,2,0,"D"
"2010-10-09",2010,"Darlington","Hayes & Yeading","0-1",0,1,5,5,1,-1,"A"
"2010-10-09",2010,"Gateshead","Tamworth","3-1",3,1,5,5,4,2,"H"
"2010-10-09",2010,"Histon","Altrincham","3-0",3,0,5,5,3,3,"H"
"2010-10-09",2010,"Newport County","York City","4-0",4,0,5,5,4,4,"H"
"2010-10-09",2010,"Rushden & Diamonds","Mansfield Town","1-0",1,0,5,5,1,1,"H"
"2010-10-09",2010,"Southport","Kettering Town","1-2",1,2,5,5,3,-1,"A"
"2010-10-09",2010,"Wrexham","AFC Wimbledon","1-2",1,2,5,5,3,-1,"A"
"2010-10-10",2010,"Fleetwood Town","Cambridge United","2-2",2,2,5,5,4,0,"D"
"2010-10-10",2010,"Kidderminster Harriers","Grimsby Town","3-2",3,2,5,5,5,1,"H"
"2010-10-16",2010,"AFC Wimbledon","Gateshead","1-0",1,0,5,5,1,1,"H"
"2010-10-16",2010,"Altrincham","Fleetwood Town","1-0",1,0,5,5,1,1,"H"
"2010-10-16",2010,"Cambridge United","Barrow","3-1",3,1,5,5,4,2,"H"
"2010-10-16",2010,"Crawley Town","Newport County","2-3",2,3,5,5,5,-1,"A"
"2010-10-16",2010,"Eastbourne Borough","Luton Town","2-4",2,4,5,5,6,-2,"A"
"2010-10-16",2010,"Forest Green Rovers","Histon","0-1",0,1,5,5,1,-1,"A"
"2010-10-16",2010,"Grimsby Town","Southport","1-1",1,1,5,5,2,0,"D"
"2010-10-16",2010,"Hayes & Yeading","Wrexham","0-3",0,3,5,5,3,-3,"A"
"2010-10-16",2010,"Kettering Town","Kidderminster Harriers","1-1",1,1,5,5,2,0,"D"
"2010-10-16",2010,"Mansfield Town","Darlington","1-1",1,1,5,5,2,0,"D"
"2010-10-16",2010,"Tamworth","Rushden & Diamonds","1-2",1,2,5,5,3,-1,"A"
"2010-10-16",2010,"York City","Bath City","1-1",1,1,5,5,2,0,"D"
"2010-10-19",2010,"Luton Town","Forest Green Rovers","6-1",6,1,5,5,7,5,"H"
"2010-10-29",2010,"Southport","Kidderminster Harriers","2-2",2,2,5,5,4,0,"D"
"2010-10-30",2010,"AFC Wimbledon","Darlington","0-2",0,2,5,5,2,-2,"A"
"2010-10-30",2010,"Forest Green Rovers","York City","2-1",2,1,5,5,3,1,"H"
"2010-10-30",2010,"Gateshead","Cambridge United","2-3",2,3,5,5,5,-1,"A"
"2010-10-30",2010,"Grimsby Town","Eastbourne Borough","2-2",2,2,5,5,4,0,"D"
"2010-10-30",2010,"Hayes & Yeading","Altrincham","0-1",0,1,5,5,1,-1,"A"
"2010-10-30",2010,"Histon","Wrexham","1-1",1,1,5,5,2,0,"D"
"2010-10-30",2010,"Luton Town","Bath City","3-1",3,1,5,5,4,2,"H"
"2010-10-30",2010,"Mansfield Town","Crawley Town","1-4",1,4,5,5,5,-3,"A"
"2010-10-30",2010,"Newport County","Kettering Town","1-2",1,2,5,5,3,-1,"A"
"2010-10-30",2010,"Rushden & Diamonds","Barrow","5-0",5,0,5,5,5,5,"H"
"2010-10-30",2010,"Tamworth","Fleetwood Town","0-2",0,2,5,5,2,-2,"A"
"2010-11-06",2010,"Barrow","Newport County","2-1",2,1,5,5,3,1,"H"
"2010-11-06",2010,"Bath City","Altrincham","2-2",2,2,5,5,4,0,"D"
"2010-11-09",2010,"Altrincham","AFC Wimbledon","0-2",0,2,5,5,2,-2,"A"
"2010-11-09",2010,"Bath City","Hayes & Yeading","3-1",3,1,5,5,4,2,"H"
"2010-11-09",2010,"Cambridge United","Grimsby Town","1-1",1,1,5,5,2,0,"D"
"2010-11-09",2010,"Darlington","Tamworth","1-0",1,0,5,5,1,1,"H"
"2010-11-09",2010,"Eastbourne Borough","Forest Green Rovers","0-0",0,0,5,5,0,0,"D"
"2010-11-09",2010,"Fleetwood Town","Gateshead","0-0",0,0,5,5,0,0,"D"
"2010-11-09",2010,"Kettering Town","Mansfield Town","0-2",0,2,5,5,2,-2,"A"
"2010-11-09",2010,"Kidderminster Harriers","Rushden & Diamonds","1-0",1,0,5,5,1,1,"H"
"2010-11-11",2010,"Wrexham","Luton Town","1-0",1,0,5,5,1,1,"H"
"2010-11-13",2010,"Altrincham","Luton Town","0-1",0,1,5,5,1,-1,"A"
"2010-11-13",2010,"Barrow","AFC Wimbledon","2-0",2,0,5,5,2,2,"H"
"2010-11-13",2010,"Darlington","Crawley Town","1-1",1,1,5,5,2,0,"D"
"2010-11-13",2010,"Eastbourne Borough","Newport County","0-0",0,0,5,5,0,0,"D"
"2010-11-13",2010,"Fleetwood Town","Rushden & Diamonds","1-1",1,1,5,5,2,0,"D"
"2010-11-13",2010,"Forest Green Rovers","Mansfield Town","2-1",2,1,5,5,3,1,"H"
"2010-11-13",2010,"Hayes & Yeading","Grimsby Town","0-3",0,3,5,5,3,-3,"A"
"2010-11-13",2010,"Histon","Kidderminster Harriers","0-1",0,1,5,5,1,-1,"A"
"2010-11-13",2010,"Kettering Town","Cambridge United","2-2",2,2,5,5,4,0,"D"
"2010-11-13",2010,"Southport","Bath City","2-3",2,3,5,5,5,-1,"A"
"2010-11-13",2010,"Tamworth","Gateshead","1-1",1,1,5,5,2,0,"D"
"2010-11-14",2010,"York City","Wrexham","1-1",1,1,5,5,2,0,"D"
"2010-11-20",2010,"Bath City","Fleetwood Town","1-1",1,1,5,5,2,0,"D"
"2010-11-20",2010,"Cambridge United","Tamworth","3-3",3,3,5,5,6,0,"D"
"2010-11-20",2010,"Crawley Town","Altrincham","7-0",7,0,5,5,7,7,"H"
"2010-11-20",2010,"Gateshead","Forest Green Rovers","1-1",1,1,5,5,2,0,"D"
"2010-11-20",2010,"Grimsby Town","Barrow","1-1",1,1,5,5,2,0,"D"
"2010-11-20",2010,"Kidderminster Harriers","Eastbourne Borough","2-1",2,1,5,5,3,1,"H"
"2010-11-20",2010,"Luton Town","Histon","5-1",5,1,5,5,6,4,"H"
"2010-11-20",2010,"Mansfield Town","Hayes & Yeading","3-2",3,2,5,5,5,1,"H"
"2010-11-20",2010,"Newport County","Southport","2-0",2,0,5,5,2,2,"H"
"2010-11-20",2010,"Rushden & Diamonds","York City","0-4",0,4,5,5,4,-4,"A"
"2010-11-20",2010,"Wrexham","Darlington","2-1",2,1,5,5,3,1,"H"
"2010-11-21",2010,"AFC Wimbledon","Kettering Town","3-2",3,2,5,5,5,1,"H"
"2010-11-23",2010,"York City","Southport","2-0",2,0,5,5,2,2,"H"
"2010-11-25",2010,"Histon","Bath City","1-2",1,2,5,5,3,-1,"A"
"2010-11-27",2010,"Cambridge United","Altrincham","4-0",4,0,5,5,4,4,"H"
"2010-11-27",2010,"Forest Green Rovers","Rushden & Diamonds","2-2",2,2,5,5,4,0,"D"
"2010-11-27",2010,"Newport County","Hayes & Yeading","2-1",2,1,5,5,3,1,"H"
"2010-11-27",2010,"Wrexham","Mansfield Town","1-1",1,1,5,5,2,0,"D"
"2010-11-30",2010,"Kidderminster Harriers","York City","0-0",0,0,5,5,0,0,"D"
"2010-12-07",2010,"Hayes & Yeading","Eastbourne Borough","2-1",2,1,5,5,3,1,"H"
"2010-12-18",2010,"Fleetwood Town","Newport County","1-1",1,1,5,5,2,0,"D"
"2010-12-28",2010,"AFC Wimbledon","Eastbourne Borough","3-0",3,0,5,5,3,3,"H"
"2010-12-28",2010,"Bath City","Forest Green Rovers","2-4",2,4,5,5,6,-2,"A"
"2010-12-28",2010,"Cambridge United","Mansfield Town","1-5",1,5,5,5,6,-4,"A"
"2010-12-28",2010,"Fleetwood Town","Southport","2-0",2,0,5,5,2,2,"H"
"2010-12-28",2010,"Kidderminster Harriers","Newport County","2-3",2,3,5,5,5,-1,"A"
"2011-01-01",2010,"AFC Wimbledon","Hayes & Yeading","3-1",3,1,5,5,4,2,"H"
"2011-01-01",2010,"Altrincham","Wrexham","0-0",0,0,5,5,0,0,"D"
"2011-01-01",2010,"Barrow","Southport","1-1",1,1,5,5,2,0,"D"
"2011-01-01",2010,"Cambridge United","Histon","0-0",0,0,5,5,0,0,"D"
"2011-01-01",2010,"Crawley Town","Eastbourne Borough","3-1",3,1,5,5,4,2,"H"
"2011-01-01",2010,"Fleetwood Town","Darlington","1-0",1,0,5,5,1,1,"H"
"2011-01-01",2010,"Gateshead","York City","0-3",0,3,5,5,3,-3,"A"
"2011-01-01",2010,"Grimsby Town","Mansfield Town","7-2",7,2,5,5,9,5,"H"
"2011-01-01",2010,"Kettering Town","Tamworth","0-1",0,1,5,5,1,-1,"A"
"2011-01-01",2010,"Kidderminster Harriers","Forest Green Rovers","1-0",1,0,5,5,1,1,"H"
"2011-01-01",2010,"Luton Town","Rushden & Diamonds","3-0",3,0,5,5,3,3,"H"
"2011-01-01",2010,"Newport County","Bath City","1-2",1,2,5,5,3,-1,"A"
"2011-01-03",2010,"Darlington","Barrow","3-1",3,1,5,5,4,2,"H"
"2011-01-03",2010,"Eastbourne Borough","Cambridge United","0-2",0,2,5,5,2,-2,"A"
"2011-01-03",2010,"Forest Green Rovers","Crawley Town","0-3",0,3,5,5,3,-3,"A"
"2011-01-03",2010,"Histon","Grimsby Town","1-6",1,6,5,5,7,-5,"A"
"2011-01-03",2010,"Mansfield Town","Altrincham","0-1",0,1,5,5,1,-1,"A"
"2011-01-03",2010,"Newport County","AFC Wimbledon","3-3",3,3,5,5,6,0,"D"
"2011-01-03",2010,"Rushden & Diamonds","Kettering Town","1-2",1,2,5,5,3,-1,"A"
"2011-01-03",2010,"Southport","Gateshead","5-1",5,1,5,5,6,4,"H"
"2011-01-03",2010,"Tamworth","Kidderminster Harriers","2-2",2,2,5,5,4,0,"D"
"2011-01-03",2010,"Wrexham","Bath City","2-0",2,0,5,5,2,2,"H"
"2011-01-04",2010,"Hayes & Yeading","Luton Town","0-1",0,1,5,5,1,-1,"A"
"2011-01-08",2010,"Barrow","Cambridge United","1-2",1,2,5,5,3,-1,"A"
"2011-01-08",2010,"Bath City","Luton Town","0-0",0,0,5,5,0,0,"D"
"2011-01-08",2010,"Darlington","AFC Wimbledon","0-0",0,0,5,5,0,0,"D"
"2011-01-08",2010,"Eastbourne Borough","Mansfield Town","1-3",1,3,5,5,4,-2,"A"
"2011-01-08",2010,"Forest Green Rovers","Fleetwood Town","1-0",1,0,5,5,1,1,"H"
"2011-01-08",2010,"Gateshead","Kidderminster Harriers","2-2",2,2,5,5,4,0,"D"
"2011-01-08",2010,"Hayes & Yeading","Tamworth","2-1",2,1,5,5,3,1,"H"
"2011-01-08",2010,"Rushden & Diamonds","Altrincham","1-2",1,2,5,5,3,-1,"A"
"2011-01-08",2010,"Southport","Newport County","2-1",2,1,5,5,3,1,"H"
"2011-01-08",2010,"Wrexham","Grimsby Town","2-0",2,0,5,5,2,2,"H"
"2011-01-11",2010,"Darlington","Histon","3-1",3,1,5,5,4,2,"H"
"2011-01-11",2010,"Kidderminster Harriers","Kettering Town","4-1",4,1,5,5,5,3,"H"
"2011-01-11",2010,"Mansfield Town","Fleetwood Town","2-5",2,5,5,5,7,-3,"A"
"2011-01-11",2010,"Tamworth","Newport County","3-2",3,2,5,5,5,1,"H"
"2011-01-11",2010,"York City","Grimsby Town","1-0",1,0,5,5,1,1,"H"
"2011-01-12",2010,"AFC Wimbledon","Luton Town","0-0",0,0,5,5,0,0,"D"
"2011-01-15",2010,"Barrow","Kidderminster Harriers","2-1",2,1,5,5,3,1,"H"
"2011-01-15",2010,"Crawley Town","Kettering Town","2-1",2,1,5,5,3,1,"H"
"2011-01-15",2010,"Histon","York City","1-2",1,2,5,5,3,-1,"A"
"2011-01-18",2010,"Bath City","Crawley Town","0-2",0,2,5,5,2,-2,"A"
"2011-01-18",2010,"Fleetwood Town","AFC Wimbledon","1-1",1,1,5,5,2,0,"D"
"2011-01-18",2010,"Gateshead","Barrow","3-0",3,0,5,5,3,3,"H"
"2011-01-18",2010,"Grimsby Town","Kettering Town","2-1",2,1,5,5,3,1,"H"
"2011-01-18",2010,"Hayes & Yeading","Rushden & Diamonds","3-3",3,3,5,5,6,0,"D"
"2011-01-18",2010,"Luton Town","York City","5-0",5,0,5,5,5,5,"H"
"2011-01-18",2010,"Southport","Wrexham","0-1",0,1,5,5,1,-1,"A"
"2011-01-18",2010,"Tamworth","Altrincham","1-1",1,1,5,5,2,0,"D"
"2011-01-22",2010,"AFC Wimbledon","Southport","5-0",5,0,5,5,5,5,"H"
"2011-01-22",2010,"Altrincham","Bath City","0-3",0,3,5,5,3,-3,"A"
"2011-01-22",2010,"Cambridge United","Wrexham","1-3",1,3,5,5,4,-2,"A"
"2011-01-22",2010,"Fleetwood Town","Hayes & Yeading","1-1",1,1,5,5,2,0,"D"
"2011-01-22",2010,"Grimsby Town","Crawley Town","0-0",0,0,5,5,0,0,"D"
"2011-01-22",2010,"Kettering Town","Eastbourne Borough","3-0",3,0,5,5,3,3,"H"
"2011-01-22",2010,"Kidderminster Harriers","Barrow","2-0",2,0,5,5,2,2,"H"
"2011-01-22",2010,"Luton Town","Gateshead","2-2",2,2,5,5,4,0,"D"
"2011-01-22",2010,"Mansfield Town","Histon","1-0",1,0,5,5,1,1,"H"
"2011-01-22",2010,"Newport County","Rushden & Diamonds","1-3",1,3,5,5,4,-2,"A"
"2011-01-22",2010,"Tamworth","Darlington","1-1",1,1,5,5,2,0,"D"
"2011-01-22",2010,"York City","Forest Green Rovers","2-1",2,1,5,5,3,1,"H"
"2011-01-25",2010,"Altrincham","Hayes & Yeading","4-2",4,2,5,5,6,2,"H"
"2011-01-25",2010,"Barrow","Histon","1-1",1,1,5,5,2,0,"D"
"2011-01-25",2010,"Bath City","AFC Wimbledon","2-2",2,2,5,5,4,0,"D"
"2011-01-25",2010,"Crawley Town","Cambridge United","3-0",3,0,5,5,3,3,"H"
"2011-01-25",2010,"Darlington","Mansfield Town","0-0",0,0,5,5,0,0,"D"
"2011-01-25",2010,"Eastbourne Borough","Tamworth","1-4",1,4,5,5,5,-3,"A"
"2011-01-25",2010,"Forest Green Rovers","Kidderminster Harriers","1-1",1,1,5,5,2,0,"D"
"2011-01-25",2010,"Kettering Town","Fleetwood Town","2-1",2,1,5,5,3,1,"H"
"2011-01-25",2010,"Luton Town","Grimsby Town","1-0",1,0,5,5,1,1,"H"
"2011-01-28",2010,"Gateshead","AFC Wimbledon","0-2",0,2,5,5,2,-2,"A"
"2011-01-29",2010,"Bath City","Cambridge United","4-0",4,0,5,5,4,4,"H"
"2011-01-29",2010,"Eastbourne Borough","Grimsby Town","2-3",2,3,5,5,5,-1,"A"
"2011-01-29",2010,"Fleetwood Town","Forest Green Rovers","2-0",2,0,5,5,2,2,"H"
"2011-01-29",2010,"Hayes & Yeading","Kidderminster Harriers","0-4",0,4,5,5,4,-4,"A"
"2011-01-29",2010,"Histon","Newport County","0-0",0,0,5,5,0,0,"D"
"2011-01-29",2010,"Mansfield Town","Wrexham","2-3",2,3,5,5,5,-1,"A"
"2011-01-29",2010,"Rushden & Diamonds","Tamworth","1-1",1,1,5,5,2,0,"D"
"2011-01-29",2010,"Southport","York City","4-0",4,0,5,5,4,4,"H"
"2011-02-01",2010,"Eastbourne Borough","Gateshead","0-3",0,3,5,5,3,-3,"A"
"2011-02-01",2010,"Histon","Fleetwood Town","1-0",1,0,5,5,1,1,"H"
"2011-02-01",2010,"Luton Town","Darlington","4-0",4,0,5,5,4,4,"H"
"2011-02-01",2010,"Rushden & Diamonds","Cambridge United","2-1",2,1,5,5,3,1,"H"
"2011-02-01",2010,"Southport","Grimsby Town","2-2",2,2,5,5,4,0,"D"
"2011-02-01",2010,"Wrexham","Altrincham","2-1",2,1,5,5,3,1,"H"
"2011-02-01",2010,"York City","AFC Wimbledon","4-1",4,1,5,5,5,3,"H"
"2011-02-03",2010,"Kettering Town","Crawley Town","0-0",0,0,5,5,0,0,"D"
"2011-02-05",2010,"AFC Wimbledon","Fleetwood Town","1-0",1,0,5,5,1,1,"H"
"2011-02-05",2010,"Barrow","Wrexham","0-1",0,1,5,5,1,-1,"A"
"2011-02-05",2010,"Cambridge United","Rushden & Diamonds","0-2",0,2,5,5,2,-2,"A"
"2011-02-05",2010,"Forest Green Rovers","Hayes & Yeading","1-0",1,0,5,5,1,1,"H"
"2011-02-05",2010,"Kidderminster Harriers","Bath City","1-0",1,0,5,5,1,1,"H"
"2011-02-05",2010,"Tamworth","Histon","0-1",0,1,5,5,1,-1,"A"
"2011-02-12",2010,"AFC Wimbledon","York City","1-0",1,0,5,5,1,1,"H"
"2011-02-12",2010,"Bath City","Tamworth","2-0",2,0,5,5,2,2,"H"
"2011-02-12",2010,"Crawley Town","Wrexham","3-2",3,2,5,5,5,1,"H"
"2011-02-12",2010,"Darlington","Eastbourne Borough","6-1",6,1,5,5,7,5,"H"
"2011-02-12",2010,"Grimsby Town","Cambridge United","1-1",1,1,5,5,2,0,"D"
"2011-02-12",2010,"Histon","Hayes & Yeading","0-1",0,1,5,5,1,-1,"A"
"2011-02-12",2010,"Kettering Town","Barrow","1-1",1,1,5,5,2,0,"D"
"2011-02-12",2010,"Kidderminster Harriers","Altrincham","2-1",2,1,5,5,3,1,"H"
"2011-02-12",2010,"Luton Town","Fleetwood Town","1-3",1,3,5,5,4,-2,"A"
"2011-02-12",2010,"Mansfield Town","Newport County","3-3",3,3,5,5,6,0,"D"
"2011-02-12",2010,"Rushden & Diamonds","Gateshead","0-2",0,2,5,5,2,-2,"A"
"2011-02-12",2010,"Southport","Forest Green Rovers","4-0",4,0,5,5,4,4,"H"
"2011-02-15",2010,"Altrincham","Histon","0-3",0,3,5,5,3,-3,"A"
"2011-02-15",2010,"Cambridge United","Darlington","0-1",0,1,5,5,1,-1,"A"
"2011-02-15",2010,"Gateshead","Hayes & Yeading","1-0",1,0,5,5,1,1,"H"
"2011-02-15",2010,"Kettering Town","Bath City","2-1",2,1,5,5,3,1,"H"
"2011-02-15",2010,"Wrexham","Crawley Town","0-0",0,0,5,5,0,0,"D"
"2011-02-15",2010,"York City","Fleetwood Town","1-0",1,0,5,5,1,1,"H"
"2011-02-18",2010,"Cambridge United","Kidderminster Harriers","1-2",1,2,5,5,3,-1,"A"
"2011-02-18",2010,"Newport County","Luton Town","1-1",1,1,5,5,2,0,"D"
"2011-02-19",2010,"Altrincham","Kettering Town","3-2",3,2,5,5,5,1,"H"
"2011-02-19",2010,"Barrow","Mansfield Town","2-2",2,2,5,5,4,0,"D"
"2011-02-19",2010,"Eastbourne Borough","Histon","2-2",2,2,5,5,4,0,"D"
"2011-02-19",2010,"Fleetwood Town","Grimsby Town","3-0",3,0,5,5,3,3,"H"
"2011-02-19",2010,"Forest Green Rovers","Darlington","1-1",1,1,5,5,2,0,"D"
"2011-02-19",2010,"Hayes & Yeading","Southport","1-0",1,0,5,5,1,1,"H"
"2011-02-19",2010,"Tamworth","AFC Wimbledon","2-5",2,5,5,5,7,-3,"A"
"2011-02-19",2010,"Wrexham","Gateshead","2-7",2,7,5,5,9,-5,"A"
"2011-02-22",2010,"AFC Wimbledon","Wrexham","0-1",0,1,5,5,1,-1,"A"
"2011-02-22",2010,"Altrincham","York City","0-0",0,0,5,5,0,0,"D"
"2011-02-22",2010,"Barrow","Tamworth","0-2",0,2,5,5,2,-2,"A"
"2011-02-22",2010,"Bath City","Newport County","2-2",2,2,5,5,4,0,"D"
"2011-02-22",2010,"Crawley Town","Southport","1-0",1,0,5,5,1,1,"H"
"2011-02-22",2010,"Darlington","Kidderminster Harriers","1-1",1,1,5,5,2,0,"D"
"2011-02-22",2010,"Grimsby Town","Forest Green Rovers","1-1",1,1,5,5,2,0,"D"
"2011-02-22",2010,"Histon","Cambridge United","0-2",0,2,5,5,2,-2,"A"
"2011-02-22",2010,"Kettering Town","Gateshead","1-4",1,4,5,5,5,-3,"A"
"2011-02-22",2010,"Rushden & Diamonds","Eastbourne Borough","2-0",2,0,5,5,2,2,"H"
"2011-02-26",2010,"AFC Wimbledon","Altrincham","4-1",4,1,5,5,5,3,"H"
"2011-02-26",2010,"Bath City","Southport","2-1",2,1,5,5,3,1,"H"
"2011-02-26",2010,"Crawley Town","Barrow","3-2",3,2,5,5,5,1,"H"
"2011-02-26",2010,"Fleetwood Town","Eastbourne Borough","0-1",0,1,5,5,1,-1,"A"
"2011-02-26",2010,"Forest Green Rovers","Tamworth","4-0",4,0,5,5,4,4,"H"
"2011-02-26",2010,"Hayes & Yeading","York City","1-2",1,2,5,5,3,-1,"A"
"2011-02-26",2010,"Kettering Town","Newport County","2-0",2,0,5,5,2,2,"H"
"2011-02-26",2010,"Kidderminster Harriers","Wrexham","1-0",1,0,5,5,1,1,"H"
"2011-03-01",2010,"Darlington","Fleetwood Town","4-0",4,0,5,5,4,4,"H"
"2011-03-01",2010,"Forest Green Rovers","Luton Town","0-1",0,1,5,5,1,-1,"A"
"2011-03-01",2010,"Hayes & Yeading","AFC Wimbledon","0-0",0,0,5,5,0,0,"D"
"2011-03-01",2010,"Newport County","Cambridge United","1-1",1,1,5,5,2,0,"D"
"2011-03-01",2010,"Rushden & Diamonds","Bath City","5-1",5,1,5,5,6,4,"H"
"2011-03-01",2010,"Southport","Histon","3-1",3,1,5,5,4,2,"H"
"2011-03-01",2010,"York City","Gateshead","2-1",2,1,5,5,3,1,"H"
"2011-03-02",2010,"Tamworth","Kettering Town","3-1",3,1,5,5,4,2,"H"
"2011-03-05",2010,"Altrincham","Gateshead","1-1",1,1,5,5,2,0,"D"
"2011-03-05",2010,"Barrow","York City","0-0",0,0,5,5,0,0,"D"
"2011-03-05",2010,"Bath City","Kettering Town","1-1",1,1,5,5,2,0,"D"
"2011-03-05",2010,"Crawley Town","Histon","5-0",5,0,5,5,5,5,"H"
"2011-03-05",2010,"Darlington","Cambridge United","1-0",1,0,5,5,1,1,"H"
"2011-03-05",2010,"Eastbourne Borough","Southport","4-1",4,1,5,5,5,3,"H"
"2011-03-05",2010,"Grimsby Town","AFC Wimbledon","2-1",2,1,5,5,3,1,"H"
"2011-03-05",2010,"Luton Town","Kidderminster Harriers","1-1",1,1,5,5,2,0,"D"
"2011-03-05",2010,"Newport County","Fleetwood Town","1-3",1,3,5,5,4,-2,"A"
"2011-03-05",2010,"Rushden & Diamonds","Hayes & Yeading","1-1",1,1,5,5,2,0,"D"
"2011-03-05",2010,"Tamworth","Mansfield Town","0-2",0,2,5,5,2,-2,"A"
"2011-03-05",2010,"Wrexham","Forest Green Rovers","2-1",2,1,5,5,3,1,"H"
"2011-03-08",2010,"Barrow","Altrincham","1-0",1,0,5,5,1,1,"H"
"2011-03-08",2010,"Gateshead","Darlington","2-2",2,2,5,5,4,0,"D"
"2011-03-08",2010,"Kidderminster Harriers","Crawley Town","0-0",0,0,5,5,0,0,"D"
"2011-03-08",2010,"Luton Town","Tamworth","2-0",2,0,5,5,2,2,"H"
"2011-03-08",2010,"Rushden & Diamonds","Forest Green Rovers","2-2",2,2,5,5,4,0,"D"
"2011-03-08",2010,"Wrexham","Eastbourne Borough","2-1",2,1,5,5,3,1,"H"
"2011-03-12",2010,"AFC Wimbledon","Kidderminster Harriers","1-2",1,2,5,5,3,-1,"A"
"2011-03-12",2010,"Fleetwood Town","Crawley Town","1-2",1,2,5,5,3,-1,"A"
"2011-03-12",2010,"Forest Green Rovers","Barrow","2-3",2,3,5,5,5,-1,"A"
"2011-03-12",2010,"Kettering Town","Grimsby Town","1-2",1,2,5,5,3,-1,"A"
"2011-03-12",2010,"Newport County","Altrincham","2-1",2,1,5,5,3,1,"H"
"2011-03-12",2010,"Southport","Cambridge United","1-1",1,1,5,5,2,0,"D"
"2011-03-12",2010,"Tamworth","Hayes & Yeading","2-3",2,3,5,5,5,-1,"A"
"2011-03-12",2010,"Wrexham","Rushden & Diamonds","1-1",1,1,5,5,2,0,"D"
"2011-03-12",2010,"York City","Eastbourne Borough","1-0",1,0,5,5,1,1,"H"
"2011-03-15",2010,"Altrincham","Forest Green Rovers","2-1",2,1,5,5,3,1,"H"
"2011-03-15",2010,"Cambridge United","Luton Town","0-0",0,0,5,5,0,0,"D"
"2011-03-15",2010,"Crawley Town","Hayes & Yeading","5-2",5,2,5,5,7,3,"H"
"2011-03-15",2010,"Kettering Town","Histon","4-3",4,3,5,5,7,1,"H"
"2011-03-15",2010,"Southport","Barrow","2-4",2,4,5,5,6,-2,"A"
"2011-03-15",2010,"York City","Mansfield Town","2-1",2,1,5,5,3,1,"H"
"2011-03-18",2010,"Crawley Town","AFC Wimbledon","3-1",3,1,5,5,4,2,"H"
"2011-03-19",2010,"Altrincham","Tamworth","2-0",2,0,5,5,2,2,"H"
"2011-03-19",2010,"Bath City","Grimsby Town","2-1",2,1,5,5,3,1,"H"
"2011-03-19",2010,"Cambridge United","York City","2-1",2,1,5,5,3,1,"H"
"2011-03-19",2010,"Eastbourne Borough","Barrow","0-2",0,2,5,5,2,-2,"A"
"2011-03-19",2010,"Fleetwood Town","Wrexham","1-0",1,0,5,5,1,1,"H"
"2011-03-19",2010,"Forest Green Rovers","Newport County","0-0",0,0,5,5,0,0,"D"
"2011-03-19",2010,"Hayes & Yeading","Kettering Town","3-2",3,2,5,5,5,1,"H"
"2011-03-19",2010,"Rushden & Diamonds","Southport","2-2",2,2,5,5,4,0,"D"
"2011-03-22",2010,"Darlington","Kettering Town","1-1",1,1,5,5,2,0,"D"
"2011-03-22",2010,"Eastbourne Borough","Crawley Town","1-2",1,2,5,5,3,-1,"A"
"2011-03-22",2010,"Grimsby Town","Gateshead","2-2",2,2,5,5,4,0,"D"
"2011-03-22",2010,"Histon","Mansfield Town","2-3",2,3,5,5,5,-1,"A"
"2011-03-22",2010,"Rushden & Diamonds","Luton Town","0-1",0,1,5,5,1,-1,"A"
"2011-03-26",2010,"AFC Wimbledon","Rushden & Diamonds","1-0",1,0,5,5,1,1,"H"
"2011-03-26",2010,"Barrow","Bath City","0-1",0,1,5,5,1,-1,"A"
"2011-03-26",2010,"Cambridge United","Forest Green Rovers","1-1",1,1,5,5,2,0,"D"
"2011-03-26",2010,"Darlington","Altrincham","0-1",0,1,5,5,1,-1,"A"
"2011-03-26",2010,"Eastbourne Borough","Kettering Town","1-3",1,3,5,5,4,-2,"A"
"2011-03-26",2010,"Gateshead","Crawley Town","0-0",0,0,5,5,0,0,"D"
"2011-03-26",2010,"Grimsby Town","Tamworth","2-2",2,2,5,5,4,0,"D"
"2011-03-26",2010,"Hayes & Yeading","Fleetwood Town","1-2",1,2,5,5,3,-1,"A"
"2011-03-26",2010,"Mansfield Town","Kidderminster Harriers","1-2",1,2,5,5,3,-1,"A"
"2011-03-26",2010,"Southport","Luton Town","2-1",2,1,5,5,3,1,"H"
"2011-03-26",2010,"York City","Histon","1-0",1,0,5,5,1,1,"H"
"2011-03-27",2010,"Wrexham","Newport County","1-0",1,0,5,5,1,1,"H"
"2011-03-29",2010,"Altrincham","Southport","1-1",1,1,5,5,2,0,"D"
"2011-03-29",2010,"Crawley Town","Mansfield Town","2-0",2,0,5,5,2,2,"H"
"2011-03-29",2010,"Grimsby Town","Darlington","0-1",0,1,5,5,1,-1,"A"
"2011-03-29",2010,"Luton Town","Barrow","0-0",0,0,5,5,0,0,"D"
"2011-03-29",2010,"Newport County","Gateshead","2-1",2,1,5,5,3,1,"H"
"2011-03-29",2010,"Tamworth","Wrexham","1-1",1,1,5,5,2,0,"D"
"2011-04-02",2010,"AFC Wimbledon","Barrow","2-0",2,0,5,5,2,2,"H"
"2011-04-02",2010,"Altrincham","Cambridge United","2-2",2,2,5,5,4,0,"D"
"2011-04-02",2010,"Bath City","Gateshead","1-0",1,0,5,5,1,1,"H"
"2011-04-02",2010,"Crawley Town","Darlington","1-0",1,0,5,5,1,1,"H"
"2011-04-02",2010,"Fleetwood Town","Tamworth","2-1",2,1,5,5,3,1,"H"
"2011-04-02",2010,"Histon","Forest Green Rovers","0-3",0,3,5,5,3,-3,"A"
"2011-04-02",2010,"Kettering Town","York City","1-1",1,1,5,5,2,0,"D"
"2011-04-02",2010,"Kidderminster Harriers","Luton Town","3-3",3,3,5,5,6,0,"D"
"2011-04-02",2010,"Mansfield Town","Rushden & Diamonds","2-1",2,1,5,5,3,1,"H"
"2011-04-02",2010,"Newport County","Grimsby Town","2-1",2,1,5,5,3,1,"H"
"2011-04-02",2010,"Southport","Eastbourne Borough","1-3",1,3,5,5,4,-2,"A"
"2011-04-02",2010,"Wrexham","Hayes & Yeading","0-2",0,2,5,5,2,-2,"A"
"2011-04-04",2010,"Gateshead","Bath City","1-1",1,1,5,5,2,0,"D"
"2011-04-05",2010,"Histon","Rushden & Diamonds","0-2",0,2,5,5,2,-2,"A"
"2011-04-05",2010,"Luton Town","Kettering Town","2-2",2,2,5,5,4,0,"D"
"2011-04-05",2010,"Mansfield Town","Southport","2-2",2,2,5,5,4,0,"D"
"2011-04-05",2010,"Newport County","Darlington","2-1",2,1,5,5,3,1,"H"
"2011-04-05",2010,"York City","Crawley Town","1-1",1,1,5,5,2,0,"D"
"2011-04-09",2010,"Barrow","Kettering Town","5-0",5,0,5,5,5,5,"H"
"2011-04-09",2010,"Cambridge United","AFC Wimbledon","1-2",1,2,5,5,3,-1,"A"
"2011-04-09",2010,"Darlington","Bath City","3-1",3,1,5,5,4,2,"H"
"2011-04-09",2010,"Eastbourne Borough","Fleetwood Town","0-6",0,6,5,5,6,-6,"A"
"2011-04-09",2010,"Forest Green Rovers","Altrincham","1-0",1,0,5,5,1,1,"H"
"2011-04-09",2010,"Gateshead","Histon","2-0",2,0,5,5,2,2,"H"
"2011-04-09",2010,"Grimsby Town","Kidderminster Harriers","3-3",3,3,5,5,6,0,"D"
"2011-04-09",2010,"Hayes & Yeading","Mansfield Town","4-0",4,0,5,5,4,4,"H"
"2011-04-09",2010,"Luton Town","Southport","6-0",6,0,5,5,6,6,"H"
"2011-04-09",2010,"Rushden & Diamonds","Wrexham","2-2",2,2,5,5,4,0,"D"
"2011-04-09",2010,"Tamworth","Crawley Town","0-3",0,3,5,5,3,-3,"A"
"2011-04-09",2010,"York City","Newport County","2-1",2,1,5,5,3,1,"H"
"2011-04-12",2010,"Crawley Town","Luton Town","1-1",1,1,5,5,2,0,"D"
"2011-04-12",2010,"Gateshead","Eastbourne Borough","3-0",3,0,5,5,3,3,"H"
"2011-04-12",2010,"Histon","Darlington","0-1",0,1,5,5,1,-1,"A"
"2011-04-12",2010,"Mansfield Town","Barrow","1-1",1,1,5,5,2,0,"D"
"2011-04-13",2010,"Grimsby Town","Rushden & Diamonds","1-1",1,1,5,5,2,0,"D"
"2011-04-14",2010,"Mansfield Town","Bath City","2-0",2,0,5,5,2,2,"H"
"2011-04-16",2010,"Eastbourne Borough","Kidderminster Harriers","1-1",1,1,5,5,2,0,"D"
"2011-04-16",2010,"Fleetwood Town","Altrincham","3-1",3,1,5,5,4,2,"H"
"2011-04-16",2010,"Forest Green Rovers","Cambridge United","1-1",1,1,5,5,2,0,"D"
"2011-04-16",2010,"Gateshead","Rushden & Diamonds","2-2",2,2,5,5,4,0,"D"
"2011-04-16",2010,"Grimsby Town","Bath City","2-2",2,2,5,5,4,0,"D"
"2011-04-16",2010,"Hayes & Yeading","Darlington","3-2",3,2,5,5,5,1,"H"
"2011-04-16",2010,"Histon","AFC Wimbledon","0-4",0,4,5,5,4,-4,"A"
"2011-04-16",2010,"Mansfield Town","Luton Town","0-0",0,0,5,5,0,0,"D"
"2011-04-16",2010,"Newport County","Barrow","5-0",5,0,5,5,5,5,"H"
"2011-04-16",2010,"Southport","Crawley Town","0-4",0,4,5,5,4,-4,"A"
"2011-04-16",2010,"Wrexham","Kettering Town","2-0",2,0,5,5,2,2,"H"
"2011-04-16",2010,"York City","Tamworth","1-2",1,2,5,5,3,-1,"A"
"2011-04-19",2010,"Hayes & Yeading","Gateshead","3-1",3,1,5,5,4,2,"H"
"2011-04-19",2010,"Kidderminster Harriers","Darlington","1-2",1,2,5,5,3,-1,"A"
"2011-04-19",2010,"Mansfield Town","Grimsby Town","0-2",0,2,5,5,2,-2,"A"
"2011-04-19",2010,"York City","Luton Town","1-0",1,0,5,5,1,1,"H"
"2011-04-22",2010,"AFC Wimbledon","Mansfield Town","2-1",2,1,5,5,3,1,"H"
"2011-04-22",2010,"Crawley Town","Rushden & Diamonds","4-0",4,0,5,5,4,4,"H"
"2011-04-22",2010,"Kidderminster Harriers","Fleetwood Town","2-1",2,1,5,5,3,1,"H"
"2011-04-23",2010,"Altrincham","Newport County","1-3",1,3,5,5,4,-2,"A"
"2011-04-23",2010,"Barrow","Grimsby Town","0-2",0,2,5,5,2,-2,"A"
"2011-04-23",2010,"Bath City","Histon","2-1",2,1,5,5,3,1,"H"
"2011-04-23",2010,"Cambridge United","Hayes & Yeading","1-0",1,0,5,5,1,1,"H"
"2011-04-23",2010,"Darlington","York City","2-1",2,1,5,5,3,1,"H"
"2011-04-23",2010,"Gateshead","Wrexham","0-1",0,1,5,5,1,-1,"A"
"2011-04-23",2010,"Kettering Town","Forest Green Rovers","2-1",2,1,5,5,3,1,"H"
"2011-04-23",2010,"Luton Town","Eastbourne Borough","3-0",3,0,5,5,3,3,"H"
"2011-04-23",2010,"Tamworth","Southport","0-1",0,1,5,5,1,-1,"A"
"2011-04-25",2010,"Eastbourne Borough","Bath City","2-0",2,0,5,5,2,2,"H"
"2011-04-25",2010,"Fleetwood Town","Barrow","1-0",1,0,5,5,1,1,"H"
"2011-04-25",2010,"Forest Green Rovers","AFC Wimbledon","0-0",0,0,5,5,0,0,"D"
"2011-04-25",2010,"Grimsby Town","Altrincham","0-1",0,1,5,5,1,-1,"A"
"2011-04-25",2010,"Histon","Luton Town","0-4",0,4,5,5,4,-4,"A"
"2011-04-25",2010,"Mansfield Town","Gateshead","3-2",3,2,5,5,5,1,"H"
"2011-04-25",2010,"Newport County","Crawley Town","0-1",0,1,5,5,1,-1,"A"
"2011-04-25",2010,"Rushden & Diamonds","Kidderminster Harriers","2-1",2,1,5,5,3,1,"H"
"2011-04-25",2010,"Southport","Darlington","1-1",1,1,5,5,2,0,"D"
"2011-04-25",2010,"Wrexham","Tamworth","4-2",4,2,5,5,6,2,"H"
"2011-04-25",2010,"York City","Cambridge United","0-0",0,0,5,5,0,0,"D"
"2011-04-30",2010,"AFC Wimbledon","Grimsby Town","2-1",2,1,5,5,3,1,"H"
"2011-04-30",2010,"Altrincham","Eastbourne Borough","3-4",3,4,5,5,7,-1,"A"
"2011-04-30",2010,"Barrow","Hayes & Yeading","2-0",2,0,5,5,2,2,"H"
"2011-04-30",2010,"Bath City","Mansfield Town","2-0",2,0,5,5,2,2,"H"
"2011-04-30",2010,"Cambridge United","Fleetwood Town","0-1",0,1,5,5,1,-1,"A"
"2011-04-30",2010,"Crawley Town","York City","1-1",1,1,5,5,2,0,"D"
"2011-04-30",2010,"Darlington","Rushden & Diamonds","2-0",2,0,5,5,2,2,"H"
"2011-04-30",2010,"Gateshead","Newport County","1-7",1,7,5,5,8,-6,"A"
"2011-04-30",2010,"Kettering Town","Southport","3-1",3,1,5,5,4,2,"H"
"2011-04-30",2010,"Kidderminster Harriers","Histon","2-2",2,2,5,5,4,0,"D"
"2011-04-30",2010,"Luton Town","Wrexham","1-1",1,1,5,5,2,0,"D"
"2011-04-30",2010,"Tamworth","Forest Green Rovers","2-1",2,1,5,5,3,1,"H"
"2011-08-12",2011,"Forest Green Rovers","Stockport County","1-1",1,1,5,5,2,0,"D"
"2011-08-13",2011,"Barrow","Tamworth","1-1",1,1,5,5,2,0,"D"
"2011-08-13",2011,"Darlington","Braintree Town","1-0",1,0,5,5,1,1,"H"
"2011-08-13",2011,"Ebbsfleet United","York City","1-2",1,2,5,5,3,-1,"A"
"2011-08-13",2011,"Grimsby Town","Fleetwood Town","0-2",0,2,5,5,2,-2,"A"
"2011-08-13",2011,"Hayes & Yeading","Alfreton Town","3-1",3,1,5,5,4,2,"H"
"2011-08-13",2011,"Kettering Town","Newport County","3-2",3,2,5,5,5,1,"H"
"2011-08-13",2011,"Kidderminster Harriers","Gateshead","2-3",2,3,5,5,5,-1,"A"
"2011-08-13",2011,"Mansfield Town","Bath City","1-1",1,1,5,5,2,0,"D"
"2011-08-13",2011,"Southport","Lincoln City","2-2",2,2,5,5,4,0,"D"
"2011-08-13",2011,"Wrexham","Cambridge United","1-1",1,1,5,5,2,0,"D"
"2011-08-16",2011,"Alfreton Town","Southport","0-0",0,0,5,5,0,0,"D"
"2011-08-16",2011,"Bath City","Wrexham","0-2",0,2,5,5,2,-2,"A"
"2011-08-16",2011,"Braintree Town","Grimsby Town","5-0",5,0,5,5,5,5,"H"
"2011-08-16",2011,"Cambridge United","Telford United","1-0",1,0,5,5,1,1,"H"
"2011-08-16",2011,"Fleetwood Town","Darlington","0-0",0,0,5,5,0,0,"D"
"2011-08-16",2011,"Gateshead","Mansfield Town","3-0",3,0,5,5,3,3,"H"
"2011-08-16",2011,"Lincoln City","Kidderminster Harriers","0-1",0,1,5,5,1,-1,"A"
"2011-08-16",2011,"Luton Town","Forest Green Rovers","1-1",1,1,5,5,2,0,"D"
"2011-08-16",2011,"Newport County","Hayes & Yeading","4-0",4,0,5,5,4,4,"H"
"2011-08-16",2011,"Stockport County","Kettering Town","1-0",1,0,5,5,1,1,"H"
"2011-08-16",2011,"Tamworth","Ebbsfleet United","1-0",1,0,5,5,1,1,"H"
"2011-08-16",2011,"York City","Barrow","3-1",3,1,5,5,4,2,"H"
"2011-08-19",2011,"Lincoln City","Wrexham","1-2",1,2,5,5,3,-1,"A"
"2011-08-20",2011,"Alfreton Town","Forest Green Rovers","1-6",1,6,5,5,7,-5,"A"
"2011-08-20",2011,"Bath City","Barrow","0-1",0,1,5,5,1,-1,"A"
"2011-08-20",2011,"Braintree Town","Mansfield Town","1-1",1,1,5,5,2,0,"D"
"2011-08-20",2011,"Cambridge United","Kidderminster Harriers","1-2",1,2,5,5,3,-1,"A"
"2011-08-20",2011,"Fleetwood Town","Hayes & Yeading","1-0",1,0,5,5,1,1,"H"
"2011-08-20",2011,"Gateshead","Kettering Town","1-1",1,1,5,5,2,0,"D"
"2011-08-20",2011,"Luton Town","Southport","5-1",5,1,5,5,6,4,"H"
"2011-08-20",2011,"Newport County","Grimsby Town","0-0",0,0,5,5,0,0,"D"
"2011-08-20",2011,"Stockport County","Ebbsfleet United","1-1",1,1,5,5,2,0,"D"
"2011-08-20",2011,"Tamworth","Darlington","1-0",1,0,5,5,1,1,"H"
"2011-08-20",2011,"York City","Telford United","0-1",0,1,5,5,1,-1,"A"
"2011-08-23",2011,"Barrow","Fleetwood Town","4-0",4,0,5,5,4,4,"H"
"2011-08-23",2011,"Darlington","Alfreton Town","1-1",1,1,5,5,2,0,"D"
"2011-08-23",2011,"Ebbsfleet United","Newport County","1-1",1,1,5,5,2,0,"D"
"2011-08-23",2011,"Forest Green Rovers","Braintree Town","0-2",0,2,5,5,2,-2,"A"
"2011-08-23",2011,"Grimsby Town","Cambridge United","2-1",2,1,5,5,3,1,"H"
"2011-08-23",2011,"Hayes & Yeading","Bath City","1-1",1,1,5,5,2,0,"D"
"2011-08-23",2011,"Kettering Town","York City","1-5",1,5,5,5,6,-4,"A"
"2011-08-23",2011,"Kidderminster Harriers","Stockport County","1-1",1,1,5,5,2,0,"D"
"2011-08-23",2011,"Mansfield Town","Luton Town","1-1",1,1,5,5,2,0,"D"
"2011-08-23",2011,"Southport","Gateshead","1-3",1,3,5,5,4,-2,"A"
"2011-08-23",2011,"Telford United","Lincoln City","1-2",1,2,5,5,3,-1,"A"
"2011-08-23",2011,"Wrexham","Tamworth","3-0",3,0,5,5,3,3,"H"
"2011-08-26",2011,"Fleetwood Town","York City","0-0",0,0,5,5,0,0,"D"
"2011-08-26",2011,"Lincoln City","Stockport County","1-1",1,1,5,5,2,0,"D"
"2011-08-27",2011,"Alfreton Town","Wrexham","1-4",1,4,5,5,5,-3,"A"
"2011-08-27",2011,"Barrow","Gateshead","1-2",1,2,5,5,3,-1,"A"
"2011-08-27",2011,"Bath City","Tamworth","0-2",0,2,5,5,2,-2,"A"
"2011-08-27",2011,"Cambridge United","Hayes & Yeading","2-1",2,1,5,5,3,1,"H"
"2011-08-27",2011,"Ebbsfleet United","Forest Green Rovers","1-1",1,1,5,5,2,0,"D"
"2011-08-27",2011,"Grimsby Town","Darlington","1-2",1,2,5,5,3,-1,"A"
"2011-08-27",2011,"Kidderminster Harriers","Southport","2-0",2,0,5,5,2,2,"H"
"2011-08-27",2011,"Luton Town","Braintree Town","3-1",3,1,5,5,4,2,"H"
"2011-08-27",2011,"Mansfield Town","Kettering Town","3-0",3,0,5,5,3,3,"H"
"2011-08-27",2011,"Telford United","Newport County","2-1",2,1,5,5,3,1,"H"
"2011-08-29",2011,"Braintree Town","Ebbsfleet United","2-3",2,3,5,5,5,-1,"A"
"2011-08-29",2011,"Darlington","Lincoln City","3-1",3,1,5,5,4,2,"H"
"2011-08-29",2011,"Forest Green Rovers","Bath City","3-0",3,0,5,5,3,3,"H"
"2011-08-29",2011,"Gateshead","Grimsby Town","1-0",1,0,5,5,1,1,"H"
"2011-08-29",2011,"Kettering Town","Cambridge United","0-0",0,0,5,5,0,0,"D"
"2011-08-29",2011,"Newport County","Kidderminster Harriers","1-3",1,3,5,5,4,-2,"A"
"2011-08-29",2011,"Southport","Barrow","2-1",2,1,5,5,3,1,"H"
"2011-08-29",2011,"Stockport County","Mansfield Town","0-1",0,1,5,5,1,-1,"A"
"2011-08-29",2011,"Tamworth","Telford United","2-2",2,2,5,5,4,0,"D"
"2011-08-29",2011,"Wrexham","Fleetwood Town","2-0",2,0,5,5,2,2,"H"
"2011-08-29",2011,"York City","Alfreton Town","0-1",0,1,5,5,1,-1,"A"
"2011-08-30",2011,"Hayes & Yeading","Luton Town","2-2",2,2,5,5,4,0,"D"
"2011-09-02",2011,"Stockport County","Luton Town","1-1",1,1,5,5,2,0,"D"
"2011-09-03",2011,"Braintree Town","Lincoln City","1-0",1,0,5,5,1,1,"H"
"2011-09-03",2011,"Darlington","Mansfield Town","0-2",0,2,5,5,2,-2,"A"
"2011-09-03",2011,"Ebbsfleet United","Barrow","1-2",1,2,5,5,3,-1,"A"
"2011-09-03",2011,"Forest Green Rovers","Grimsby Town","0-1",0,1,5,5,1,-1,"A"
"2011-09-03",2011,"Gateshead","Alfreton Town","2-0",2,0,5,5,2,2,"H"
"2011-09-03",2011,"Kettering Town","Fleetwood Town","2-3",2,3,5,5,5,-1,"A"
"2011-09-03",2011,"Newport County","Cambridge United","0-1",0,1,5,5,1,-1,"A"
"2011-09-03",2011,"Southport","Telford United","3-2",3,2,5,5,5,1,"H"
"2011-09-03",2011,"Wrexham","Kidderminster Harriers","2-0",2,0,5,5,2,2,"H"
"2011-09-04",2011,"Hayes & Yeading","Tamworth","1-0",1,0,5,5,1,1,"H"
"2011-09-10",2011,"Alfreton Town","Braintree Town","0-1",0,1,5,5,1,-1,"A"
"2011-09-10",2011,"Barrow","Wrexham","3-1",3,1,5,5,4,2,"H"
"2011-09-10",2011,"Bath City","Southport","1-2",1,2,5,5,3,-1,"A"
"2011-09-10",2011,"Cambridge United","Forest Green Rovers","1-1",1,1,5,5,2,0,"D"
"2011-09-10",2011,"Fleetwood Town","Gateshead","3-1",3,1,5,5,4,2,"H"
"2011-09-10",2011,"Grimsby Town","Hayes & Yeading","3-0",3,0,5,5,3,3,"H"
"2011-09-10",2011,"Kidderminster Harriers","Ebbsfleet United","2-2",2,2,5,5,4,0,"D"
"2011-09-10",2011,"Lincoln City","Kettering Town","0-2",0,2,5,5,2,-2,"A"
"2011-09-10",2011,"Luton Town","Darlington","2-0",2,0,5,5,2,2,"H"
"2011-09-10",2011,"Mansfield Town","Newport County","5-0",5,0,5,5,5,5,"H"
"2011-09-10",2011,"Tamworth","York City","2-1",2,1,5,5,3,1,"H"
"2011-09-10",2011,"Telford United","Stockport County","1-1",1,1,5,5,2,0,"D"
"2011-09-13",2011,"Telford United","Luton Town","0-2",0,2,5,5,2,-2,"A"
"2011-09-13",2011,"York City","Bath City","1-0",1,0,5,5,1,1,"H"
"2011-09-17",2011,"Barrow","Mansfield Town","2-3",2,3,5,5,5,-1,"A"
"2011-09-17",2011,"Braintree Town","Newport County","1-0",1,0,5,5,1,1,"H"
"2011-09-17",2011,"Darlington","Hayes & Yeading","1-1",1,1,5,5,2,0,"D"
"2011-09-17",2011,"Ebbsfleet United","Fleetwood Town","1-3",1,3,5,5,4,-2,"A"
"2011-09-17",2011,"Forest Green Rovers","Southport","2-3",2,3,5,5,5,-1,"A"
"2011-09-17",2011,"Gateshead","Cambridge United","1-1",1,1,5,5,2,0,"D"
"2011-09-17",2011,"Kettering Town","Tamworth","0-2",0,2,5,5,2,-2,"A"
"2011-09-17",2011,"Kidderminster Harriers","Alfreton Town","3-1",3,1,5,5,4,2,"H"
"2011-09-17",2011,"Luton Town","Lincoln City","1-0",1,0,5,5,1,1,"H"
"2011-09-17",2011,"Stockport County","Grimsby Town","2-0",2,0,5,5,2,2,"H"
"2011-09-17",2011,"Telford United","Bath City","2-1",2,1,5,5,3,1,"H"
"2011-09-17",2011,"Wrexham","York City","0-3",0,3,5,5,3,-3,"A"
"2011-09-20",2011,"Alfreton Town","Barrow","2-1",2,1,5,5,3,1,"H"
"2011-09-20",2011,"Bath City","Luton Town","1-1",1,1,5,5,2,0,"D"
"2011-09-20",2011,"Cambridge United","Ebbsfleet United","2-0",2,0,5,5,2,2,"H"
"2011-09-20",2011,"Fleetwood Town","Kidderminster Harriers","5-2",5,2,5,5,7,3,"H"
"2011-09-20",2011,"Grimsby Town","Kettering Town","2-1",2,1,5,5,3,1,"H"
"2011-09-20",2011,"Hayes & Yeading","Braintree Town","1-2",1,2,5,5,3,-1,"A"
"2011-09-20",2011,"Lincoln City","Gateshead","1-0",1,0,5,5,1,1,"H"
"2011-09-20",2011,"Mansfield Town","Telford United","1-1",1,1,5,5,2,0,"D"
"2011-09-20",2011,"Newport County","Stockport County","1-1",1,1,5,5,2,0,"D"
"2011-09-20",2011,"Southport","Wrexham","0-0",0,0,5,5,0,0,"D"
"2011-09-20",2011,"Tamworth","Forest Green Rovers","0-1",0,1,5,5,1,-1,"A"
"2011-09-20",2011,"York City","Darlington","2-2",2,2,5,5,4,0,"D"
"2011-09-24",2011,"Alfreton Town","Ebbsfleet United","2-2",2,2,5,5,4,0,"D"
"2011-09-24",2011,"Bath City","Kettering Town","0-1",0,1,5,5,1,-1,"A"
"2011-09-24",2011,"Cambridge United","Darlington","2-0",2,0,5,5,2,2,"H"
"2011-09-24",2011,"Fleetwood Town","Telford United","2-2",2,2,5,5,4,0,"D"
"2011-09-24",2011,"Grimsby Town","Wrexham","1-3",1,3,5,5,4,-2,"A"
"2011-09-24",2011,"Hayes & Yeading","Gateshead","2-3",2,3,5,5,5,-1,"A"
"2011-09-24",2011,"Lincoln City","Forest Green Rovers","1-1",1,1,5,5,2,0,"D"
"2011-09-24",2011,"Mansfield Town","Kidderminster Harriers","0-3",0,3,5,5,3,-3,"A"
"2011-09-24",2011,"Newport County","Barrow","2-2",2,2,5,5,4,0,"D"
"2011-09-24",2011,"Southport","Braintree Town","0-4",0,4,5,5,4,-4,"A"
"2011-09-24",2011,"Tamworth","Stockport County","1-1",1,1,5,5,2,0,"D"
"2011-09-24",2011,"York City","Luton Town","3-0",3,0,5,5,3,3,"H"
"2011-09-27",2011,"Barrow","Lincoln City","1-0",1,0,5,5,1,1,"H"
"2011-09-27",2011,"Braintree Town","Tamworth","3-1",3,1,5,5,4,2,"H"
"2011-09-27",2011,"Darlington","Southport","0-3",0,3,5,5,3,-3,"A"
"2011-09-27",2011,"Ebbsfleet United","Bath City","3-0",3,0,5,5,3,3,"H"
"2011-09-27",2011,"Forest Green Rovers","Newport County","1-1",1,1,5,5,2,0,"D"
"2011-09-27",2011,"Gateshead","York City","3-2",3,2,5,5,5,1,"H"
"2011-09-27",2011,"Kettering Town","Hayes & Yeading","3-5",3,5,5,5,8,-2,"A"
"2011-09-27",2011,"Kidderminster Harriers","Grimsby Town","1-1",1,1,5,5,2,0,"D"
"2011-09-27",2011,"Luton Town","Cambridge United","0-1",0,1,5,5,1,-1,"A"
"2011-09-27",2011,"Stockport County","Fleetwood Town","2-4",2,4,5,5,6,-2,"A"
"2011-09-27",2011,"Telford United","Alfreton Town","1-0",1,0,5,5,1,1,"H"
"2011-09-27",2011,"Wrexham","Mansfield Town","1-3",1,3,5,5,4,-2,"A"
"2011-10-01",2011,"Braintree Town","Fleetwood Town","1-2",1,2,5,5,3,-1,"A"
"2011-10-01",2011,"Darlington","Newport County","2-0",2,0,5,5,2,2,"H"
"2011-10-01",2011,"Forest Green Rovers","Mansfield Town","1-1",1,1,5,5,2,0,"D"
"2011-10-01",2011,"Gateshead","Tamworth","1-1",1,1,5,5,2,0,"D"
"2011-10-01",2011,"Grimsby Town","Alfreton Town","5-2",5,2,5,5,7,3,"H"
"2011-10-01",2011,"Kettering Town","Kidderminster Harriers","0-1",0,1,5,5,1,-1,"A"
"2011-10-01",2011,"Lincoln City","Bath City","2-0",2,0,5,5,2,2,"H"
"2011-10-01",2011,"Luton Town","Barrow","5-1",5,1,5,5,6,4,"H"
"2011-10-01",2011,"Southport","Cambridge United","1-0",1,0,5,5,1,1,"H"
"2011-10-01",2011,"Stockport County","York City","1-2",1,2,5,5,3,-1,"A"
"2011-10-01",2011,"Telford United","Hayes & Yeading","1-1",1,1,5,5,2,0,"D"
"2011-10-01",2011,"Wrexham","Ebbsfleet United","1-0",1,0,5,5,1,1,"H"
"2011-10-04",2011,"Gateshead","Wrexham","1-4",1,4,5,5,5,-3,"A"
"2011-10-06",2011,"Cambridge United","Stockport County","2-2",2,2,5,5,4,0,"D"
"2011-10-08",2011,"Alfreton Town","Kettering Town","1-1",1,1,5,5,2,0,"D"
"2011-10-08",2011,"Barrow","Telford United","2-1",2,1,5,5,3,1,"H"
"2011-10-08",2011,"Bath City","Darlington","2-0",2,0,5,5,2,2,"H"
"2011-10-08",2011,"Ebbsfleet United","Gateshead","0-1",0,1,5,5,1,-1,"A"
"2011-10-08",2011,"Fleetwood Town","Forest Green Rovers","0-0",0,0,5,5,0,0,"D"
"2011-10-08",2011,"Kidderminster Harriers","Luton Town","1-2",1,2,5,5,3,-1,"A"
"2011-10-08",2011,"Mansfield Town","Grimsby Town","2-1",2,1,5,5,3,1,"H"
"2011-10-08",2011,"Newport County","Southport","0-3",0,3,5,5,3,-3,"A"
"2011-10-08",2011,"Tamworth","Lincoln City","4-0",4,0,5,5,4,4,"H"
"2011-10-08",2011,"York City","Braintree Town","6-2",6,2,5,5,8,4,"H"
"2011-10-09",2011,"Hayes & Yeading","Wrexham","0-2",0,2,5,5,2,-2,"A"
"2011-10-11",2011,"Alfreton Town","Lincoln City","1-3",1,3,5,5,4,-2,"A"
"2011-10-11",2011,"Bath City","Cambridge United","3-4",3,4,5,5,7,-1,"A"
"2011-10-11",2011,"Ebbsfleet United","Luton Town","2-2",2,2,5,5,4,0,"D"
"2011-10-11",2011,"Fleetwood Town","Newport County","1-4",1,4,5,5,5,-3,"A"
"2011-10-11",2011,"Grimsby Town","Barrow","5-2",5,2,5,5,7,3,"H"
"2011-10-11",2011,"Hayes & Yeading","Forest Green Rovers","2-0",2,0,5,5,2,2,"H"
"2011-10-11",2011,"Kettering Town","Braintree Town","2-1",2,1,5,5,3,1,"H"
"2011-10-11",2011,"Kidderminster Harriers","Telford United","2-2",2,2,5,5,4,0,"D"
"2011-10-11",2011,"Southport","York City","1-1",1,1,5,5,2,0,"D"
"2011-10-11",2011,"Stockport County","Darlington","3-4",3,4,5,5,7,-1,"A"
"2011-10-14",2011,"Lincoln City","Fleetwood Town","1-3",1,3,5,5,4,-2,"A"
"2011-10-15",2011,"Barrow","Hayes & Yeading","3-1",3,1,5,5,4,2,"H"
"2011-10-15",2011,"Braintree Town","Bath City","3-3",3,3,5,5,6,0,"D"
"2011-10-15",2011,"Cambridge United","Alfreton Town","3-0",3,0,5,5,3,3,"H"
"2011-10-15",2011,"Darlington","Kidderminster Harriers","1-0",1,0,5,5,1,1,"H"
"2011-10-15",2011,"Forest Green Rovers","Kettering Town","0-1",0,1,5,5,1,-1,"A"
"2011-10-15",2011,"Luton Town","Gateshead","5-1",5,1,5,5,6,4,"H"
"2011-10-15",2011,"Mansfield Town","Southport","1-3",1,3,5,5,4,-2,"A"
"2011-10-15",2011,"Newport County","Tamworth","1-2",1,2,5,5,3,-1,"A"
"2011-10-15",2011,"Telford United","Ebbsfleet United","0-2",0,2,5,5,2,-2,"A"
"2011-10-15",2011,"Wrexham","Stockport County","4-0",4,0,5,5,4,4,"H"
"2011-10-15",2011,"York City","Grimsby Town","2-1",2,1,5,5,3,1,"H"
"2011-10-18",2011,"Alfreton Town","Fleetwood Town","1-4",1,4,5,5,5,-3,"A"
"2011-10-18",2011,"Bath City","Stockport County","0-2",0,2,5,5,2,-2,"A"
"2011-10-18",2011,"Darlington","Barrow","0-1",0,1,5,5,1,-1,"A"
"2011-10-18",2011,"Ebbsfleet United","Grimsby Town","3-1",3,1,5,5,4,2,"H"
"2011-10-18",2011,"Forest Green Rovers","Telford United","2-1",2,1,5,5,3,1,"H"
"2011-10-18",2011,"Gateshead","Southport","2-3",2,3,5,5,5,-1,"A"
"2011-10-18",2011,"Kidderminster Harriers","Braintree Town","5-4",5,4,5,5,9,1,"H"
"2011-10-18",2011,"Lincoln City","Mansfield Town","1-1",1,1,5,5,2,0,"D"
"2011-10-18",2011,"Luton Town","Wrexham","0-1",0,1,5,5,1,-1,"A"
"2011-10-18",2011,"Newport County","Kettering Town","3-1",3,1,5,5,4,2,"H"
"2011-10-18",2011,"Tamworth","Hayes & Yeading","2-1",2,1,5,5,3,1,"H"
"2011-10-18",2011,"York City","Cambridge United","2-2",2,2,5,5,4,0,"D"
"2011-10-21",2011,"Cambridge United","Lincoln City","2-0",2,0,5,5,2,2,"H"
"2011-10-21",2011,"Grimsby Town","Luton Town","0-1",0,1,5,5,1,-1,"A"
"2011-10-22",2011,"Barrow","Kidderminster Harriers","3-1",3,1,5,5,4,2,"H"
"2011-10-22",2011,"Braintree Town","Darlington","3-1",3,1,5,5,4,2,"H"
"2011-10-22",2011,"Fleetwood Town","Bath City","4-1",4,1,5,5,5,3,"H"
"2011-10-22",2011,"Hayes & Yeading","York City","2-4",2,4,5,5,6,-2,"A"
"2011-10-22",2011,"Kettering Town","Ebbsfleet United","2-2",2,2,5,5,4,0,"D"
"2011-10-22",2011,"Mansfield Town","Alfreton Town","3-2",3,2,5,5,5,1,"H"
"2011-10-22",2011,"Southport","Tamworth","1-1",1,1,5,5,2,0,"D"
"2011-10-22",2011,"Stockport County","Forest Green Rovers","0-1",0,1,5,5,1,-1,"A"
"2011-10-22",2011,"Telford United","Gateshead","1-2",1,2,5,5,3,-1,"A"
"2011-10-22",2011,"Wrexham","Newport County","0-0",0,0,5,5,0,0,"D"
"2011-11-05",2011,"Bath City","Grimsby Town","2-2",2,2,5,5,4,0,"D"
"2011-11-05",2011,"Darlington","Telford United","1-0",1,0,5,5,1,1,"H"
"2011-11-05",2011,"Forest Green Rovers","Alfreton Town","4-1",4,1,5,5,5,3,"H"
"2011-11-05",2011,"Gateshead","Braintree Town","2-2",2,2,5,5,4,0,"D"
"2011-11-05",2011,"Kettering Town","Southport","2-3",2,3,5,5,5,-1,"A"
"2011-11-05",2011,"Kidderminster Harriers","Tamworth","2-0",2,0,5,5,2,2,"H"
"2011-11-05",2011,"Lincoln City","Barrow","2-1",2,1,5,5,3,1,"H"
"2011-11-05",2011,"Luton Town","Fleetwood Town","1-2",1,2,5,5,3,-1,"A"
"2011-11-05",2011,"Mansfield Town","Cambridge United","1-2",1,2,5,5,3,-1,"A"
"2011-11-05",2011,"Newport County","Ebbsfleet United","0-1",0,1,5,5,1,-1,"A"
"2011-11-05",2011,"Stockport County","Hayes & Yeading","3-3",3,3,5,5,6,0,"D"
"2011-11-05",2011,"York City","Wrexham","0-0",0,0,5,5,0,0,"D"
"2011-11-12",2011,"Ebbsfleet United","Stockport County","2-1",2,1,5,5,3,1,"H"
"2011-11-18",2011,"Tamworth","Kettering Town","2-2",2,2,5,5,4,0,"D"
"2011-11-19",2011,"Alfreton Town","Gateshead","1-1",1,1,5,5,2,0,"D"
"2011-11-19",2011,"Barrow","York City","0-0",0,0,5,5,0,0,"D"
"2011-11-19",2011,"Braintree Town","Forest Green Rovers","1-5",1,5,5,5,6,-4,"A"
"2011-11-19",2011,"Cambridge United","Luton Town","1-1",1,1,5,5,2,0,"D"
"2011-11-19",2011,"Ebbsfleet United","Darlington","1-3",1,3,5,5,4,-2,"A"
"2011-11-19",2011,"Fleetwood Town","Stockport County","2-1",2,1,5,5,3,1,"H"
"2011-11-19",2011,"Grimsby Town","Newport County","2-2",2,2,5,5,4,0,"D"
"2011-11-19",2011,"Hayes & Yeading","Kidderminster Harriers","1-3",1,3,5,5,4,-2,"A"
"2011-11-19",2011,"Southport","Bath City","2-1",2,1,5,5,3,1,"H"
"2011-11-19",2011,"Telford United","Mansfield Town","0-0",0,0,5,5,0,0,"D"
"2011-11-19",2011,"Wrexham","Lincoln City","2-0",2,0,5,5,2,2,"H"
"2011-11-26",2011,"Alfreton Town","Hayes & Yeading","3-2",3,2,5,5,5,1,"H"
"2011-11-26",2011,"Bath City","Mansfield Town","1-1",1,1,5,5,2,0,"D"
"2011-11-26",2011,"Braintree Town","Wrexham","0-0",0,0,5,5,0,0,"D"
"2011-11-26",2011,"Darlington","Tamworth","2-0",2,0,5,5,2,2,"H"
"2011-11-26",2011,"Forest Green Rovers","York City","1-1",1,1,5,5,2,0,"D"
"2011-11-26",2011,"Gateshead","Fleetwood Town","1-1",1,1,5,5,2,0,"D"
"2011-11-26",2011,"Kettering Town","Grimsby Town","1-2",1,2,5,5,3,-1,"A"
"2011-11-26",2011,"Kidderminster Harriers","Cambridge United","0-0",0,0,5,5,0,0,"D"
"2011-11-26",2011,"Lincoln City","Ebbsfleet United","3-0",3,0,5,5,3,3,"H"
"2011-11-26",2011,"Newport County","Luton Town","0-1",0,1,5,5,1,-1,"A"
"2011-11-26",2011,"Stockport County","Southport","0-1",0,1,5,5,1,-1,"A"
"2011-11-26",2011,"Telford United","Barrow","1-0",1,0,5,5,1,1,"H"
"2011-11-29",2011,"Barrow","Alfreton Town","1-0",1,0,5,5,1,1,"H"
"2011-11-29",2011,"Cambridge United","Bath City","1-1",1,1,5,5,2,0,"D"
"2011-11-29",2011,"Ebbsfleet United","Kidderminster Harriers","3-3",3,3,5,5,6,0,"D"
"2011-11-29",2011,"Fleetwood Town","Kettering Town","3-0",3,0,5,5,3,3,"H"
"2011-11-29",2011,"Grimsby Town","Stockport County","7-0",7,0,5,5,7,7,"H"
"2011-11-29",2011,"Hayes & Yeading","Newport County","0-4",0,4,5,5,4,-4,"A"
"2011-11-29",2011,"Luton Town","Telford United","1-1",1,1,5,5,2,0,"D"
"2011-11-29",2011,"Mansfield Town","Gateshead","1-1",1,1,5,5,2,0,"D"
"2011-11-29",2011,"Southport","Forest Green Rovers","1-3",1,3,5,5,4,-2,"A"
"2011-11-29",2011,"Tamworth","Braintree Town","1-0",1,0,5,5,1,1,"H"
"2011-11-29",2011,"York City","Lincoln City","2-0",2,0,5,5,2,2,"H"
"2011-11-30",2011,"Wrexham","Darlington","2-1",2,1,5,5,3,1,"H"
"2011-12-03",2011,"Barrow","Ebbsfleet United","1-1",1,1,5,5,2,0,"D"
"2011-12-03",2011,"Bath City","Telford United","3-1",3,1,5,5,4,2,"H"
"2011-12-03",2011,"Darlington","Forest Green Rovers","0-0",0,0,5,5,0,0,"D"
"2011-12-03",2011,"Mansfield Town","Braintree Town","4-1",4,1,5,5,5,3,"H"
"2011-12-03",2011,"Newport County","Lincoln City","1-0",1,0,5,5,1,1,"H"
"2011-12-03",2011,"Southport","Alfreton Town","2-1",2,1,5,5,3,1,"H"
"2011-12-03",2011,"York City","Kettering Town","7-0",7,0,5,5,7,7,"H"
"2011-12-06",2011,"Alfreton Town","Newport County","3-2",3,2,5,5,5,1,"H"
"2011-12-06",2011,"Braintree Town","Hayes & Yeading","0-3",0,3,5,5,3,-3,"A"
"2011-12-06",2011,"Ebbsfleet United","Cambridge United","0-0",0,0,5,5,0,0,"D"
"2011-12-06",2011,"Forest Green Rovers","Tamworth","3-1",3,1,5,5,4,2,"H"
"2011-12-06",2011,"Grimsby Town","Mansfield Town","0-0",0,0,5,5,0,0,"D"
"2011-12-06",2011,"Kettering Town","Darlington","0-0",0,0,5,5,0,0,"D"
"2011-12-06",2011,"Kidderminster Harriers","Bath City","4-1",4,1,5,5,5,3,"H"
"2011-12-06",2011,"Lincoln City","Luton Town","1-1",1,1,5,5,2,0,"D"
"2011-12-06",2011,"Stockport County","Gateshead","0-1",0,1,5,5,1,-1,"A"
"2011-12-06",2011,"Telford United","York City","0-0",0,0,5,5,0,0,"D"
"2011-12-06",2011,"Wrexham","Southport","2-0",2,0,5,5,2,2,"H"
"2011-12-17",2011,"Braintree Town","Telford United","2-1",2,1,5,5,3,1,"H"
"2011-12-17",2011,"Darlington","Cambridge United","2-0",2,0,5,5,2,2,"H"
"2011-12-17",2011,"Forest Green Rovers","Lincoln City","0-2",0,2,5,5,2,-2,"A"
"2011-12-17",2011,"Grimsby Town","Ebbsfleet United","4-3",4,3,5,5,7,1,"H"
"2011-12-17",2011,"Hayes & Yeading","Barrow","1-1",1,1,5,5,2,0,"D"
"2011-12-17",2011,"Kettering Town","Bath City","1-1",1,1,5,5,2,0,"D"
"2011-12-17",2011,"Newport County","Fleetwood Town","0-1",0,1,5,5,1,-1,"A"
"2011-12-17",2011,"Southport","Mansfield Town","3-1",3,1,5,5,4,2,"H"
"2011-12-17",2011,"Stockport County","Alfreton Town","0-0",0,0,5,5,0,0,"D"
"2011-12-17",2011,"Tamworth","Luton Town","1-3",1,3,5,5,4,-2,"A"
"2011-12-17",2011,"Wrexham","Gateshead","2-1",2,1,5,5,3,1,"H"
"2011-12-19",2011,"York City","Kidderminster Harriers","2-3",2,3,5,5,5,-1,"A"
"2011-12-20",2011,"Hayes & Yeading","Fleetwood Town","1-3",1,3,5,5,4,-2,"A"
"2011-12-26",2011,"Alfreton Town","Tamworth","5-2",5,2,5,5,7,3,"H"
"2011-12-26",2011,"Barrow","Stockport County","1-0",1,0,5,5,1,1,"H"
"2011-12-26",2011,"Cambridge United","Braintree Town","2-0",2,0,5,5,2,2,"H"
"2011-12-26",2011,"Ebbsfleet United","Hayes & Yeading","3-1",3,1,5,5,4,2,"H"
"2011-12-26",2011,"Fleetwood Town","Southport","2-2",2,2,5,5,4,0,"D"
"2011-12-26",2011,"Gateshead","Darlington","1-1",1,1,5,5,2,0,"D"
"2011-12-26",2011,"Kidderminster Harriers","Forest Green Rovers","1-0",1,0,5,5,1,1,"H"
"2011-12-26",2011,"Lincoln City","Grimsby Town","1-2",1,2,5,5,3,-1,"A"
"2011-12-26",2011,"Luton Town","Kettering Town","5-0",5,0,5,5,5,5,"H"
"2011-12-26",2011,"Mansfield Town","York City","1-1",1,1,5,5,2,0,"D"
"2011-12-26",2011,"Telford United","Wrexham","0-2",0,2,5,5,2,-2,"A"
"2012-01-01",2011,"Braintree Town","Cambridge United","3-2",3,2,5,5,5,1,"H"
"2012-01-01",2011,"Darlington","Gateshead","0-1",0,1,5,5,1,-1,"A"
"2012-01-01",2011,"Forest Green Rovers","Kidderminster Harriers","1-1",1,1,5,5,2,0,"D"
"2012-01-01",2011,"Grimsby Town","Lincoln City","3-1",3,1,5,5,4,2,"H"
"2012-01-01",2011,"Kettering Town","Luton Town","0-5",0,5,5,5,5,-5,"A"
"2012-01-01",2011,"Southport","Fleetwood Town","0-6",0,6,5,5,6,-6,"A"
"2012-01-01",2011,"Stockport County","Barrow","3-2",3,2,5,5,5,1,"H"
"2012-01-01",2011,"Tamworth","Alfreton Town","2-2",2,2,5,5,4,0,"D"
"2012-01-01",2011,"Wrexham","Telford United","4-0",4,0,5,5,4,4,"H"
"2012-01-01",2011,"York City","Mansfield Town","2-2",2,2,5,5,4,0,"D"
"2012-01-03",2011,"Bath City","Newport County","3-2",3,2,5,5,5,1,"H"
"2012-01-05",2011,"Cambridge United","Southport","3-0",3,0,5,5,3,3,"H"
"2012-01-07",2011,"Alfreton Town","Grimsby Town","2-5",2,5,5,5,7,-3,"A"
"2012-01-07",2011,"Barrow","Darlington","3-0",3,0,5,5,3,3,"H"
"2012-01-07",2011,"Bath City","Braintree Town","1-1",1,1,5,5,2,0,"D"
"2012-01-07",2011,"Gateshead","Stockport County","2-0",2,0,5,5,2,2,"H"
"2012-01-07",2011,"Kidderminster Harriers","Hayes & Yeading","3-1",3,1,5,5,4,2,"H"
"2012-01-07",2011,"Lincoln City","York City","0-2",0,2,5,5,2,-2,"A"
"2012-01-07",2011,"Luton Town","Newport County","2-0",2,0,5,5,2,2,"H"
"2012-01-07",2011,"Mansfield Town","Forest Green Rovers","1-0",1,0,5,5,1,1,"H"
"2012-01-07",2011,"Telford United","Kettering Town","3-1",3,1,5,5,4,2,"H"
"2012-01-10",2011,"Cambridge United","Grimsby Town","0-1",0,1,5,5,1,-1,"A"
"2012-01-10",2011,"Fleetwood Town","Barrow","4-1",4,1,5,5,5,3,"H"
"2012-01-10",2011,"Gateshead","Kidderminster Harriers","2-1",2,1,5,5,3,1,"H"
"2012-01-10",2011,"Luton Town","Stockport County","1-0",1,0,5,5,1,1,"H"
"2012-01-14",2011,"Tamworth","Wrexham","1-2",1,2,5,5,3,-1,"A"
"2012-01-17",2011,"Hayes & Yeading","Ebbsfleet United","1-2",1,2,5,5,3,-1,"A"
"2012-01-21",2011,"Alfreton Town","Kidderminster Harriers","0-2",0,2,5,5,2,-2,"A"
"2012-01-21",2011,"Braintree Town","Stockport County","2-2",2,2,5,5,4,0,"D"
"2012-01-21",2011,"Darlington","Fleetwood Town","0-1",0,1,5,5,1,-1,"A"
"2012-01-21",2011,"Gateshead","Lincoln City","3-3",3,3,5,5,6,0,"D"
"2012-01-21",2011,"Grimsby Town","Bath City","6-0",6,0,5,5,6,6,"H"
"2012-01-21",2011,"Mansfield Town","Hayes & Yeading","3-2",3,2,5,5,5,1,"H"
"2012-01-21",2011,"Newport County","Forest Green Rovers","0-0",0,0,5,5,0,0,"D"
"2012-01-21",2011,"Southport","Luton Town","3-3",3,3,5,5,6,0,"D"
"2012-01-21",2011,"Tamworth","Barrow","2-3",2,3,5,5,5,-1,"A"
"2012-01-21",2011,"Telford United","Cambridge United","1-2",1,2,5,5,3,-1,"A"
"2012-01-21",2011,"Wrexham","Kettering Town","4-1",4,1,5,5,5,3,"H"
"2012-01-21",2011,"York City","Ebbsfleet United","3-2",3,2,5,5,5,1,"H"
"2012-01-24",2011,"Barrow","Grimsby Town","2-2",2,2,5,5,4,0,"D"
"2012-01-24",2011,"Bath City","Alfreton Town","0-3",0,3,5,5,3,-3,"A"
"2012-01-24",2011,"Ebbsfleet United","Tamworth","3-0",3,0,5,5,3,3,"H"
"2012-01-24",2011,"Fleetwood Town","Braintree Town","3-1",3,1,5,5,4,2,"H"
"2012-01-24",2011,"Forest Green Rovers","Wrexham","1-0",1,0,5,5,1,1,"H"
"2012-01-24",2011,"Hayes & Yeading","Darlington","3-2",3,2,5,5,5,1,"H"
"2012-01-24",2011,"Kettering Town","Gateshead","2-1",2,1,5,5,3,1,"H"
"2012-01-24",2011,"Kidderminster Harriers","York City","1-1",1,1,5,5,2,0,"D"
"2012-01-24",2011,"Lincoln City","Southport","2-0",2,0,5,5,2,2,"H"
"2012-01-24",2011,"Stockport County","Telford United","2-2",2,2,5,5,4,0,"D"
"2012-01-25",2011,"Luton Town","Mansfield Town","0-0",0,0,5,5,0,0,"D"
"2012-01-28",2011,"Braintree Town","Barrow","1-0",1,0,5,5,1,1,"H"
"2012-01-28",2011,"Cambridge United","Tamworth","0-1",0,1,5,5,1,-1,"A"
"2012-01-28",2011,"Darlington","York City","2-2",2,2,5,5,4,0,"D"
"2012-01-28",2011,"Ebbsfleet United","Mansfield Town","0-3",0,3,5,5,3,-3,"A"
"2012-01-28",2011,"Forest Green Rovers","Fleetwood Town","1-2",1,2,5,5,3,-1,"A"
"2012-01-28",2011,"Gateshead","Newport County","2-3",2,3,5,5,5,-1,"A"
"2012-01-28",2011,"Grimsby Town","Telford United","2-0",2,0,5,5,2,2,"H"
"2012-01-28",2011,"Hayes & Yeading","Southport","0-2",0,2,5,5,2,-2,"A"
"2012-01-28",2011,"Kettering Town","Lincoln City","1-0",1,0,5,5,1,1,"H"
"2012-01-28",2011,"Luton Town","Alfreton Town","1-0",1,0,5,5,1,1,"H"
"2012-01-28",2011,"Stockport County","Kidderminster Harriers","2-1",2,1,5,5,3,1,"H"
"2012-01-28",2011,"Wrexham","Bath City","2-0",2,0,5,5,2,2,"H"
"2012-02-04",2011,"Fleetwood Town","Tamworth","2-2",2,2,5,5,4,0,"D"
"2012-02-11",2011,"Stockport County","Newport County","2-2",2,2,5,5,4,0,"D"
"2012-02-14",2011,"Lincoln City","Braintree Town","3-3",3,3,5,5,6,0,"D"
"2012-02-14",2011,"Newport County","Bath City","1-0",1,0,5,5,1,1,"H"
"2012-02-14",2011,"Southport","Darlington","2-0",2,0,5,5,2,2,"H"
"2012-02-17",2011,"Southport","Grimsby Town","1-2",1,2,5,5,3,-1,"A"
"2012-02-18",2011,"Alfreton Town","Darlington","3-1",3,1,5,5,4,2,"H"
"2012-02-18",2011,"Barrow","Kettering Town","3-0",3,0,5,5,3,3,"H"
"2012-02-18",2011,"Bath City","Ebbsfleet United","2-3",2,3,5,5,5,-1,"A"
"2012-02-18",2011,"Fleetwood Town","Cambridge United","1-0",1,0,5,5,1,1,"H"
"2012-02-18",2011,"Forest Green Rovers","Gateshead","2-1",2,1,5,5,3,1,"H"
"2012-02-18",2011,"Kidderminster Harriers","Lincoln City","1-1",1,1,5,5,2,0,"D"
"2012-02-18",2011,"Luton Town","Tamworth","3-0",3,0,5,5,3,3,"H"
"2012-02-18",2011,"Newport County","Mansfield Town","1-0",1,0,5,5,1,1,"H"
"2012-02-18",2011,"Telford United","Braintree Town","1-0",1,0,5,5,1,1,"H"
"2012-02-18",2011,"Wrexham","Hayes & Yeading","4-1",4,1,5,5,5,3,"H"
"2012-02-18",2011,"York City","Stockport County","2-1",2,1,5,5,3,1,"H"
"2012-02-21",2011,"Barrow","Luton Town","1-0",1,0,5,5,1,1,"H"
"2012-02-21",2011,"Bath City","Hayes & Yeading","0-1",0,1,5,5,1,-1,"A"
"2012-02-21",2011,"Fleetwood Town","Ebbsfleet United","6-2",6,2,5,5,8,4,"H"
"2012-02-21",2011,"Kettering Town","Forest Green Rovers","1-3",1,3,5,5,4,-2,"A"
"2012-02-21",2011,"Kidderminster Harriers","Wrexham","0-1",0,1,5,5,1,-1,"A"
"2012-02-21",2011,"Mansfield Town","Darlington","5-2",5,2,5,5,7,3,"H"
"2012-02-21",2011,"Tamworth","Newport County","2-1",2,1,5,5,3,1,"H"
"2012-02-22",2011,"York City","Gateshead","1-2",1,2,5,5,3,-1,"A"
"2012-02-25",2011,"Barrow","Forest Green Rovers","1-1",1,1,5,5,2,0,"D"
"2012-02-25",2011,"Bath City","Kidderminster Harriers","1-2",1,2,5,5,3,-1,"A"
"2012-02-25",2011,"Braintree Town","Kettering Town","2-1",2,1,5,5,3,1,"H"
"2012-02-25",2011,"Ebbsfleet United","Southport","1-2",1,2,5,5,3,-1,"A"
"2012-02-25",2011,"Fleetwood Town","Alfreton Town","4-0",4,0,5,5,4,4,"H"
"2012-02-25",2011,"Lincoln City","Telford United","1-1",1,1,5,5,2,0,"D"
"2012-02-25",2011,"Mansfield Town","Tamworth","2-1",2,1,5,5,3,1,"H"
"2012-02-25",2011,"Stockport County","Wrexham","1-0",1,0,5,5,1,1,"H"
"2012-03-03",2011,"Alfreton Town","Telford United","0-0",0,0,5,5,0,0,"D"
"2012-03-03",2011,"Darlington","Stockport County","0-1",0,1,5,5,1,-1,"A"
"2012-03-03",2011,"Forest Green Rovers","Cambridge United","2-1",2,1,5,5,3,1,"H"
"2012-03-03",2011,"Gateshead","Ebbsfleet United","2-3",2,3,5,5,5,-1,"A"
"2012-03-03",2011,"Grimsby Town","Braintree Town","1-1",1,1,5,5,2,0,"D"
"2012-03-03",2011,"Kettering Town","Wrexham","0-1",0,1,5,5,1,-1,"A"
"2012-03-03",2011,"Kidderminster Harriers","Barrow","1-2",1,2,5,5,3,-1,"A"
"2012-03-03",2011,"Luton Town","Bath City","2-0",2,0,5,5,2,2,"H"
"2012-03-03",2011,"Mansfield Town","Lincoln City","2-1",2,1,5,5,3,1,"H"
"2012-03-03",2011,"Southport","Newport County","1-1",1,1,5,5,2,0,"D"
"2012-03-03",2011,"Tamworth","Fleetwood Town","0-3",0,3,5,5,3,-3,"A"
"2012-03-03",2011,"York City","Hayes & Yeading","2-0",2,0,5,5,2,2,"H"
"2012-03-06",2011,"Alfreton Town","Stockport County","6-1",6,1,5,5,7,5,"H"
"2012-03-06",2011,"Barrow","Bath City","0-1",0,1,5,5,1,-1,"A"
"2012-03-06",2011,"Cambridge United","Mansfield Town","1-2",1,2,5,5,3,-1,"A"
"2012-03-06",2011,"Fleetwood Town","Grimsby Town","2-1",2,1,5,5,3,1,"H"
"2012-03-06",2011,"Gateshead","Hayes & Yeading","2-0",2,0,5,5,2,2,"H"
"2012-03-06",2011,"Newport County","Braintree Town","3-4",3,4,5,5,7,-1,"A"
"2012-03-06",2011,"York City","Tamworth","0-0",0,0,5,5,0,0,"D"
"2012-03-07",2011,"Wrexham","Luton Town","2-0",2,0,5,5,2,2,"H"
"2012-03-09",2011,"Kidderminster Harriers","Fleetwood Town","0-2",0,2,5,5,2,-2,"A"
"2012-03-10",2011,"Braintree Town","Gateshead","3-1",3,1,5,5,4,2,"H"
"2012-03-10",2011,"Grimsby Town","Forest Green Rovers","2-1",2,1,5,5,3,1,"H"
"2012-03-10",2011,"Hayes & Yeading","Kettering Town","1-0",1,0,5,5,1,1,"H"
"2012-03-10",2011,"Lincoln City","Alfreton Town","0-1",0,1,5,5,1,-1,"A"
"2012-03-10",2011,"Stockport County","Cambridge United","0-1",0,1,5,5,1,-1,"A"
"2012-03-10",2011,"Tamworth","Mansfield Town","0-1",0,1,5,5,1,-1,"A"
"2012-03-10",2011,"Telford United","Southport","0-1",0,1,5,5,1,-1,"A"
"2012-03-10",2011,"Wrexham","Barrow","2-0",2,0,5,5,2,2,"H"
"2012-03-13",2011,"Cambridge United","Barrow","1-0",1,0,5,5,1,1,"H"
"2012-03-13",2011,"Darlington","Luton Town","1-1",1,1,5,5,2,0,"D"
"2012-03-13",2011,"Ebbsfleet United","Wrexham","0-5",0,5,5,5,5,-5,"A"
"2012-03-13",2011,"Grimsby Town","York City","2-3",2,3,5,5,5,-1,"A"
"2012-03-13",2011,"Mansfield Town","Fleetwood Town","1-1",1,1,5,5,2,0,"D"
"2012-03-13",2011,"Southport","Kettering Town","0-0",0,0,5,5,0,0,"D"
"2012-03-13",2011,"Telford United","Kidderminster Harriers","2-1",2,1,5,5,3,1,"H"
"2012-03-17",2011,"Bath City","Lincoln City","2-1",2,1,5,5,3,1,"H"
"2012-03-17",2011,"Braintree Town","Kidderminster Harriers","1-4",1,4,5,5,5,-3,"A"
"2012-03-17",2011,"Cambridge United","Gateshead","0-1",0,1,5,5,1,-1,"A"
"2012-03-17",2011,"Darlington","Ebbsfleet United","0-2",0,2,5,5,2,-2,"A"
"2012-03-17",2011,"Forest Green Rovers","Hayes & Yeading","1-3",1,3,5,5,4,-2,"A"
"2012-03-17",2011,"Grimsby Town","Tamworth","0-0",0,0,5,5,0,0,"D"
"2012-03-17",2011,"Kettering Town","Alfreton Town","0-2",0,2,5,5,2,-2,"A"
"2012-03-17",2011,"Mansfield Town","Barrow","7-0",7,0,5,5,7,7,"H"
"2012-03-17",2011,"Southport","Stockport County","5-0",5,0,5,5,5,5,"H"
"2012-03-17",2011,"Telford United","Fleetwood Town","1-4",1,4,5,5,5,-3,"A"
"2012-03-20",2011,"Alfreton Town","Mansfield Town","3-6",3,6,5,5,9,-3,"A"
"2012-03-20",2011,"Cambridge United","Newport County","1-1",1,1,5,5,2,0,"D"
"2012-03-20",2011,"Forest Green Rovers","Luton Town","3-0",3,0,5,5,3,3,"H"
"2012-03-20",2011,"Gateshead","Bath City","1-0",1,0,5,5,1,1,"H"
"2012-03-20",2011,"Hayes & Yeading","Grimsby Town","1-2",1,2,5,5,3,-1,"A"
"2012-03-20",2011,"Kettering Town","Telford United","2-1",2,1,5,5,3,1,"H"
"2012-03-20",2011,"Tamworth","Kidderminster Harriers","0-0",0,0,5,5,0,0,"D"
"2012-03-24",2011,"Alfreton Town","Cambridge United","2-1",2,1,5,5,3,1,"H"
"2012-03-24",2011,"Barrow","Braintree Town","0-4",0,4,5,5,4,-4,"A"
"2012-03-24",2011,"Ebbsfleet United","Kettering Town","1-0",1,0,5,5,1,1,"H"
"2012-03-24",2011,"Fleetwood Town","Mansfield Town","2-0",2,0,5,5,2,2,"H"
"2012-03-24",2011,"Hayes & Yeading","Telford United","0-0",0,0,5,5,0,0,"D"
"2012-03-24",2011,"Kidderminster Harriers","Darlington","3-1",3,1,5,5,4,2,"H"
"2012-03-24",2011,"Lincoln City","Newport County","2-0",2,0,5,5,2,2,"H"
"2012-03-24",2011,"Luton Town","Grimsby Town","1-1",1,1,5,5,2,0,"D"
"2012-03-24",2011,"Stockport County","Bath City","4-0",4,0,5,5,4,4,"H"
"2012-03-24",2011,"Tamworth","Gateshead","1-1",1,1,5,5,2,0,"D"
"2012-03-24",2011,"Wrexham","Forest Green Rovers","1-2",1,2,5,5,3,-1,"A"
"2012-03-24",2011,"York City","Southport","1-2",1,2,5,5,3,-1,"A"
"2012-03-27",2011,"Bath City","York City","0-1",0,1,5,5,1,-1,"A"
"2012-03-27",2011,"Braintree Town","Southport","0-0",0,0,5,5,0,0,"D"
"2012-03-27",2011,"Darlington","Wrexham","2-4",2,4,5,5,6,-2,"A"
"2012-03-27",2011,"Ebbsfleet United","Alfreton Town","1-2",1,2,5,5,3,-1,"A"
"2012-03-27",2011,"Hayes & Yeading","Lincoln City","1-2",1,2,5,5,3,-1,"A"
"2012-03-27",2011,"Tamworth","Grimsby Town","1-1",1,1,5,5,2,0,"D"
"2012-03-27",2011,"Telford United","Forest Green Rovers","2-0",2,0,5,5,2,2,"H"
"2012-03-30",2011,"Luton Town","York City","1-2",1,2,5,5,3,-1,"A"
"2012-03-31",2011,"Bath City","Fleetwood Town","1-4",1,4,5,5,5,-3,"A"
"2012-03-31",2011,"Braintree Town","Alfreton Town","1-2",1,2,5,5,3,-1,"A"
"2012-03-31",2011,"Cambridge United","Wrexham","1-1",1,1,5,5,2,0,"D"
"2012-03-31",2011,"Forest Green Rovers","Barrow","3-0",3,0,5,5,3,3,"H"
"2012-03-31",2011,"Grimsby Town","Kidderminster Harriers","1-2",1,2,5,5,3,-1,"A"
"2012-03-31",2011,"Kettering Town","Stockport County","1-3",1,3,5,5,4,-2,"A"
"2012-03-31",2011,"Lincoln City","Tamworth","4-0",4,0,5,5,4,4,"H"
"2012-03-31",2011,"Mansfield Town","Ebbsfleet United","1-0",1,0,5,5,1,1,"H"
"2012-03-31",2011,"Newport County","Gateshead","1-0",1,0,5,5,1,1,"H"
"2012-03-31",2011,"Southport","Hayes & Yeading","1-2",1,2,5,5,3,-1,"A"
"2012-03-31",2011,"Telford United","Darlington","3-3",3,3,5,5,6,0,"D"
"2012-04-03",2011,"Lincoln City","Cambridge United","0-1",0,1,5,5,1,-1,"A"
"2012-04-03",2011,"Newport County","York City","2-1",2,1,5,5,3,1,"H"
"2012-04-06",2011,"Forest Green Rovers","Ebbsfleet United","3-1",3,1,5,5,4,2,"H"
"2012-04-06",2011,"Newport County","Telford United","0-0",0,0,5,5,0,0,"D"
"2012-04-06",2011,"Tamworth","Bath City","0-1",0,1,5,5,1,-1,"A"
"2012-04-06",2011,"Wrexham","Alfreton Town","0-1",0,1,5,5,1,-1,"A"
"2012-04-07",2011,"Braintree Town","Luton Town","3-1",3,1,5,5,4,2,"H"
"2012-04-07",2011,"Darlington","Grimsby Town","0-0",0,0,5,5,0,0,"D"
"2012-04-07",2011,"Gateshead","Barrow","2-0",2,0,5,5,2,2,"H"
"2012-04-07",2011,"Hayes & Yeading","Cambridge United","0-0",0,0,5,5,0,0,"D"
"2012-04-07",2011,"Kettering Town","Mansfield Town","0-3",0,3,5,5,3,-3,"A"
"2012-04-07",2011,"Southport","Kidderminster Harriers","1-2",1,2,5,5,3,-1,"A"
"2012-04-07",2011,"Stockport County","Lincoln City","4-0",4,0,5,5,4,4,"H"
"2012-04-07",2011,"York City","Fleetwood Town","0-1",0,1,5,5,1,-1,"A"
"2012-04-09",2011,"Alfreton Town","York City","0-2",0,2,5,5,2,-2,"A"
"2012-04-09",2011,"Barrow","Southport","2-2",2,2,5,5,4,0,"D"
"2012-04-09",2011,"Bath City","Forest Green Rovers","0-2",0,2,5,5,2,-2,"A"
"2012-04-09",2011,"Cambridge United","Kettering Town","2-0",2,0,5,5,2,2,"H"
"2012-04-09",2011,"Ebbsfleet United","Braintree Town","1-1",1,1,5,5,2,0,"D"
"2012-04-09",2011,"Grimsby Town","Gateshead","2-0",2,0,5,5,2,2,"H"
"2012-04-09",2011,"Kidderminster Harriers","Newport County","3-2",3,2,5,5,5,1,"H"
"2012-04-09",2011,"Lincoln City","Darlington","5-0",5,0,5,5,5,5,"H"
"2012-04-09",2011,"Luton Town","Hayes & Yeading","4-2",4,2,5,5,6,2,"H"
"2012-04-09",2011,"Mansfield Town","Stockport County","2-1",2,1,5,5,3,1,"H"
"2012-04-10",2011,"Fleetwood Town","Wrexham","1-1",1,1,5,5,2,0,"D"
"2012-04-13",2011,"Fleetwood Town","Lincoln City","2-2",2,2,5,5,4,0,"D"
"2012-04-14",2011,"Alfreton Town","Luton Town","0-0",0,0,5,5,0,0,"D"
"2012-04-14",2011,"Barrow","Cambridge United","1-3",1,3,5,5,4,-2,"A"
"2012-04-14",2011,"Darlington","Bath City","2-2",2,2,5,5,4,0,"D"
"2012-04-14",2011,"Ebbsfleet United","Telford United","3-2",3,2,5,5,5,1,"H"
"2012-04-14",2011,"Gateshead","Forest Green Rovers","1-0",1,0,5,5,1,1,"H"
"2012-04-14",2011,"Hayes & Yeading","Mansfield Town","1-3",1,3,5,5,4,-2,"A"
"2012-04-14",2011,"Kidderminster Harriers","Kettering Town","6-1",6,1,5,5,7,5,"H"
"2012-04-14",2011,"Stockport County","Braintree Town","1-1",1,1,5,5,2,0,"D"
"2012-04-14",2011,"Tamworth","Southport","2-2",2,2,5,5,4,0,"D"
"2012-04-14",2011,"Wrexham","Grimsby Town","2-2",2,2,5,5,4,0,"D"
"2012-04-14",2011,"York City","Newport County","1-1",1,1,5,5,2,0,"D"
"2012-04-17",2011,"Cambridge United","York City","0-1",0,1,5,5,1,-1,"A"
"2012-04-17",2011,"Luton Town","Ebbsfleet United","3-0",3,0,5,5,3,3,"H"
"2012-04-17",2011,"Newport County","Darlington","0-0",0,0,5,5,0,0,"D"
"2012-04-17",2011,"Telford United","Tamworth","1-0",1,0,5,5,1,1,"H"
"2012-04-20",2011,"Mansfield Town","Wrexham","2-0",2,0,5,5,2,2,"H"
"2012-04-21",2011,"Bath City","Gateshead","4-2",4,2,5,5,6,2,"H"
"2012-04-21",2011,"Braintree Town","York City","0-1",0,1,5,5,1,-1,"A"
"2012-04-21",2011,"Cambridge United","Fleetwood Town","2-0",2,0,5,5,2,2,"H"
"2012-04-21",2011,"Forest Green Rovers","Darlington","2-0",2,0,5,5,2,2,"H"
"2012-04-21",2011,"Kettering Town","Barrow","1-1",1,1,5,5,2,0,"D"
"2012-04-21",2011,"Lincoln City","Hayes & Yeading","0-1",0,1,5,5,1,-1,"A"
"2012-04-21",2011,"Luton Town","Kidderminster Harriers","1-0",1,0,5,5,1,1,"H"
"2012-04-21",2011,"Newport County","Alfreton Town","1-0",1,0,5,5,1,1,"H"
"2012-04-21",2011,"Southport","Ebbsfleet United","3-3",3,3,5,5,6,0,"D"
"2012-04-21",2011,"Stockport County","Tamworth","2-0",2,0,5,5,2,2,"H"
"2012-04-21",2011,"Telford United","Grimsby Town","0-0",0,0,5,5,0,0,"D"
"2012-04-24",2011,"Gateshead","Luton Town","0-0",0,0,5,5,0,0,"D"
"2012-04-24",2011,"Newport County","Wrexham","0-1",0,1,5,5,1,-1,"A"
"2012-04-28",2011,"Alfreton Town","Bath City","2-1",2,1,5,5,3,1,"H"
"2012-04-28",2011,"Barrow","Newport County","3-1",3,1,5,5,4,2,"H"
"2012-04-28",2011,"Darlington","Kettering Town","3-1",3,1,5,5,4,2,"H"
"2012-04-28",2011,"Ebbsfleet United","Lincoln City","2-3",2,3,5,5,5,-1,"A"
"2012-04-28",2011,"Fleetwood Town","Luton Town","0-2",0,2,5,5,2,-2,"A"
"2012-04-28",2011,"Gateshead","Telford United","3-0",3,0,5,5,3,3,"H"
"2012-04-28",2011,"Grimsby Town","Southport","0-1",0,1,5,5,1,-1,"A"
"2012-04-28",2011,"Hayes & Yeading","Stockport County","1-2",1,2,5,5,3,-1,"A"
"2012-04-28",2011,"Kidderminster Harriers","Mansfield Town","0-3",0,3,5,5,3,-3,"A"
"2012-04-28",2011,"Tamworth","Cambridge United","2-2",2,2,5,5,4,0,"D"
"2012-04-28",2011,"Wrexham","Braintree Town","5-1",5,1,5,5,6,4,"H"
"2012-04-28",2011,"York City","Forest Green Rovers","1-0",1,0,5,5,1,1,"H"
"2012-08-10",2012,"Hereford United","Macclesfield","2-1",2,1,5,5,3,1,"H"
"2012-08-11",2012,"Barrow","Telford United","0-0",0,0,5,5,0,0,"D"
"2012-08-11",2012,"Braintree Town","Hyde United","2-2",2,2,5,5,4,0,"D"
"2012-08-11",2012,"Dartford","Tamworth","2-3",2,3,5,5,5,-1,"A"
"2012-08-11",2012,"Forest Green Rovers","Cambridge United","1-1",1,1,5,5,2,0,"D"
"2012-08-11",2012,"Lincoln City","Kidderminster Harriers","1-0",1,0,5,5,1,1,"H"
"2012-08-11",2012,"Luton Town","Gateshead","2-2",2,2,5,5,4,0,"D"
"2012-08-11",2012,"Mansfield Town","Newport County","3-4",3,4,5,5,7,-1,"A"
"2012-08-11",2012,"Nuneaton Town","Ebbsfleet United","4-5",4,5,5,5,9,-1,"A"
"2012-08-11",2012,"Southport","Grimsby Town","1-1",1,1,5,5,2,0,"D"
"2012-08-11",2012,"Stockport County","Alfreton Town","1-0",1,0,5,5,1,1,"H"
"2012-08-11",2012,"Wrexham","Woking","3-1",3,1,5,5,4,2,"H"
"2012-08-14",2012,"Alfreton Town","Southport","3-3",3,3,5,5,6,0,"D"
"2012-08-14",2012,"Cambridge United","Lincoln City","2-1",2,1,5,5,3,1,"H"
"2012-08-14",2012,"Ebbsfleet United","Braintree Town","0-1",0,1,5,5,1,-1,"A"
"2012-08-14",2012,"Gateshead","Mansfield Town","4-1",4,1,5,5,5,3,"H"
"2012-08-14",2012,"Grimsby Town","Stockport County","1-2",1,2,5,5,3,-1,"A"
"2012-08-14",2012,"Hyde United","Barrow","0-0",0,0,5,5,0,0,"D"
"2012-08-14",2012,"Kidderminster Harriers","Luton Town","0-2",0,2,5,5,2,-2,"A"
"2012-08-14",2012,"Macclesfield","Wrexham","2-0",2,0,5,5,2,2,"H"
"2012-08-14",2012,"Newport County","Nuneaton Town","4-0",4,0,5,5,4,4,"H"
"2012-08-14",2012,"Tamworth","Hereford United","2-2",2,2,5,5,4,0,"D"
"2012-08-14",2012,"Telford United","Forest Green Rovers","1-2",1,2,5,5,3,-1,"A"
"2012-08-14",2012,"Woking","Dartford","1-0",1,0,5,5,1,1,"H"
"2012-08-17",2012,"Hyde United","Luton Town","1-2",1,2,5,5,3,-1,"A"
"2012-08-18",2012,"Alfreton Town","Hereford United","0-3",0,3,5,5,3,-3,"A"
"2012-08-18",2012,"Cambridge United","Southport","2-0",2,0,5,5,2,2,"H"
"2012-08-18",2012,"Ebbsfleet United","Wrexham","1-1",1,1,5,5,2,0,"D"
"2012-08-18",2012,"Gateshead","Forest Green Rovers","1-1",1,1,5,5,2,0,"D"
"2012-08-18",2012,"Grimsby Town","Nuneaton Town","0-0",0,0,5,5,0,0,"D"
"2012-08-18",2012,"Kidderminster Harriers","Mansfield Town","2-3",2,3,5,5,5,-1,"A"
"2012-08-18",2012,"Macclesfield","Dartford","2-0",2,0,5,5,2,2,"H"
"2012-08-18",2012,"Newport County","Lincoln City","2-1",2,1,5,5,3,1,"H"
"2012-08-18",2012,"Tamworth","Stockport County","1-0",1,0,5,5,1,1,"H"
"2012-08-18",2012,"Telford United","Braintree Town","3-0",3,0,5,5,3,3,"H"
"2012-08-18",2012,"Woking","Barrow","3-1",3,1,5,5,4,2,"H"
"2012-08-24",2012,"Stockport County","Gateshead","1-2",1,2,5,5,3,-1,"A"
"2012-08-25",2012,"Barrow","Alfreton Town","1-3",1,3,5,5,4,-2,"A"
"2012-08-25",2012,"Braintree Town","Newport County","1-2",1,2,5,5,3,-1,"A"
"2012-08-25",2012,"Dartford","Kidderminster Harriers","1-0",1,0,5,5,1,1,"H"
"2012-08-25",2012,"Forest Green Rovers","Woking","3-1",3,1,5,5,4,2,"H"
"2012-08-25",2012,"Hereford United","Ebbsfleet United","4-2",4,2,5,5,6,2,"H"
"2012-08-25",2012,"Lincoln City","Macclesfield","2-3",2,3,5,5,5,-1,"A"
"2012-08-25",2012,"Luton Town","Telford United","0-1",0,1,5,5,1,-1,"A"
"2012-08-25",2012,"Mansfield Town","Hyde United","1-0",1,0,5,5,1,1,"H"
"2012-08-25",2012,"Nuneaton Town","Cambridge United","2-2",2,2,5,5,4,0,"D"
"2012-08-25",2012,"Southport","Tamworth","0-3",0,3,5,5,3,-3,"A"
"2012-08-25",2012,"Wrexham","Grimsby Town","0-0",0,0,5,5,0,0,"D"
"2012-08-27",2012,"Alfreton Town","Nuneaton Town","0-3",0,3,5,5,3,-3,"A"
"2012-08-27",2012,"Cambridge United","Dartford","1-2",1,2,5,5,3,-1,"A"
"2012-08-27",2012,"Ebbsfleet United","Luton Town","1-3",1,3,5,5,4,-2,"A"
"2012-08-27",2012,"Gateshead","Lincoln City","1-1",1,1,5,5,2,0,"D"
"2012-08-27",2012,"Grimsby Town","Mansfield Town","4-1",4,1,5,5,5,3,"H"
"2012-08-27",2012,"Hyde United","Southport","0-2",0,2,5,5,2,-2,"A"
"2012-08-27",2012,"Kidderminster Harriers","Forest Green Rovers","0-1",0,1,5,5,1,-1,"A"
"2012-08-27",2012,"Macclesfield","Barrow","2-0",2,0,5,5,2,2,"H"
"2012-08-27",2012,"Tamworth","Wrexham","0-1",0,1,5,5,1,-1,"A"
"2012-08-27",2012,"Telford United","Stockport County","2-2",2,2,5,5,4,0,"D"
"2012-08-28",2012,"Newport County","Hereford United","2-0",2,0,5,5,2,2,"H"
"2012-08-28",2012,"Woking","Braintree Town","1-4",1,4,5,5,5,-3,"A"
"2012-09-01",2012,"Barrow","Kidderminster Harriers","1-1",1,1,5,5,2,0,"D"
"2012-09-01",2012,"Braintree Town","Tamworth","2-1",2,1,5,5,3,1,"H"
"2012-09-01",2012,"Dartford","Alfreton Town","5-1",5,1,5,5,6,4,"H"
"2012-09-01",2012,"Forest Green Rovers","Hyde United","3-1",3,1,5,5,4,2,"H"
"2012-09-01",2012,"Hereford United","Grimsby Town","0-2",0,2,5,5,2,-2,"A"
"2012-09-01",2012,"Lincoln City","Ebbsfleet United","1-1",1,1,5,5,2,0,"D"
"2012-09-01",2012,"Luton Town","Macclesfield","4-1",4,1,5,5,5,3,"H"
"2012-09-01",2012,"Mansfield Town","Woking","3-1",3,1,5,5,4,2,"H"
"2012-09-01",2012,"Nuneaton Town","Gateshead","0-1",0,1,5,5,1,-1,"A"
"2012-09-01",2012,"Southport","Telford United","0-3",0,3,5,5,3,-3,"A"
"2012-09-01",2012,"Stockport County","Cambridge United","1-1",1,1,5,5,2,0,"D"
"2012-09-01",2012,"Wrexham","Newport County","2-0",2,0,5,5,2,2,"H"
"2012-09-04",2012,"Barrow","Grimsby Town","2-2",2,2,5,5,4,0,"D"
"2012-09-04",2012,"Braintree Town","Kidderminster Harriers","1-1",1,1,5,5,2,0,"D"
"2012-09-04",2012,"Dartford","Newport County","2-1",2,1,5,5,3,1,"H"
"2012-09-04",2012,"Forest Green Rovers","Ebbsfleet United","4-1",4,1,5,5,5,3,"H"
"2012-09-04",2012,"Hereford United","Woking","2-1",2,1,5,5,3,1,"H"
"2012-09-04",2012,"Lincoln City","Alfreton Town","1-2",1,2,5,5,3,-1,"A"
"2012-09-04",2012,"Luton Town","Cambridge United","3-2",3,2,5,5,5,1,"H"
"2012-09-04",2012,"Mansfield Town","Tamworth","2-0",2,0,5,5,2,2,"H"
"2012-09-04",2012,"Nuneaton Town","Telford United","3-1",3,1,5,5,4,2,"H"
"2012-09-04",2012,"Southport","Gateshead","2-1",2,1,5,5,3,1,"H"
"2012-09-04",2012,"Stockport County","Macclesfield","3-4",3,4,5,5,7,-1,"A"
"2012-09-04",2012,"Wrexham","Hyde United","2-0",2,0,5,5,2,2,"H"
"2012-09-08",2012,"Alfreton Town","Luton Town","3-0",3,0,5,5,3,3,"H"
"2012-09-08",2012,"Cambridge United","Wrexham","1-4",1,4,5,5,5,-3,"A"
"2012-09-08",2012,"Ebbsfleet United","Mansfield Town","3-1",3,1,5,5,4,2,"H"
"2012-09-08",2012,"Gateshead","Dartford","2-0",2,0,5,5,2,2,"H"
"2012-09-08",2012,"Grimsby Town","Forest Green Rovers","1-0",1,0,5,5,1,1,"H"
"2012-09-08",2012,"Hyde United","Hereford United","5-2",5,2,5,5,7,3,"H"
"2012-09-08",2012,"Kidderminster Harriers","Southport","2-2",2,2,5,5,4,0,"D"
"2012-09-08",2012,"Macclesfield","Braintree Town","2-1",2,1,5,5,3,1,"H"
"2012-09-08",2012,"Newport County","Stockport County","0-0",0,0,5,5,0,0,"D"
"2012-09-08",2012,"Tamworth","Barrow","1-3",1,3,5,5,4,-2,"A"
"2012-09-08",2012,"Telford United","Lincoln City","1-1",1,1,5,5,2,0,"D"
"2012-09-08",2012,"Woking","Nuneaton Town","6-1",6,1,5,5,7,5,"H"
"2012-09-15",2012,"Barrow","Newport County","0-3",0,3,5,5,3,-3,"A"
"2012-09-15",2012,"Cambridge United","Telford United","3-3",3,3,5,5,6,0,"D"
"2012-09-15",2012,"Dartford","Hereford United","4-0",4,0,5,5,4,4,"H"
"2012-09-15",2012,"Forest Green Rovers","Alfreton Town","1-1",1,1,5,5,2,0,"D"
"2012-09-15",2012,"Gateshead","Tamworth","0-2",0,2,5,5,2,-2,"A"
"2012-09-15",2012,"Kidderminster Harriers","Grimsby Town","0-0",0,0,5,5,0,0,"D"
"2012-09-15",2012,"Lincoln City","Hyde United","3-2",3,2,5,5,5,1,"H"
"2012-09-15",2012,"Luton Town","Wrexham","0-0",0,0,5,5,0,0,"D"
"2012-09-15",2012,"Mansfield Town","Braintree Town","2-0",2,0,5,5,2,2,"H"
"2012-09-15",2012,"Nuneaton Town","Macclesfield","3-3",3,3,5,5,6,0,"D"
"2012-09-15",2012,"Southport","Ebbsfleet United","1-0",1,0,5,5,1,1,"H"
"2012-09-15",2012,"Stockport County","Woking","1-2",1,2,5,5,3,-1,"A"
"2012-09-21",2012,"Grimsby Town","Luton Town","4-1",4,1,5,5,5,3,"H"
"2012-09-22",2012,"Alfreton Town","Kidderminster Harriers","1-1",1,1,5,5,2,0,"D"
"2012-09-22",2012,"Braintree Town","Stockport County","0-0",0,0,5,5,0,0,"D"
"2012-09-22",2012,"Ebbsfleet United","Barrow","2-4",2,4,5,5,6,-2,"A"
"2012-09-22",2012,"Hereford United","Cambridge United","4-2",4,2,5,5,6,2,"H"
"2012-09-22",2012,"Hyde United","Nuneaton Town","2-2",2,2,5,5,4,0,"D"
"2012-09-22",2012,"Macclesfield","Forest Green Rovers","1-2",1,2,5,5,3,-1,"A"
"2012-09-22",2012,"Newport County","Southport","2-1",2,1,5,5,3,1,"H"
"2012-09-22",2012,"Tamworth","Lincoln City","1-0",1,0,5,5,1,1,"H"
"2012-09-22",2012,"Telford United","Mansfield Town","2-2",2,2,5,5,4,0,"D"
"2012-09-22",2012,"Woking","Gateshead","2-1",2,1,5,5,3,1,"H"
"2012-09-22",2012,"Wrexham","Dartford","2-2",2,2,5,5,4,0,"D"
"2012-09-25",2012,"Braintree Town","Dartford","0-2",0,2,5,5,2,-2,"A"
"2012-09-25",2012,"Cambridge United","Kidderminster Harriers","1-3",1,3,5,5,4,-2,"A"
"2012-09-25",2012,"Ebbsfleet United","Woking","2-2",2,2,5,5,4,0,"D"
"2012-09-25",2012,"Grimsby Town","Gateshead","3-0",3,0,5,5,3,3,"H"
"2012-09-25",2012,"Hereford United","Forest Green Rovers","1-2",1,2,5,5,3,-1,"A"
"2012-09-25",2012,"Lincoln City","Nuneaton Town","2-1",2,1,5,5,3,1,"H"
"2012-09-25",2012,"Southport","Stockport County","1-1",1,1,5,5,2,0,"D"
"2012-09-25",2012,"Tamworth","Luton Town","1-2",1,2,5,5,3,-1,"A"
"2012-09-25",2012,"Telford United","Newport County","2-4",2,4,5,5,6,-2,"A"
"2012-09-25",2012,"Wrexham","Barrow","3-0",3,0,5,5,3,3,"H"
"2012-09-28",2012,"Forest Green Rovers","Lincoln City","3-0",3,0,5,5,3,3,"H"
"2012-09-29",2012,"Alfreton Town","Braintree Town","1-1",1,1,5,5,2,0,"D"
"2012-09-29",2012,"Barrow","Cambridge United","1-4",1,4,5,5,5,-3,"A"
"2012-09-29",2012,"Dartford","Hyde United","2-1",2,1,5,5,3,1,"H"
"2012-09-29",2012,"Gateshead","Telford United","1-1",1,1,5,5,2,0,"D"
"2012-09-29",2012,"Kidderminster Harriers","Macclesfield","3-0",3,0,5,5,3,3,"H"
"2012-09-29",2012,"Luton Town","Southport","3-1",3,1,5,5,4,2,"H"
"2012-09-29",2012,"Mansfield Town","Hereford United","1-1",1,1,5,5,2,0,"D"
"2012-09-29",2012,"Newport County","Grimsby Town","0-0",0,0,5,5,0,0,"D"
"2012-09-29",2012,"Nuneaton Town","Wrexham","0-0",0,0,5,5,0,0,"D"
"2012-09-29",2012,"Stockport County","Ebbsfleet United","3-1",3,1,5,5,4,2,"H"
"2012-09-29",2012,"Woking","Tamworth","2-3",2,3,5,5,5,-1,"A"
"2012-10-06",2012,"Braintree Town","Barrow","2-3",2,3,5,5,5,-1,"A"
"2012-10-06",2012,"Cambridge United","Mansfield Town","4-1",4,1,5,5,5,3,"H"
"2012-10-06",2012,"Ebbsfleet United","Kidderminster Harriers","1-1",1,1,5,5,2,0,"D"
"2012-10-06",2012,"Grimsby Town","Dartford","0-2",0,2,5,5,2,-2,"A"
"2012-10-06",2012,"Hereford United","Stockport County","1-2",1,2,5,5,3,-1,"A"
"2012-10-06",2012,"Hyde United","Gateshead","1-1",1,1,5,5,2,0,"D"
"2012-10-06",2012,"Lincoln City","Luton Town","1-2",1,2,5,5,3,-1,"A"
"2012-10-06",2012,"Macclesfield","Alfreton Town","1-2",1,2,5,5,3,-1,"A"
"2012-10-06",2012,"Southport","Nuneaton Town","3-1",3,1,5,5,4,2,"H"
"2012-10-06",2012,"Tamworth","Newport County","1-2",1,2,5,5,3,-1,"A"
"2012-10-06",2012,"Telford United","Woking","1-0",1,0,5,5,1,1,"H"
"2012-10-06",2012,"Wrexham","Forest Green Rovers","2-1",2,1,5,5,3,1,"H"
"2012-10-09",2012,"Alfreton Town","Grimsby Town","0-2",0,2,5,5,2,-2,"A"
"2012-10-09",2012,"Barrow","Southport","3-2",3,2,5,5,5,1,"H"
"2012-10-09",2012,"Dartford","Telford United","1-4",1,4,5,5,5,-3,"A"
"2012-10-09",2012,"Forest Green Rovers","Tamworth","1-2",1,2,5,5,3,-1,"A"
"2012-10-09",2012,"Gateshead","Macclesfield","2-2",2,2,5,5,4,0,"D"
"2012-10-09",2012,"Kidderminster Harriers","Hyde United","3-0",3,0,5,5,3,3,"H"
"2012-10-09",2012,"Luton Town","Braintree Town","2-3",2,3,5,5,5,-1,"A"
"2012-10-09",2012,"Mansfield Town","Lincoln City","0-0",0,0,5,5,0,0,"D"
"2012-10-09",2012,"Newport County","Ebbsfleet United","1-0",1,0,5,5,1,1,"H"
"2012-10-09",2012,"Nuneaton Town","Hereford United","0-0",0,0,5,5,0,0,"D"
"2012-10-09",2012,"Woking","Cambridge United","2-1",2,1,5,5,3,1,"H"
"2012-10-10",2012,"Stockport County","Wrexham","2-3",2,3,5,5,5,-1,"A"
"2012-10-13",2012,"Barrow","Dartford","0-0",0,0,5,5,0,0,"D"
"2012-10-13",2012,"Ebbsfleet United","Alfreton Town","0-0",0,0,5,5,0,0,"D"
"2012-10-13",2012,"Gateshead","Cambridge United","0-0",0,0,5,5,0,0,"D"
"2012-10-13",2012,"Hereford United","Braintree Town","0-0",0,0,5,5,0,0,"D"
"2012-10-13",2012,"Hyde United","Tamworth","2-1",2,1,5,5,3,1,"H"
"2012-10-13",2012,"Luton Town","Nuneaton Town","2-0",2,0,5,5,2,2,"H"
"2012-10-13",2012,"Macclesfield","Newport County","1-1",1,1,5,5,2,0,"D"
"2012-10-13",2012,"Mansfield Town","Forest Green Rovers","1-0",1,0,5,5,1,1,"H"
"2012-10-13",2012,"Stockport County","Kidderminster Harriers","1-0",1,0,5,5,1,1,"H"
"2012-10-13",2012,"Telford United","Grimsby Town","1-2",1,2,5,5,3,-1,"A"
"2012-10-13",2012,"Woking","Southport","2-3",2,3,5,5,5,-1,"A"
"2012-10-13",2012,"Wrexham","Lincoln City","2-4",2,4,5,5,6,-2,"A"
"2012-10-26",2012,"Dartford","Mansfield Town","2-0",2,0,5,5,2,2,"H"
"2012-10-27",2012,"Alfreton Town","Telford United","1-1",1,1,5,5,2,0,"D"
"2012-10-27",2012,"Cambridge United","Hyde United","0-1",0,1,5,5,1,-1,"A"
"2012-10-27",2012,"Forest Green Rovers","Luton Town","1-2",1,2,5,5,3,-1,"A"
"2012-10-27",2012,"Grimsby Town","Macclesfield","0-1",0,1,5,5,1,-1,"A"
"2012-10-27",2012,"Kidderminster Harriers","Gateshead","1-1",1,1,5,5,2,0,"D"
"2012-10-27",2012,"Lincoln City","Stockport County","3-3",3,3,5,5,6,0,"D"
"2012-10-27",2012,"Newport County","Woking","2-3",2,3,5,5,5,-1,"A"
"2012-10-27",2012,"Nuneaton Town","Barrow","1-1",1,1,5,5,2,0,"D"
"2012-10-27",2012,"Southport","Hereford United","2-2",2,2,5,5,4,0,"D"
"2012-10-27",2012,"Tamworth","Ebbsfleet United","0-1",0,1,5,5,1,-1,"A"
"2012-11-03",2012,"Gateshead","Woking","2-1",2,1,5,5,3,1,"H"
"2012-11-03",2012,"Tamworth","Grimsby Town","0-1",0,1,5,5,1,-1,"A"
"2012-11-06",2012,"Dartford","Forest Green Rovers","0-1",0,1,5,5,1,-1,"A"
"2012-11-06",2012,"Gateshead","Alfreton Town","2-0",2,0,5,5,2,2,"H"
"2012-11-06",2012,"Hereford United","Luton Town","1-0",1,0,5,5,1,1,"H"
"2012-11-06",2012,"Hyde United","Grimsby Town","3-2",3,2,5,5,5,1,"H"
"2012-11-06",2012,"Lincoln City","Braintree Town","3-0",3,0,5,5,3,3,"H"
"2012-11-06",2012,"Macclesfield","Tamworth","2-0",2,0,5,5,2,2,"H"
"2012-11-06",2012,"Newport County","Cambridge United","6-2",6,2,5,5,8,4,"H"
"2012-11-06",2012,"Nuneaton Town","Mansfield Town","1-1",1,1,5,5,2,0,"D"
"2012-11-06",2012,"Southport","Wrexham","1-4",1,4,5,5,5,-3,"A"
"2012-11-06",2012,"Stockport County","Barrow","3-1",3,1,5,5,4,2,"H"
"2012-11-06",2012,"Telford United","Ebbsfleet United","2-2",2,2,5,5,4,0,"D"
"2012-11-06",2012,"Woking","Kidderminster Harriers","2-2",2,2,5,5,4,0,"D"
"2012-11-09",2012,"Alfreton Town","Newport County","4-3",4,3,5,5,7,1,"H"
"2012-11-10",2012,"Barrow","Lincoln City","1-2",1,2,5,5,3,-1,"A"
"2012-11-10",2012,"Braintree Town","Gateshead","2-1",2,1,5,5,3,1,"H"
"2012-11-10",2012,"Cambridge United","Macclesfield","2-0",2,0,5,5,2,2,"H"
"2012-11-10",2012,"Ebbsfleet United","Hyde United","3-2",3,2,5,5,5,1,"H"
"2012-11-10",2012,"Forest Green Rovers","Stockport County","4-1",4,1,5,5,5,3,"H"
"2012-11-10",2012,"Grimsby Town","Woking","5-1",5,1,5,5,6,4,"H"
"2012-11-10",2012,"Kidderminster Harriers","Nuneaton Town","1-0",1,0,5,5,1,1,"H"
"2012-11-10",2012,"Luton Town","Dartford","0-2",0,2,5,5,2,-2,"A"
"2012-11-10",2012,"Mansfield Town","Southport","1-0",1,0,5,5,1,1,"H"
"2012-11-10",2012,"Tamworth","Telford United","0-0",0,0,5,5,0,0,"D"
"2012-11-10",2012,"Wrexham","Hereford United","1-2",1,2,5,5,3,-1,"A"
"2012-11-17",2012,"Barrow","Forest Green Rovers","2-2",2,2,5,5,4,0,"D"
"2012-11-17",2012,"Cambridge United","Tamworth","1-1",1,1,5,5,2,0,"D"
"2012-11-17",2012,"Dartford","Southport","2-2",2,2,5,5,4,0,"D"
"2012-11-17",2012,"Grimsby Town","Braintree Town","3-0",3,0,5,5,3,3,"H"
"2012-11-17",2012,"Lincoln City","Hereford United","3-2",3,2,5,5,5,1,"H"
"2012-11-17",2012,"Macclesfield","Ebbsfleet United","1-2",1,2,5,5,3,-1,"A"
"2012-11-17",2012,"Newport County","Hyde United","1-3",1,3,5,5,4,-2,"A"
"2012-11-17",2012,"Nuneaton Town","Stockport County","2-0",2,0,5,5,2,2,"H"
"2012-11-17",2012,"Telford United","Kidderminster Harriers","0-2",0,2,5,5,2,-2,"A"
"2012-11-17",2012,"Woking","Alfreton Town","1-2",1,2,5,5,3,-1,"A"
"2012-11-17",2012,"Wrexham","Gateshead","1-1",1,1,5,5,2,0,"D"
"2012-11-18",2012,"Mansfield Town","Luton Town","2-2",2,2,5,5,4,0,"D"
"2012-11-20",2012,"Braintree Town","Wrexham","1-5",1,5,5,5,6,-4,"A"
"2012-11-20",2012,"Hyde United","Alfreton Town","1-1",1,1,5,5,2,0,"D"
"2012-11-20",2012,"Macclesfield","Mansfield Town","0-3",0,3,5,5,3,-3,"A"
"2012-12-01",2012,"Ebbsfleet United","Grimsby Town","1-1",1,1,5,5,2,0,"D"
"2012-12-01",2012,"Forest Green Rovers","Nuneaton Town","1-0",1,0,5,5,1,1,"H"
"2012-12-01",2012,"Hyde United","Woking","7-0",7,0,5,5,7,7,"H"
"2012-12-01",2012,"Kidderminster Harriers","Wrexham","2-0",2,0,5,5,2,2,"H"
"2012-12-01",2012,"Newport County","Gateshead","3-1",3,1,5,5,4,2,"H"
"2012-12-01",2012,"Stockport County","Southport","3-4",3,4,5,5,7,-1,"A"
"2012-12-01",2012,"Tamworth","Dartford","3-2",3,2,5,5,5,1,"H"
"2012-12-04",2012,"Ebbsfleet United","Cambridge United","2-4",2,4,5,5,6,-2,"A"
"2012-12-04",2012,"Lincoln City","Woking","0-2",0,2,5,5,2,-2,"A"
"2012-12-04",2012,"Macclesfield","Hyde United","3-2",3,2,5,5,5,1,"H"
"2012-12-04",2012,"Nuneaton Town","Dartford","1-0",1,0,5,5,1,1,"H"
"2012-12-04",2012,"Tamworth","Kidderminster Harriers","0-1",0,1,5,5,1,-1,"A"
"2012-12-04",2012,"Telford United","Barrow","1-1",1,1,5,5,2,0,"D"
"2012-12-07",2012,"Barrow","Hereford United","0-2",0,2,5,5,2,-2,"A"
"2012-12-08",2012,"Cambridge United","Gateshead","3-0",3,0,5,5,3,3,"H"
"2012-12-08",2012,"Dartford","Lincoln City","2-4",2,4,5,5,6,-2,"A"
"2012-12-08",2012,"Forest Green Rovers","Macclesfield","1-1",1,1,5,5,2,0,"D"
"2012-12-08",2012,"Grimsby Town","Tamworth","2-0",2,0,5,5,2,2,"H"
"2012-12-08",2012,"Hyde United","Telford United","2-1",2,1,5,5,3,1,"H"
"2012-12-08",2012,"Kidderminster Harriers","Newport County","3-2",3,2,5,5,5,1,"H"
"2012-12-08",2012,"Luton Town","Alfreton Town","3-0",3,0,5,5,3,3,"H"
"2012-12-08",2012,"Mansfield Town","Ebbsfleet United","4-1",4,1,5,5,5,3,"H"
"2012-12-08",2012,"Southport","Braintree Town","0-2",0,2,5,5,2,-2,"A"
"2012-12-08",2012,"Woking","Stockport County","1-0",1,0,5,5,1,1,"H"
"2012-12-08",2012,"Wrexham","Nuneaton Town","6-1",6,1,5,5,7,5,"H"
"2012-12-11",2012,"Newport County","Luton Town","5-2",5,2,5,5,7,3,"H"
"2012-12-15",2012,"Macclesfield","Nuneaton Town","0-0",0,0,5,5,0,0,"D"
"2012-12-18",2012,"Alfreton Town","Cambridge United","1-1",1,1,5,5,2,0,"D"
"2012-12-18",2012,"Braintree Town","Forest Green Rovers","3-1",3,1,5,5,4,2,"H"
"2012-12-21",2012,"Grimsby Town","Wrexham","1-0",1,0,5,5,1,1,"H"
"2012-12-22",2012,"Kidderminster Harriers","Dartford","5-1",5,1,5,5,6,4,"H"
"2012-12-26",2012,"Barrow","Gateshead","0-2",0,2,5,5,2,-2,"A"
"2012-12-26",2012,"Braintree Town","Cambridge United","0-3",0,3,5,5,3,-3,"A"
"2012-12-26",2012,"Dartford","Ebbsfleet United","3-1",3,1,5,5,4,2,"H"
"2012-12-26",2012,"Forest Green Rovers","Newport County","1-2",1,2,5,5,3,-1,"A"
"2012-12-26",2012,"Hereford United","Kidderminster Harriers","0-1",0,1,5,5,1,-1,"A"
"2012-12-26",2012,"Lincoln City","Grimsby Town","1-4",1,4,5,5,5,-3,"A"
"2012-12-26",2012,"Luton Town","Woking","3-1",3,1,5,5,4,2,"H"
"2012-12-26",2012,"Mansfield Town","Alfreton Town","1-2",1,2,5,5,3,-1,"A"
"2012-12-26",2012,"Nuneaton Town","Tamworth","2-1",2,1,5,5,3,1,"H"
"2012-12-26",2012,"Southport","Macclesfield","3-2",3,2,5,5,5,1,"H"
"2012-12-26",2012,"Stockport County","Hyde United","0-2",0,2,5,5,2,-2,"A"
"2012-12-26",2012,"Wrexham","Telford United","4-1",4,1,5,5,5,3,"H"
"2012-12-29",2012,"Dartford","Cambridge United","1-1",1,1,5,5,2,0,"D"
"2012-12-29",2012,"Lincoln City","Gateshead","1-1",1,1,5,5,2,0,"D"
"2012-12-29",2012,"Southport","Hyde United","0-1",0,1,5,5,1,-1,"A"
"2012-12-29",2012,"Stockport County","Telford United","2-2",2,2,5,5,4,0,"D"
"2012-12-29",2012,"Wrexham","Tamworth","2-2",2,2,5,5,4,0,"D"
"2013-01-01",2012,"Alfreton Town","Mansfield Town","0-3",0,3,5,5,3,-3,"A"
"2013-01-01",2012,"Cambridge United","Braintree Town","1-0",1,0,5,5,1,1,"H"
"2013-01-01",2012,"Ebbsfleet United","Dartford","2-2",2,2,5,5,4,0,"D"
"2013-01-01",2012,"Gateshead","Barrow","0-1",0,1,5,5,1,-1,"A"
"2013-01-01",2012,"Grimsby Town","Lincoln City","1-1",1,1,5,5,2,0,"D"
"2013-01-01",2012,"Hyde United","Stockport County","0-1",0,1,5,5,1,-1,"A"
"2013-01-01",2012,"Kidderminster Harriers","Hereford United","0-1",0,1,5,5,1,-1,"A"
"2013-01-01",2012,"Macclesfield","Southport","2-2",2,2,5,5,4,0,"D"
"2013-01-01",2012,"Newport County","Forest Green Rovers","0-5",0,5,5,5,5,-5,"A"
"2013-01-01",2012,"Telford United","Wrexham","0-2",0,2,5,5,2,-2,"A"
"2013-01-01",2012,"Woking","Luton Town","3-1",3,1,5,5,4,2,"H"
"2013-01-02",2012,"Tamworth","Nuneaton Town","2-1",2,1,5,5,3,1,"H"
"2013-01-04",2012,"Newport County","Wrexham","1-1",1,1,5,5,2,0,"D"
"2013-01-05",2012,"Alfreton Town","Dartford","3-2",3,2,5,5,5,1,"H"
"2013-01-05",2012,"Cambridge United","Stockport County","4-1",4,1,5,5,5,3,"H"
"2013-01-05",2012,"Ebbsfleet United","Lincoln City","1-1",1,1,5,5,2,0,"D"
"2013-01-05",2012,"Grimsby Town","Hereford United","1-1",1,1,5,5,2,0,"D"
"2013-01-05",2012,"Hyde United","Forest Green Rovers","0-1",0,1,5,5,1,-1,"A"
"2013-01-05",2012,"Kidderminster Harriers","Barrow","2-0",2,0,5,5,2,2,"H"
"2013-01-05",2012,"Tamworth","Braintree Town","1-4",1,4,5,5,5,-3,"A"
"2013-01-05",2012,"Telford United","Southport","1-3",1,3,5,5,4,-2,"A"
"2013-01-08",2012,"Alfreton Town","Wrexham","1-2",1,2,5,5,3,-1,"A"
"2013-01-08",2012,"Braintree Town","Macclesfield","0-3",0,3,5,5,3,-3,"A"
"2013-01-08",2012,"Hereford United","Telford United","1-1",1,1,5,5,2,0,"D"
"2013-01-08",2012,"Luton Town","Barrow","6-1",6,1,5,5,7,5,"H"
"2013-01-08",2012,"Southport","Lincoln City","4-2",4,2,5,5,6,2,"H"
"2013-01-12",2012,"Braintree Town","Telford United","3-2",3,2,5,5,5,1,"H"
"2013-01-12",2012,"Hereford United","Alfreton Town","3-3",3,3,5,5,6,0,"D"
"2013-01-12",2012,"Lincoln City","Newport County","2-4",2,4,5,5,6,-2,"A"
"2013-01-12",2012,"Mansfield Town","Kidderminster Harriers","0-2",0,2,5,5,2,-2,"A"
"2013-01-12",2012,"Nuneaton Town","Forest Green Rovers","1-1",1,1,5,5,2,0,"D"
"2013-01-13",2012,"Woking","Ebbsfleet United","1-0",1,0,5,5,1,1,"H"
"2013-01-15",2012,"Cambridge United","Nuneaton Town","1-3",1,3,5,5,4,-2,"A"
"2013-01-15",2012,"Dartford","Macclesfield","2-0",2,0,5,5,2,2,"H"
"2013-01-15",2012,"Stockport County","Mansfield Town","1-3",1,3,5,5,4,-2,"A"
"2013-01-15",2012,"Telford United","Luton Town","0-0",0,0,5,5,0,0,"D"
"2013-01-19",2012,"Macclesfield","Kidderminster Harriers","1-0",1,0,5,5,1,1,"H"
"2013-01-19",2012,"Newport County","Barrow","0-2",0,2,5,5,2,-2,"A"
"2013-01-19",2012,"Southport","Mansfield Town","1-2",1,2,5,5,3,-1,"A"
"2013-01-19",2012,"Stockport County","Forest Green Rovers","2-1",2,1,5,5,3,1,"H"
"2013-01-19",2012,"Telford United","Alfreton Town","0-0",0,0,5,5,0,0,"D"
"2013-01-22",2012,"Grimsby Town","Hyde United","2-0",2,0,5,5,2,2,"H"
"2013-01-26",2012,"Cambridge United","Grimsby Town","0-0",0,0,5,5,0,0,"D"
"2013-01-26",2012,"Lincoln City","Forest Green Rovers","1-2",1,2,5,5,3,-1,"A"
"2013-01-26",2012,"Nuneaton Town","Braintree Town","2-4",2,4,5,5,6,-2,"A"
"2013-01-29",2012,"Kidderminster Harriers","Telford United","1-0",1,0,5,5,1,1,"H"
"2013-01-29",2012,"Wrexham","Southport","2-2",2,2,5,5,4,0,"D"
"2013-02-01",2012,"Ebbsfleet United","Macclesfield","0-4",0,4,5,5,4,-4,"A"
"2013-02-02",2012,"Barrow","Luton Town","1-0",1,0,5,5,1,1,"H"
"2013-02-02",2012,"Forest Green Rovers","Wrexham","0-0",0,0,5,5,0,0,"D"
"2013-02-02",2012,"Grimsby Town","Alfreton Town","4-2",4,2,5,5,6,2,"H"
"2013-02-02",2012,"Hereford United","Southport","2-2",2,2,5,5,4,0,"D"
"2013-02-02",2012,"Mansfield Town","Dartford","5-0",5,0,5,5,5,5,"H"
"2013-02-02",2012,"Stockport County","Nuneaton Town","3-2",3,2,5,5,5,1,"H"
"2013-02-02",2012,"Tamworth","Gateshead","2-0",2,0,5,5,2,2,"H"
"2013-02-02",2012,"Telford United","Cambridge United","1-2",1,2,5,5,3,-1,"A"
"2013-02-02",2012,"Woking","Hyde United","2-1",2,1,5,5,3,1,"H"
"2013-02-09",2012,"Alfreton Town","Woking","0-3",0,3,5,5,3,-3,"A"
"2013-02-09",2012,"Braintree Town","Hereford United","0-2",0,2,5,5,2,-2,"A"
"2013-02-09",2012,"Ebbsfleet United","Gateshead","3-1",3,1,5,5,4,2,"H"
"2013-02-09",2012,"Grimsby Town","Telford United","1-0",1,0,5,5,1,1,"H"
"2013-02-09",2012,"Hyde United","Macclesfield","1-1",1,1,5,5,2,0,"D"
"2013-02-09",2012,"Kidderminster Harriers","Cambridge United","3-2",3,2,5,5,5,1,"H"
"2013-02-09",2012,"Lincoln City","Dartford","2-1",2,1,5,5,3,1,"H"
"2013-02-09",2012,"Luton Town","Forest Green Rovers","1-1",1,1,5,5,2,0,"D"
"2013-02-09",2012,"Mansfield Town","Barrow","8-1",8,1,5,5,9,7,"H"
"2013-02-09",2012,"Newport County","Tamworth","2-2",2,2,5,5,4,0,"D"
"2013-02-09",2012,"Nuneaton Town","Southport","0-1",0,1,5,5,1,-1,"A"
"2013-02-09",2012,"Wrexham","Stockport County","3-1",3,1,5,5,4,2,"H"
"2013-02-12",2012,"Cambridge United","Alfreton Town","0-3",0,3,5,5,3,-3,"A"
"2013-02-12",2012,"Dartford","Luton Town","1-0",1,0,5,5,1,1,"H"
"2013-02-12",2012,"Forest Green Rovers","Braintree Town","4-1",4,1,5,5,5,3,"H"
"2013-02-12",2012,"Hereford United","Wrexham","0-1",0,1,5,5,1,-1,"A"
"2013-02-12",2012,"Newport County","Mansfield Town","2-0",2,0,5,5,2,2,"H"
"2013-02-12",2012,"Southport","Barrow","5-2",5,2,5,5,7,3,"H"
"2013-02-12",2012,"Stockport County","Lincoln City","2-0",2,0,5,5,2,2,"H"
"2013-02-12",2012,"Tamworth","Macclesfield","0-0",0,0,5,5,0,0,"D"
"2013-02-12",2012,"Telford United","Hyde United","1-3",1,3,5,5,4,-2,"A"
"2013-02-16",2012,"Alfreton Town","Macclesfield","1-2",1,2,5,5,3,-1,"A"
"2013-02-16",2012,"Barrow","Nuneaton Town","1-2",1,2,5,5,3,-1,"A"
"2013-02-16",2012,"Ebbsfleet United","Stockport County","0-0",0,0,5,5,0,0,"D"
"2013-02-16",2012,"Forest Green Rovers","Gateshead","1-0",1,0,5,5,1,1,"H"
"2013-02-16",2012,"Hereford United","Lincoln City","3-2",3,2,5,5,5,1,"H"
"2013-02-16",2012,"Hyde United","Kidderminster Harriers","0-4",0,4,5,5,4,-4,"A"
"2013-02-16",2012,"Mansfield Town","Cambridge United","3-1",3,1,5,5,4,2,"H"
"2013-02-16",2012,"Telford United","Tamworth","3-3",3,3,5,5,6,0,"D"
"2013-02-16",2012,"Woking","Newport County","1-3",1,3,5,5,4,-2,"A"
"2013-02-19",2012,"Barrow","Woking","2-0",2,0,5,5,2,2,"H"
"2013-02-19",2012,"Braintree Town","Grimsby Town","2-0",2,0,5,5,2,2,"H"
"2013-02-19",2012,"Ebbsfleet United","Hereford United","1-0",1,0,5,5,1,1,"H"
"2013-02-19",2012,"Forest Green Rovers","Kidderminster Harriers","0-1",0,1,5,5,1,-1,"A"
"2013-02-19",2012,"Gateshead","Wrexham","0-1",0,1,5,5,1,-1,"A"
"2013-02-19",2012,"Hyde United","Mansfield Town","0-1",0,1,5,5,1,-1,"A"
"2013-02-19",2012,"Macclesfield","Luton Town","1-1",1,1,5,5,2,0,"D"
"2013-02-19",2012,"Nuneaton Town","Alfreton Town","1-0",1,0,5,5,1,1,"H"
"2013-02-19",2012,"Stockport County","Tamworth","0-1",0,1,5,5,1,-1,"A"
"2013-02-22",2012,"Macclesfield","Gateshead","0-4",0,4,5,5,4,-4,"A"
"2013-02-23",2012,"Cambridge United","Hereford United","1-3",1,3,5,5,4,-2,"A"
"2013-02-23",2012,"Kidderminster Harriers","Alfreton Town","3-1",3,1,5,5,4,2,"H"
"2013-02-23",2012,"Lincoln City","Barrow","0-0",0,0,5,5,0,0,"D"
"2013-02-23",2012,"Luton Town","Mansfield Town","2-3",2,3,5,5,5,-1,"A"
"2013-02-23",2012,"Newport County","Telford United","2-1",2,1,5,5,3,1,"H"
"2013-02-23",2012,"Southport","Woking","1-2",1,2,5,5,3,-1,"A"
"2013-02-23",2012,"Tamworth","Hyde United","2-0",2,0,5,5,2,2,"H"
"2013-02-26",2012,"Alfreton Town","Hyde United","5-1",5,1,5,5,6,4,"H"
"2013-02-26",2012,"Barrow","Wrexham","0-1",0,1,5,5,1,-1,"A"
"2013-02-26",2012,"Braintree Town","Luton Town","2-0",2,0,5,5,2,2,"H"
"2013-02-26",2012,"Grimsby Town","Ebbsfleet United","3-1",3,1,5,5,4,2,"H"
"2013-02-26",2012,"Lincoln City","Mansfield Town","0-1",0,1,5,5,1,-1,"A"
"2013-02-26",2012,"Nuneaton Town","Kidderminster Harriers","0-1",0,1,5,5,1,-1,"A"
"2013-02-26",2012,"Stockport County","Hereford United","2-3",2,3,5,5,5,-1,"A"
"2013-02-26",2012,"Tamworth","Cambridge United","1-2",1,2,5,5,3,-1,"A"
"2013-02-26",2012,"Woking","Forest Green Rovers","2-0",2,0,5,5,2,2,"H"
"2013-03-02",2012,"Barrow","Tamworth","2-0",2,0,5,5,2,2,"H"
"2013-03-02",2012,"Cambridge United","Forest Green Rovers","0-0",0,0,5,5,0,0,"D"
"2013-03-02",2012,"Gateshead","Braintree Town","1-2",1,2,5,5,3,-1,"A"
"2013-03-02",2012,"Hereford United","Nuneaton Town","0-0",0,0,5,5,0,0,"D"
"2013-03-02",2012,"Hyde United","Newport County","0-1",0,1,5,5,1,-1,"A"
"2013-03-02",2012,"Kidderminster Harriers","Ebbsfleet United","3-2",3,2,5,5,5,1,"H"
"2013-03-02",2012,"Mansfield Town","Telford United","1-0",1,0,5,5,1,1,"H"
"2013-03-02",2012,"Southport","Dartford","2-2",2,2,5,5,4,0,"D"
"2013-03-02",2012,"Stockport County","Luton Town","0-1",0,1,5,5,1,-1,"A"
"2013-03-02",2012,"Woking","Lincoln City","1-1",1,1,5,5,2,0,"D"
"2013-03-02",2012,"Wrexham","Alfreton Town","1-1",1,1,5,5,2,0,"D"
"2013-03-05",2012,"Dartford","Stockport County","1-1",1,1,5,5,2,0,"D"
"2013-03-05",2012,"Forest Green Rovers","Grimsby Town","0-1",0,1,5,5,1,-1,"A"
"2013-03-05",2012,"Gateshead","Kidderminster Harriers","2-0",2,0,5,5,2,2,"H"
"2013-03-05",2012,"Hereford United","Newport County","2-3",2,3,5,5,5,-1,"A"
"2013-03-05",2012,"Nuneaton Town","Luton Town","0-0",0,0,5,5,0,0,"D"
"2013-03-05",2012,"Southport","Cambridge United","2-1",2,1,5,5,3,1,"H"
"2013-03-05",2012,"Wrexham","Ebbsfleet United","4-1",4,1,5,5,5,3,"H"
"2013-03-06",2012,"Macclesfield","Lincoln City","2-1",2,1,5,5,3,1,"H"
"2013-03-06",2012,"Woking","Mansfield Town","1-2",1,2,5,5,3,-1,"A"
"2013-03-09",2012,"Cambridge United","Woking","1-0",1,0,5,5,1,1,"H"
"2013-03-09",2012,"Dartford","Wrexham","2-1",2,1,5,5,3,1,"H"
"2013-03-09",2012,"Ebbsfleet United","Newport County","1-1",1,1,5,5,2,0,"D"
"2013-03-09",2012,"Forest Green Rovers","Barrow","1-1",1,1,5,5,2,0,"D"
"2013-03-09",2012,"Gateshead","Hyde United","3-0",3,0,5,5,3,3,"H"
"2013-03-09",2012,"Grimsby Town","Kidderminster Harriers","1-3",1,3,5,5,4,-2,"A"
"2013-03-09",2012,"Lincoln City","Southport","1-0",1,0,5,5,1,1,"H"
"2013-03-09",2012,"Luton Town","Hereford United","1-1",1,1,5,5,2,0,"D"
"2013-03-09",2012,"Mansfield Town","Stockport County","4-1",4,1,5,5,5,3,"H"
"2013-03-09",2012,"Tamworth","Alfreton Town","1-1",1,1,5,5,2,0,"D"
"2013-03-09",2012,"Telford United","Macclesfield","0-2",0,2,5,5,2,-2,"A"
"2013-03-12",2012,"Alfreton Town","Ebbsfleet United","3-0",3,0,5,5,3,3,"H"
"2013-03-12",2012,"Barrow","Stockport County","0-2",0,2,5,5,2,-2,"A"
"2013-03-12",2012,"Lincoln City","Wrexham","1-2",1,2,5,5,3,-1,"A"
"2013-03-12",2012,"Luton Town","Hyde United","1-2",1,2,5,5,3,-1,"A"
"2013-03-12",2012,"Macclesfield","Woking","0-0",0,0,5,5,0,0,"D"
"2013-03-12",2012,"Mansfield Town","Grimsby Town","2-0",2,0,5,5,2,2,"H"
"2013-03-12",2012,"Southport","Forest Green Rovers","1-2",1,2,5,5,3,-1,"A"
"2013-03-13",2012,"Telford United","Gateshead","0-0",0,0,5,5,0,0,"D"
"2013-03-15",2012,"Forest Green Rovers","Mansfield Town","1-2",1,2,5,5,3,-1,"A"
"2013-03-16",2012,"Alfreton Town","Gateshead","3-2",3,2,5,5,5,1,"H"
"2013-03-16",2012,"Ebbsfleet United","Southport","4-1",4,1,5,5,5,3,"H"
"2013-03-16",2012,"Grimsby Town","Cambridge United","0-1",0,1,5,5,1,-1,"A"
"2013-03-16",2012,"Hereford United","Barrow","2-1",2,1,5,5,3,1,"H"
"2013-03-16",2012,"Hyde United","Dartford","3-0",3,0,5,5,3,3,"H"
"2013-03-16",2012,"Kidderminster Harriers","Tamworth","4-1",4,1,5,5,5,3,"H"
"2013-03-16",2012,"Nuneaton Town","Lincoln City","1-0",1,0,5,5,1,1,"H"
"2013-03-16",2012,"Stockport County","Braintree Town","1-3",1,3,5,5,4,-2,"A"
"2013-03-16",2012,"Woking","Telford United","5-2",5,2,5,5,7,3,"H"
"2013-03-16",2012,"Wrexham","Luton Town","0-0",0,0,5,5,0,0,"D"
"2013-03-19",2012,"Braintree Town","Woking","1-1",1,1,5,5,2,0,"D"
"2013-03-19",2012,"Cambridge United","Ebbsfleet United","1-1",1,1,5,5,2,0,"D"
"2013-03-19",2012,"Dartford","Barrow","0-1",0,1,5,5,1,-1,"A"
"2013-03-19",2012,"Gateshead","Hereford United","3-2",3,2,5,5,5,1,"H"
"2013-03-19",2012,"Luton Town","Stockport County","1-0",1,0,5,5,1,1,"H"
"2013-03-19",2012,"Macclesfield","Telford United","2-1",2,1,5,5,3,1,"H"
"2013-03-19",2012,"Newport County","Kidderminster Harriers","1-2",1,2,5,5,3,-1,"A"
"2013-03-19",2012,"Nuneaton Town","Grimsby Town","1-0",1,0,5,5,1,1,"H"
"2013-03-19",2012,"Tamworth","Southport","2-1",2,1,5,5,3,1,"H"
"2013-03-21",2012,"Braintree Town","Nuneaton Town","2-2",2,2,5,5,4,0,"D"
"2013-03-23",2012,"Dartford","Gateshead","3-0",3,0,5,5,3,3,"H"
"2013-03-23",2012,"Hereford United","Hyde United","1-2",1,2,5,5,3,-1,"A"
"2013-03-23",2012,"Lincoln City","Telford United","3-2",3,2,5,5,5,1,"H"
"2013-03-23",2012,"Luton Town","Tamworth","0-0",0,0,5,5,0,0,"D"
"2013-03-23",2012,"Southport","Kidderminster Harriers","1-3",1,3,5,5,4,-2,"A"
"2013-03-23",2012,"Stockport County","Newport County","1-0",1,0,5,5,1,1,"H"
"2013-03-26",2012,"Braintree Town","Lincoln City","0-3",0,3,5,5,3,-3,"A"
"2013-03-26",2012,"Gateshead","Grimsby Town","1-1",1,1,5,5,2,0,"D"
"2013-03-26",2012,"Hereford United","Dartford","1-0",1,0,5,5,1,1,"H"
"2013-03-26",2012,"Hyde United","Cambridge United","2-1",2,1,5,5,3,1,"H"
"2013-03-26",2012,"Kidderminster Harriers","Woking","2-2",2,2,5,5,4,0,"D"
"2013-03-26",2012,"Mansfield Town","Nuneaton Town","1-0",1,0,5,5,1,1,"H"
"2013-03-26",2012,"Southport","Newport County","0-2",0,2,5,5,2,-2,"A"
"2013-03-27",2012,"Barrow","Macclesfield","1-0",1,0,5,5,1,1,"H"
"2013-03-28",2012,"Braintree Town","Alfreton Town","2-1",2,1,5,5,3,1,"H"
"2013-03-28",2012,"Gateshead","Newport County","0-0",0,0,5,5,0,0,"D"
"2013-03-28",2012,"Nuneaton Town","Woking","0-0",0,0,5,5,0,0,"D"
"2013-03-30",2012,"Alfreton Town","Lincoln City","0-2",0,2,5,5,2,-2,"A"
"2013-03-30",2012,"Cambridge United","Luton Town","2-2",2,2,5,5,4,0,"D"
"2013-03-30",2012,"Ebbsfleet United","Forest Green Rovers","0-2",0,2,5,5,2,-2,"A"
"2013-03-30",2012,"Gateshead","Southport","2-2",2,2,5,5,4,0,"D"
"2013-03-30",2012,"Grimsby Town","Barrow","0-0",0,0,5,5,0,0,"D"
"2013-03-30",2012,"Hyde United","Wrexham","2-0",2,0,5,5,2,2,"H"
"2013-03-30",2012,"Kidderminster Harriers","Braintree Town","2-1",2,1,5,5,3,1,"H"
"2013-03-30",2012,"Macclesfield","Stockport County","1-1",1,1,5,5,2,0,"D"
"2013-03-30",2012,"Newport County","Dartford","0-0",0,0,5,5,0,0,"D"
"2013-03-30",2012,"Tamworth","Mansfield Town","0-1",0,1,5,5,1,-1,"A"
"2013-03-30",2012,"Telford United","Nuneaton Town","0-3",0,3,5,5,3,-3,"A"
"2013-03-30",2012,"Woking","Hereford United","1-1",1,1,5,5,2,0,"D"
"2013-04-01",2012,"Barrow","Hyde United","1-1",1,1,5,5,2,0,"D"
"2013-04-01",2012,"Braintree Town","Ebbsfleet United","3-1",3,1,5,5,4,2,"H"
"2013-04-01",2012,"Dartford","Woking","4-1",4,1,5,5,5,3,"H"
"2013-04-01",2012,"Forest Green Rovers","Telford United","0-0",0,0,5,5,0,0,"D"
"2013-04-01",2012,"Hereford United","Tamworth","5-2",5,2,5,5,7,3,"H"
"2013-04-01",2012,"Lincoln City","Cambridge United","0-0",0,0,5,5,0,0,"D"
"2013-04-01",2012,"Luton Town","Kidderminster Harriers","1-2",1,2,5,5,3,-1,"A"
"2013-04-01",2012,"Mansfield Town","Gateshead","4-0",4,0,5,5,4,4,"H"
"2013-04-01",2012,"Nuneaton Town","Newport County","1-2",1,2,5,5,3,-1,"A"
"2013-04-01",2012,"Southport","Alfreton Town","0-2",0,2,5,5,2,-2,"A"
"2013-04-01",2012,"Stockport County","Grimsby Town","1-2",1,2,5,5,3,-1,"A"
"2013-04-01",2012,"Wrexham","Macclesfield","0-0",0,0,5,5,0,0,"D"
"2013-04-03",2012,"Barrow","Ebbsfleet United","1-1",1,1,5,5,2,0,"D"
"2013-04-03",2012,"Braintree Town","Southport","1-3",1,3,5,5,4,-2,"A"
"2013-04-03",2012,"Macclesfield","Grimsby Town","1-3",1,3,5,5,4,-2,"A"
"2013-04-04",2012,"Wrexham","Mansfield Town","2-1",2,1,5,5,3,1,"H"
"2013-04-05",2012,"Cambridge United","Newport County","0-0",0,0,5,5,0,0,"D"
"2013-04-06",2012,"Alfreton Town","Stockport County","2-3",2,3,5,5,5,-1,"A"
"2013-04-06",2012,"Barrow","Mansfield Town","0-4",0,4,5,5,4,-4,"A"
"2013-04-06",2012,"Ebbsfleet United","Nuneaton Town","1-1",1,1,5,5,2,0,"D"
"2013-04-06",2012,"Gateshead","Luton Town","5-1",5,1,5,5,6,4,"H"
"2013-04-06",2012,"Grimsby Town","Southport","2-2",2,2,5,5,4,0,"D"
"2013-04-06",2012,"Hyde United","Braintree Town","1-2",1,2,5,5,3,-1,"A"
"2013-04-06",2012,"Kidderminster Harriers","Lincoln City","3-0",3,0,5,5,3,3,"H"
"2013-04-06",2012,"Macclesfield","Hereford United","0-1",0,1,5,5,1,-1,"A"
"2013-04-06",2012,"Tamworth","Forest Green Rovers","2-1",2,1,5,5,3,1,"H"
"2013-04-06",2012,"Telford United","Dartford","0-2",0,2,5,5,2,-2,"A"
"2013-04-06",2012,"Woking","Wrexham","2-0",2,0,5,5,2,2,"H"
"2013-04-09",2012,"Alfreton Town","Barrow","4-0",4,0,5,5,4,4,"H"
"2013-04-09",2012,"Dartford","Grimsby Town","1-2",1,2,5,5,3,-1,"A"
"2013-04-09",2012,"Forest Green Rovers","Hereford United","0-1",0,1,5,5,1,-1,"A"
"2013-04-09",2012,"Gateshead","Nuneaton Town","0-2",0,2,5,5,2,-2,"A"
"2013-04-09",2012,"Hyde United","Ebbsfleet United","1-0",1,0,5,5,1,1,"H"
"2013-04-09",2012,"Luton Town","Lincoln City","3-0",3,0,5,5,3,3,"H"
"2013-04-09",2012,"Mansfield Town","Macclesfield","3-1",3,1,5,5,4,2,"H"
"2013-04-09",2012,"Newport County","Braintree Town","1-0",1,0,5,5,1,1,"H"
"2013-04-09",2012,"Wrexham","Cambridge United","1-0",1,0,5,5,1,1,"H"
"2013-04-11",2012,"Alfreton Town","Tamworth","3-0",3,0,5,5,3,3,"H"
"2013-04-11",2012,"Dartford","Braintree Town","0-0",0,0,5,5,0,0,"D"
"2013-04-11",2012,"Newport County","Macclesfield","4-1",4,1,5,5,5,3,"H"
"2013-04-12",2012,"Luton Town","Grimsby Town","1-1",1,1,5,5,2,0,"D"
"2013-04-13",2012,"Braintree Town","Mansfield Town","2-1",2,1,5,5,3,1,"H"
"2013-04-13",2012,"Cambridge United","Barrow","2-1",2,1,5,5,3,1,"H"
"2013-04-13",2012,"Ebbsfleet United","Telford United","1-3",1,3,5,5,4,-2,"A"
"2013-04-13",2012,"Forest Green Rovers","Southport","0-1",0,1,5,5,1,-1,"A"
"2013-04-13",2012,"Hereford United","Gateshead","1-1",1,1,5,5,2,0,"D"
"2013-04-13",2012,"Lincoln City","Tamworth","2-1",2,1,5,5,3,1,"H"
"2013-04-13",2012,"Newport County","Alfreton Town","2-0",2,0,5,5,2,2,"H"
"2013-04-13",2012,"Nuneaton Town","Hyde United","3-1",3,1,5,5,4,2,"H"
"2013-04-13",2012,"Stockport County","Dartford","0-1",0,1,5,5,1,-1,"A"
"2013-04-13",2012,"Woking","Macclesfield","5-4",5,4,5,5,9,1,"H"
"2013-04-13",2012,"Wrexham","Kidderminster Harriers","1-2",1,2,5,5,3,-1,"A"
"2013-04-16",2012,"Ebbsfleet United","Tamworth","1-1",1,1,5,5,2,0,"D"
"2013-04-16",2012,"Forest Green Rovers","Dartford","2-3",2,3,5,5,5,-1,"A"
"2013-04-16",2012,"Gateshead","Stockport County","1-1",1,1,5,5,2,0,"D"
"2013-04-16",2012,"Hereford United","Mansfield Town","1-2",1,2,5,5,3,-1,"A"
"2013-04-16",2012,"Luton Town","Newport County","2-2",2,2,5,5,4,0,"D"
"2013-04-16",2012,"Woking","Grimsby Town","0-1",0,1,5,5,1,-1,"A"
"2013-04-16",2012,"Wrexham","Braintree Town","1-1",1,1,5,5,2,0,"D"
"2013-04-18",2012,"Luton Town","Ebbsfleet United","2-0",2,0,5,5,2,2,"H"
"2013-04-20",2012,"Alfreton Town","Forest Green Rovers","2-1",2,1,5,5,3,1,"H"
"2013-04-20",2012,"Barrow","Braintree Town","0-1",0,1,5,5,1,-1,"A"
"2013-04-20",2012,"Dartford","Nuneaton Town","0-1",0,1,5,5,1,-1,"A"
"2013-04-20",2012,"Gateshead","Ebbsfleet United","2-0",2,0,5,5,2,2,"H"
"2013-04-20",2012,"Grimsby Town","Newport County","3-0",3,0,5,5,3,3,"H"
"2013-04-20",2012,"Hyde United","Lincoln City","1-5",1,5,5,5,6,-4,"A"
"2013-04-20",2012,"Kidderminster Harriers","Stockport County","4-0",4,0,5,5,4,4,"H"
"2013-04-20",2012,"Macclesfield","Cambridge United","2-1",2,1,5,5,3,1,"H"
"2013-04-20",2012,"Mansfield Town","Wrexham","1-0",1,0,5,5,1,1,"H"
"2013-04-20",2012,"Southport","Luton Town","1-3",1,3,5,5,4,-2,"A"
"2013-04-20",2012,"Tamworth","Woking","2-1",2,1,5,5,3,1,"H"
"2013-04-20",2012,"Telford United","Hereford United","0-4",0,4,5,5,4,-4,"A"
"2013-08-10",2013,"Barnet","Chester","3-0",3,0,5,5,3,3,"H"
"2013-08-10",2013,"Dartford","Alfreton Town","1-0",1,0,5,5,1,1,"H"
"2013-08-10",2013,"Forest Green Rovers","Hyde United","8-0",8,0,5,5,8,8,"H"
"2013-08-10",2013,"Grimsby Town","Aldershot","1-1",1,1,5,5,2,0,"D"
"2013-08-10",2013,"Hereford United","Braintree Town","1-1",1,1,5,5,2,0,"D"
"2013-08-10",2013,"Kidderminster Harriers","Gateshead","3-1",3,1,5,5,4,2,"H"
"2013-08-10",2013,"Macclesfield","Nuneaton Town","0-1",0,1,5,5,1,-1,"A"
"2013-08-10",2013,"Salisbury","Tamworth","0-1",0,1,5,5,1,-1,"A"
"2013-08-10",2013,"Southport","Luton Town","1-0",1,0,5,5,1,1,"H"
"2013-08-10",2013,"Woking","Lincoln City","0-0",0,0,5,5,0,0,"D"
"2013-08-10",2013,"Wrexham","Welling United","2-1",2,1,5,5,3,1,"H"
"2013-08-11",2013,"Cambridge United","Halifax Town","5-1",5,1,5,5,6,4,"H"
"2013-08-13",2013,"Aldershot","Dartford","3-0",3,0,5,5,3,3,"H"
"2013-08-13",2013,"Alfreton Town","Kidderminster Harriers","3-1",3,1,5,5,4,2,"H"
"2013-08-13",2013,"Braintree Town","Woking","2-0",2,0,5,5,2,2,"H"
"2013-08-13",2013,"Chester","Hereford United","0-2",0,2,5,5,2,-2,"A"
"2013-08-13",2013,"Gateshead","Grimsby Town","1-2",1,2,5,5,3,-1,"A"
"2013-08-13",2013,"Halifax Town","Wrexham","3-2",3,2,5,5,5,1,"H"
"2013-08-13",2013,"Hyde United","Southport","1-2",1,2,5,5,3,-1,"A"
"2013-08-13",2013,"Lincoln City","Macclesfield","1-0",1,0,5,5,1,1,"H"
"2013-08-13",2013,"Luton Town","Salisbury","2-0",2,0,5,5,2,2,"H"
"2013-08-13",2013,"Nuneaton Town","Forest Green Rovers","1-1",1,1,5,5,2,0,"D"
"2013-08-13",2013,"Tamworth","Barnet","0-0",0,0,5,5,0,0,"D"
"2013-08-14",2013,"Welling United","Cambridge United","2-2",2,2,5,5,4,0,"D"
"2013-08-17",2013,"Aldershot","Cambridge United","0-1",0,1,5,5,1,-1,"A"
"2013-08-17",2013,"Alfreton Town","Salisbury","3-2",3,2,5,5,5,1,"H"
"2013-08-17",2013,"Braintree Town","Kidderminster Harriers","0-1",0,1,5,5,1,-1,"A"
"2013-08-17",2013,"Chester","Woking","0-2",0,2,5,5,2,-2,"A"
"2013-08-17",2013,"Gateshead","Barnet","1-2",1,2,5,5,3,-1,"A"
"2013-08-17",2013,"Halifax Town","Dartford","2-0",2,0,5,5,2,2,"H"
"2013-08-17",2013,"Hyde United","Hereford United","2-2",2,2,5,5,4,0,"D"
"2013-08-17",2013,"Lincoln City","Forest Green Rovers","2-1",2,1,5,5,3,1,"H"
"2013-08-17",2013,"Luton Town","Macclesfield","1-1",1,1,5,5,2,0,"D"
"2013-08-17",2013,"Nuneaton Town","Southport","3-1",3,1,5,5,4,2,"H"
"2013-08-17",2013,"Tamworth","Wrexham","2-2",2,2,5,5,4,0,"D"
"2013-08-17",2013,"Welling United","Grimsby Town","1-0",1,0,5,5,1,1,"H"
"2013-08-24",2013,"Barnet","Nuneaton Town","1-1",1,1,5,5,2,0,"D"
"2013-08-24",2013,"Cambridge United","Lincoln City","1-0",1,0,5,5,1,1,"H"
"2013-08-24",2013,"Dartford","Braintree Town","0-2",0,2,5,5,2,-2,"A"
"2013-08-24",2013,"Forest Green Rovers","Luton Town","0-0",0,0,5,5,0,0,"D"
"2013-08-24",2013,"Grimsby Town","Alfreton Town","3-1",3,1,5,5,4,2,"H"
"2013-08-24",2013,"Hereford United","Tamworth","1-0",1,0,5,5,1,1,"H"
"2013-08-24",2013,"Kidderminster Harriers","Chester","3-1",3,1,5,5,4,2,"H"
"2013-08-24",2013,"Macclesfield","Halifax Town","2-2",2,2,5,5,4,0,"D"
"2013-08-24",2013,"Salisbury","Aldershot","1-0",1,0,5,5,1,1,"H"
"2013-08-24",2013,"Southport","Gateshead","2-1",2,1,5,5,3,1,"H"
"2013-08-24",2013,"Woking","Welling United","2-4",2,4,5,5,6,-2,"A"
"2013-08-24",2013,"Wrexham","Hyde United","2-2",2,2,5,5,4,0,"D"
"2013-08-26",2013,"Aldershot","Woking","2-1",2,1,5,5,3,1,"H"
"2013-08-26",2013,"Alfreton Town","Hereford United","2-1",2,1,5,5,3,1,"H"
"2013-08-26",2013,"Braintree Town","Barnet","0-3",0,3,5,5,3,-3,"A"
"2013-08-26",2013,"Chester","Forest Green Rovers","1-2",1,2,5,5,3,-1,"A"
"2013-08-26",2013,"Gateshead","Macclesfield","2-2",2,2,5,5,4,0,"D"
"2013-08-26",2013,"Halifax Town","Southport","1-0",1,0,5,5,1,1,"H"
"2013-08-26",2013,"Hyde United","Grimsby Town","0-1",0,1,5,5,1,-1,"A"
"2013-08-26",2013,"Lincoln City","Wrexham","2-0",2,0,5,5,2,2,"H"
"2013-08-26",2013,"Luton Town","Cambridge United","0-0",0,0,5,5,0,0,"D"
"2013-08-26",2013,"Nuneaton Town","Kidderminster Harriers","2-1",2,1,5,5,3,1,"H"
"2013-08-26",2013,"Tamworth","Dartford","0-2",0,2,5,5,2,-2,"A"
"2013-08-26",2013,"Welling United","Salisbury","0-0",0,0,5,5,0,0,"D"
"2013-08-31",2013,"Barnet","Hyde United","3-2",3,2,5,5,5,1,"H"
"2013-08-31",2013,"Cambridge United","Tamworth","3-0",3,0,5,5,3,3,"H"
"2013-08-31",2013,"Dartford","Lincoln City","1-2",1,2,5,5,3,-1,"A"
"2013-08-31",2013,"Forest Green Rovers","Alfreton Town","3-1",3,1,5,5,4,2,"H"
"2013-08-31",2013,"Grimsby Town","Nuneaton Town","1-2",1,2,5,5,3,-1,"A"
"2013-08-31",2013,"Hereford United","Welling United","2-1",2,1,5,5,3,1,"H"
"2013-08-31",2013,"Kidderminster Harriers","Luton Town","0-2",0,2,5,5,2,-2,"A"
"2013-08-31",2013,"Macclesfield","Braintree Town","0-1",0,1,5,5,1,-1,"A"
"2013-08-31",2013,"Salisbury","Halifax Town","3-1",3,1,5,5,4,2,"H"
"2013-08-31",2013,"Southport","Aldershot","1-0",1,0,5,5,1,1,"H"
"2013-08-31",2013,"Woking","Gateshead","1-2",1,2,5,5,3,-1,"A"
"2013-08-31",2013,"Wrexham","Chester","0-2",0,2,5,5,2,-2,"A"
"2013-09-07",2013,"Aldershot","Macclesfield","1-0",1,0,5,5,1,1,"H"
"2013-09-07",2013,"Alfreton Town","Woking","3-1",3,1,5,5,4,2,"H"
"2013-09-07",2013,"Braintree Town","Forest Green Rovers","1-1",1,1,5,5,2,0,"D"
"2013-09-07",2013,"Chester","Dartford","0-0",0,0,5,5,0,0,"D"
"2013-09-07",2013,"Gateshead","Hereford United","2-1",2,1,5,5,3,1,"H"
"2013-09-07",2013,"Halifax Town","Barnet","2-1",2,1,5,5,3,1,"H"
"2013-09-07",2013,"Hyde United","Cambridge United","0-1",0,1,5,5,1,-1,"A"
"2013-09-07",2013,"Lincoln City","Salisbury","0-1",0,1,5,5,1,-1,"A"
"2013-09-07",2013,"Luton Town","Grimsby Town","0-0",0,0,5,5,0,0,"D"
"2013-09-07",2013,"Nuneaton Town","Wrexham","2-0",2,0,5,5,2,2,"H"
"2013-09-07",2013,"Tamworth","Southport","4-1",4,1,5,5,5,3,"H"
"2013-09-07",2013,"Welling United","Kidderminster Harriers","1-2",1,2,5,5,3,-1,"A"
"2013-09-13",2013,"Hereford United","Aldershot","0-2",0,2,5,5,2,-2,"A"
"2013-09-13",2013,"Woking","Tamworth","2-2",2,2,5,5,4,0,"D"
"2013-09-13",2013,"Wrexham","Luton Town","2-0",2,0,5,5,2,2,"H"
"2013-09-14",2013,"Barnet","Lincoln City","1-1",1,1,5,5,2,0,"D"
"2013-09-14",2013,"Cambridge United","Gateshead","1-0",1,0,5,5,1,1,"H"
"2013-09-14",2013,"Dartford","Nuneaton Town","1-2",1,2,5,5,3,-1,"A"
"2013-09-14",2013,"Forest Green Rovers","Halifax Town","2-1",2,1,5,5,3,1,"H"
"2013-09-14",2013,"Grimsby Town","Braintree Town","1-0",1,0,5,5,1,1,"H"
"2013-09-14",2013,"Kidderminster Harriers","Hyde United","2-1",2,1,5,5,3,1,"H"
"2013-09-14",2013,"Macclesfield","Alfreton Town","0-1",0,1,5,5,1,-1,"A"
"2013-09-14",2013,"Salisbury","Chester","3-1",3,1,5,5,4,2,"H"
"2013-09-14",2013,"Southport","Welling United","2-2",2,2,5,5,4,0,"D"
"2013-09-17",2013,"Aldershot","Barnet","3-3",3,3,5,5,6,0,"D"
"2013-09-17",2013,"Alfreton Town","Cambridge United","1-1",1,1,5,5,2,0,"D"
"2013-09-17",2013,"Chester","Macclesfield","2-1",2,1,5,5,3,1,"H"
"2013-09-17",2013,"Gateshead","Wrexham","0-3",0,3,5,5,3,-3,"A"
"2013-09-17",2013,"Halifax Town","Grimsby Town","4-0",4,0,5,5,4,4,"H"
"2013-09-17",2013,"Hyde United","Woking","0-2",0,2,5,5,2,-2,"A"
"2013-09-17",2013,"Lincoln City","Southport","1-0",1,0,5,5,1,1,"H"
"2013-09-17",2013,"Luton Town","Dartford","3-0",3,0,5,5,3,3,"H"
"2013-09-17",2013,"Nuneaton Town","Hereford United","2-1",2,1,5,5,3,1,"H"
"2013-09-17",2013,"Salisbury","Braintree Town","1-1",1,1,5,5,2,0,"D"
"2013-09-17",2013,"Tamworth","Kidderminster Harriers","0-3",0,3,5,5,3,-3,"A"
"2013-09-17",2013,"Welling United","Forest Green Rovers","5-2",5,2,5,5,7,3,"H"
"2013-09-21",2013,"Aldershot","Wrexham","2-0",2,0,5,5,2,2,"H"
"2013-09-21",2013,"Alfreton Town","Barnet","3-1",3,1,5,5,4,2,"H"
"2013-09-21",2013,"Braintree Town","Southport","1-0",1,0,5,5,1,1,"H"
"2013-09-21",2013,"Cambridge United","Forest Green Rovers","2-1",2,1,5,5,3,1,"H"
"2013-09-21",2013,"Chester","Grimsby Town","0-0",0,0,5,5,0,0,"D"
"2013-09-21",2013,"Dartford","Kidderminster Harriers","3-0",3,0,5,5,3,3,"H"
"2013-09-21",2013,"Halifax Town","Hereford United","1-1",1,1,5,5,2,0,"D"
"2013-09-21",2013,"Hyde United","Welling United","0-1",0,1,5,5,1,-1,"A"
"2013-09-21",2013,"Luton Town","Lincoln City","3-2",3,2,5,5,5,1,"H"
"2013-09-21",2013,"Macclesfield","Woking","3-2",3,2,5,5,5,1,"H"
"2013-09-21",2013,"Nuneaton Town","Salisbury","1-2",1,2,5,5,3,-1,"A"
"2013-09-21",2013,"Tamworth","Gateshead","0-1",0,1,5,5,1,-1,"A"
"2013-09-24",2013,"Barnet","Macclesfield","1-2",1,2,5,5,3,-1,"A"
"2013-09-24",2013,"Cambridge United","Nuneaton Town","3-0",3,0,5,5,3,3,"H"
"2013-09-24",2013,"Forest Green Rovers","Tamworth","1-2",1,2,5,5,3,-1,"A"
"2013-09-24",2013,"Gateshead","Chester","3-2",3,2,5,5,5,1,"H"
"2013-09-24",2013,"Grimsby Town","Dartford","5-2",5,2,5,5,7,3,"H"
"2013-09-24",2013,"Hereford United","Lincoln City","1-0",1,0,5,5,1,1,"H"
"2013-09-24",2013,"Kidderminster Harriers","Halifax Town","2-0",2,0,5,5,2,2,"H"
"2013-09-24",2013,"Salisbury","Hyde United","2-0",2,0,5,5,2,2,"H"
"2013-09-24",2013,"Southport","Alfreton Town","2-1",2,1,5,5,3,1,"H"
"2013-09-24",2013,"Welling United","Aldershot","1-0",1,0,5,5,1,1,"H"
"2013-09-24",2013,"Woking","Luton Town","0-4",0,4,5,5,4,-4,"A"
"2013-09-24",2013,"Wrexham","Braintree Town","2-3",2,3,5,5,5,-1,"A"
"2013-09-27",2013,"Kidderminster Harriers","Aldershot","0-0",0,0,5,5,0,0,"D"
"2013-09-28",2013,"Barnet","Salisbury","3-1",3,1,5,5,4,2,"H"
"2013-09-28",2013,"Braintree Town","Alfreton Town","3-1",3,1,5,5,4,2,"H"
"2013-09-28",2013,"Dartford","Southport","1-0",1,0,5,5,1,1,"H"
"2013-09-28",2013,"Forest Green Rovers","Gateshead","1-0",1,0,5,5,1,1,"H"
"2013-09-28",2013,"Grimsby Town","Tamworth","3-1",3,1,5,5,4,2,"H"
"2013-09-28",2013,"Halifax Town","Chester","2-1",2,1,5,5,3,1,"H"
"2013-09-28",2013,"Hereford United","Luton Town","0-0",0,0,5,5,0,0,"D"
"2013-09-28",2013,"Lincoln City","Hyde United","3-0",3,0,5,5,3,3,"H"
"2013-09-28",2013,"Macclesfield","Welling United","2-1",2,1,5,5,3,1,"H"
"2013-09-28",2013,"Woking","Nuneaton Town","2-0",2,0,5,5,2,2,"H"
"2013-09-28",2013,"Wrexham","Cambridge United","1-1",1,1,5,5,2,0,"D"
"2013-10-05",2013,"Aldershot","Grimsby Town","0-3",0,3,5,5,3,-3,"A"
"2013-10-05",2013,"Alfreton Town","Forest Green Rovers","3-2",3,2,5,5,5,1,"H"
"2013-10-05",2013,"Cambridge United","Hereford United","1-0",1,0,5,5,1,1,"H"
"2013-10-05",2013,"Chester","Kidderminster Harriers","0-0",0,0,5,5,0,0,"D"
"2013-10-05",2013,"Gateshead","Dartford","2-0",2,0,5,5,2,2,"H"
"2013-10-05",2013,"Hyde United","Braintree Town","0-3",0,3,5,5,3,-3,"A"
"2013-10-05",2013,"Luton Town","Halifax Town","4-3",4,3,5,5,7,1,"H"
"2013-10-05",2013,"Nuneaton Town","Lincoln City","2-2",2,2,5,5,4,0,"D"
"2013-10-05",2013,"Salisbury","Wrexham","2-1",2,1,5,5,3,1,"H"
"2013-10-05",2013,"Southport","Woking","1-1",1,1,5,5,2,0,"D"
"2013-10-05",2013,"Tamworth","Macclesfield","1-0",1,0,5,5,1,1,"H"
"2013-10-05",2013,"Welling United","Barnet","1-1",1,1,5,5,2,0,"D"
"2013-10-08",2013,"Aldershot","Luton Town","3-3",3,3,5,5,6,0,"D"
"2013-10-08",2013,"Alfreton Town","Chester","0-1",0,1,5,5,1,-1,"A"
"2013-10-08",2013,"Braintree Town","Welling United","2-3",2,3,5,5,5,-1,"A"
"2013-10-08",2013,"Dartford","Salisbury","1-1",1,1,5,5,2,0,"D"
"2013-10-08",2013,"Grimsby Town","Cambridge United","0-1",0,1,5,5,1,-1,"A"
"2013-10-08",2013,"Halifax Town","Nuneaton Town","2-2",2,2,5,5,4,0,"D"
"2013-10-08",2013,"Hyde United","Gateshead","0-2",0,2,5,5,2,-2,"A"
"2013-10-08",2013,"Kidderminster Harriers","Forest Green Rovers","4-1",4,1,5,5,5,3,"H"
"2013-10-08",2013,"Lincoln City","Tamworth","0-0",0,0,5,5,0,0,"D"
"2013-10-08",2013,"Macclesfield","Hereford United","1-0",1,0,5,5,1,1,"H"
"2013-10-08",2013,"Woking","Barnet","0-0",0,0,5,5,0,0,"D"
"2013-10-08",2013,"Wrexham","Southport","1-0",1,0,5,5,1,1,"H"
"2013-10-12",2013,"Chester","Cambridge United","0-0",0,0,5,5,0,0,"D"
"2013-10-12",2013,"Forest Green Rovers","Macclesfield","2-3",2,3,5,5,5,-1,"A"
"2013-10-12",2013,"Gateshead","Alfreton Town","3-0",3,0,5,5,3,3,"H"
"2013-10-12",2013,"Hereford United","Dartford","2-2",2,2,5,5,4,0,"D"
"2013-10-12",2013,"Lincoln City","Aldershot","0-1",0,1,5,5,1,-1,"A"
"2013-10-12",2013,"Luton Town","Hyde United","4-1",4,1,5,5,5,3,"H"
"2013-10-12",2013,"Nuneaton Town","Braintree Town","1-1",1,1,5,5,2,0,"D"
"2013-10-12",2013,"Salisbury","Grimsby Town","1-0",1,0,5,5,1,1,"H"
"2013-10-12",2013,"Southport","Kidderminster Harriers","1-2",1,2,5,5,3,-1,"A"
"2013-10-12",2013,"Welling United","Tamworth","2-0",2,0,5,5,2,2,"H"
"2013-10-12",2013,"Woking","Halifax Town","0-0",0,0,5,5,0,0,"D"
"2013-10-13",2013,"Barnet","Wrexham","1-1",1,1,5,5,2,0,"D"
"2013-10-17",2013,"Macclesfield","Southport","2-2",2,2,5,5,4,0,"D"
"2013-10-19",2013,"Aldershot","Alfreton Town","2-3",2,3,5,5,5,-1,"A"
"2013-10-19",2013,"Braintree Town","Chester","3-0",3,0,5,5,3,3,"H"
"2013-10-19",2013,"Cambridge United","Salisbury","2-0",2,0,5,5,2,2,"H"
"2013-10-19",2013,"Dartford","Hyde United","4-3",4,3,5,5,7,1,"H"
"2013-10-19",2013,"Grimsby Town","Forest Green Rovers","3-1",3,1,5,5,4,2,"H"
"2013-10-19",2013,"Halifax Town","Welling United","3-0",3,0,5,5,3,3,"H"
"2013-10-19",2013,"Hereford United","Barnet","0-1",0,1,5,5,1,-1,"A"
"2013-10-19",2013,"Kidderminster Harriers","Lincoln City","4-1",4,1,5,5,5,3,"H"
"2013-10-19",2013,"Nuneaton Town","Gateshead","1-4",1,4,5,5,5,-3,"A"
"2013-10-19",2013,"Tamworth","Luton Town","3-4",3,4,5,5,7,-1,"A"
"2013-10-19",2013,"Wrexham","Woking","2-0",2,0,5,5,2,2,"H"
"2013-10-31",2013,"Salisbury","Hereford United","4-1",4,1,5,5,5,3,"H"
"2013-11-02",2013,"Alfreton Town","Halifax Town","3-0",3,0,5,5,3,3,"H"
"2013-11-02",2013,"Barnet","Kidderminster Harriers","1-0",1,0,5,5,1,1,"H"
"2013-11-02",2013,"Chester","Aldershot","1-1",1,1,5,5,2,0,"D"
"2013-11-02",2013,"Forest Green Rovers","Dartford","1-0",1,0,5,5,1,1,"H"
"2013-11-02",2013,"Gateshead","Luton Town","0-0",0,0,5,5,0,0,"D"
"2013-11-02",2013,"Hyde United","Nuneaton Town","2-2",2,2,5,5,4,0,"D"
"2013-11-02",2013,"Macclesfield","Wrexham","3-2",3,2,5,5,5,1,"H"
"2013-11-02",2013,"Southport","Cambridge United","1-0",1,0,5,5,1,1,"H"
"2013-11-02",2013,"Tamworth","Braintree Town","0-0",0,0,5,5,0,0,"D"
"2013-11-02",2013,"Welling United","Lincoln City","1-0",1,0,5,5,1,1,"H"
"2013-11-02",2013,"Woking","Grimsby Town","1-2",1,2,5,5,3,-1,"A"
"2013-11-09",2013,"Hyde United","Chester","1-2",1,2,5,5,3,-1,"A"
"2013-11-12",2013,"Barnet","Welling United","0-0",0,0,5,5,0,0,"D"
"2013-11-12",2013,"Braintree Town","Luton Town","1-2",1,2,5,5,3,-1,"A"
"2013-11-12",2013,"Cambridge United","Aldershot","4-0",4,0,5,5,4,4,"H"
"2013-11-12",2013,"Forest Green Rovers","Nuneaton Town","1-0",1,0,5,5,1,1,"H"
"2013-11-12",2013,"Halifax Town","Hyde United","4-0",4,0,5,5,4,4,"H"
"2013-11-12",2013,"Hereford United","Chester","2-2",2,2,5,5,4,0,"D"
"2013-11-12",2013,"Macclesfield","Kidderminster Harriers","1-1",1,1,5,5,2,0,"D"
"2013-11-12",2013,"Southport","Lincoln City","0-1",0,1,5,5,1,-1,"A"
"2013-11-12",2013,"Tamworth","Alfreton Town","1-0",1,0,5,5,1,1,"H"
"2013-11-12",2013,"Woking","Dartford","3-0",3,0,5,5,3,3,"H"
"2013-11-12",2013,"Wrexham","Gateshead","3-2",3,2,5,5,5,1,"H"
"2013-11-16",2013,"Alfreton Town","Braintree Town","3-1",3,1,5,5,4,2,"H"
"2013-11-16",2013,"Barnet","Cambridge United","2-2",2,2,5,5,4,0,"D"
"2013-11-16",2013,"Chester","Luton Town","1-1",1,1,5,5,2,0,"D"
"2013-11-16",2013,"Forest Green Rovers","Lincoln City","4-1",4,1,5,5,5,3,"H"
"2013-11-16",2013,"Gateshead","Salisbury","3-2",3,2,5,5,5,1,"H"
"2013-11-16",2013,"Halifax Town","Aldershot","4-0",4,0,5,5,4,4,"H"
"2013-11-16",2013,"Kidderminster Harriers","Wrexham","3-1",3,1,5,5,4,2,"H"
"2013-11-16",2013,"Macclesfield","Dartford","3-1",3,1,5,5,4,2,"H"
"2013-11-16",2013,"Southport","Hereford United","0-3",0,3,5,5,3,-3,"A"
"2013-11-16",2013,"Tamworth","Grimsby Town","0-2",0,2,5,5,2,-2,"A"
"2013-11-16",2013,"Welling United","Nuneaton Town","1-2",1,2,5,5,3,-1,"A"
"2013-11-16",2013,"Woking","Hyde United","3-2",3,2,5,5,5,1,"H"
"2013-11-19",2013,"Dartford","Wrexham","1-5",1,5,5,5,6,-4,"A"
"2013-11-23",2013,"Aldershot","Southport","5-1",5,1,5,5,6,4,"H"
"2013-11-23",2013,"Braintree Town","Halifax Town","1-0",1,0,5,5,1,1,"H"
"2013-11-23",2013,"Cambridge United","Woking","2-0",2,0,5,5,2,2,"H"
"2013-11-23",2013,"Dartford","Gateshead","0-1",0,1,5,5,1,-1,"A"
"2013-11-23",2013,"Grimsby Town","Barnet","2-1",2,1,5,5,3,1,"H"
"2013-11-23",2013,"Hyde United","Alfreton Town","1-2",1,2,5,5,3,-1,"A"
"2013-11-23",2013,"Kidderminster Harriers","Tamworth","5-3",5,3,5,5,8,2,"H"
"2013-11-23",2013,"Lincoln City","Hereford United","1-1",1,1,5,5,2,0,"D"
"2013-11-23",2013,"Luton Town","Welling United","2-1",2,1,5,5,3,1,"H"
"2013-11-23",2013,"Nuneaton Town","Chester","1-0",1,0,5,5,1,1,"H"
"2013-11-23",2013,"Salisbury","Macclesfield","3-2",3,2,5,5,5,1,"H"
"2013-11-23",2013,"Wrexham","Forest Green Rovers","2-0",2,0,5,5,2,2,"H"
"2013-11-26",2013,"Aldershot","Braintree Town","2-1",2,1,5,5,3,1,"H"
"2013-11-26",2013,"Dartford","Barnet","0-2",0,2,5,5,2,-2,"A"
"2013-11-26",2013,"Hereford United","Halifax Town","3-2",3,2,5,5,5,1,"H"
"2013-11-26",2013,"Luton Town","Southport","3-0",3,0,5,5,3,3,"H"
"2013-11-26",2013,"Nuneaton Town","Alfreton Town","3-0",3,0,5,5,3,3,"H"
"2013-11-26",2013,"Salisbury","Forest Green Rovers","1-4",1,4,5,5,5,-3,"A"
"2013-12-07",2013,"Alfreton Town","Luton Town","0-5",0,5,5,5,5,-5,"A"
"2013-12-07",2013,"Barnet","Dartford","1-0",1,0,5,5,1,1,"H"
"2013-12-07",2013,"Chester","Braintree Town","0-2",0,2,5,5,2,-2,"A"
"2013-12-07",2013,"Halifax Town","Woking","3-4",3,4,5,5,7,-1,"A"
"2013-12-07",2013,"Hereford United","Nuneaton Town","0-1",0,1,5,5,1,-1,"A"
"2013-12-10",2013,"Cambridge United","Macclesfield","3-0",3,0,5,5,3,3,"H"
"2013-12-10",2013,"Grimsby Town","Welling United","1-1",1,1,5,5,2,0,"D"
"2013-12-10",2013,"Lincoln City","Gateshead","0-1",0,1,5,5,1,-1,"A"
"2013-12-10",2013,"Woking","Kidderminster Harriers","1-0",1,0,5,5,1,1,"H"
"2013-12-14",2013,"Dartford","Halifax Town","1-2",1,2,5,5,3,-1,"A"
"2013-12-14",2013,"Kidderminster Harriers","Alfreton Town","1-3",1,3,5,5,4,-2,"A"
"2013-12-14",2013,"Macclesfield","Salisbury","1-0",1,0,5,5,1,1,"H"
"2013-12-19",2013,"Grimsby Town","Kidderminster Harriers","3-1",3,1,5,5,4,2,"H"
"2013-12-21",2013,"Aldershot","Tamworth","6-0",6,0,5,5,6,6,"H"
"2013-12-21",2013,"Alfreton Town","Dartford","2-1",2,1,5,5,3,1,"H"
"2013-12-21",2013,"Chester","Lincoln City","3-3",3,3,5,5,6,0,"D"
"2013-12-21",2013,"Halifax Town","Forest Green Rovers","1-0",1,0,5,5,1,1,"H"
"2013-12-21",2013,"Hereford United","Cambridge United","1-0",1,0,5,5,1,1,"H"
"2013-12-21",2013,"Hyde United","Barnet","0-1",0,1,5,5,1,-1,"A"
"2013-12-21",2013,"Luton Town","Gateshead","4-2",4,2,5,5,6,2,"H"
"2013-12-21",2013,"Nuneaton Town","Woking","0-2",0,2,5,5,2,-2,"A"
"2013-12-21",2013,"Salisbury","Southport","1-1",1,1,5,5,2,0,"D"
"2013-12-21",2013,"Welling United","Wrexham","1-1",1,1,5,5,2,0,"D"
"2013-12-26",2013,"Barnet","Luton Town","1-2",1,2,5,5,3,-1,"A"
"2013-12-26",2013,"Cambridge United","Braintree Town","1-0",1,0,5,5,1,1,"H"
"2013-12-26",2013,"Dartford","Welling United","1-2",1,2,5,5,3,-1,"A"
"2013-12-26",2013,"Forest Green Rovers","Aldershot","3-1",3,1,5,5,4,2,"H"
"2013-12-26",2013,"Gateshead","Halifax Town","1-1",1,1,5,5,2,0,"D"
"2013-12-26",2013,"Kidderminster Harriers","Hereford United","2-1",2,1,5,5,3,1,"H"
"2013-12-26",2013,"Lincoln City","Grimsby Town","0-2",0,2,5,5,2,-2,"A"
"2013-12-26",2013,"Macclesfield","Hyde United","3-0",3,0,5,5,3,3,"H"
"2013-12-26",2013,"Southport","Chester","0-0",0,0,5,5,0,0,"D"
"2013-12-26",2013,"Tamworth","Nuneaton Town","1-1",1,1,5,5,2,0,"D"
"2013-12-26",2013,"Woking","Salisbury","1-3",1,3,5,5,4,-2,"A"
"2013-12-26",2013,"Wrexham","Alfreton Town","2-3",2,3,5,5,5,-1,"A"
"2013-12-28",2013,"Aldershot","Welling United","3-1",3,1,5,5,4,2,"H"
"2013-12-28",2013,"Alfreton Town","Southport","2-1",2,1,5,5,3,1,"H"
"2013-12-28",2013,"Braintree Town","Tamworth","2-0",2,0,5,5,2,2,"H"
"2013-12-28",2013,"Chester","Gateshead","1-1",1,1,5,5,2,0,"D"
"2013-12-28",2013,"Grimsby Town","Macclesfield","2-3",2,3,5,5,5,-1,"A"
"2013-12-28",2013,"Halifax Town","Lincoln City","5-1",5,1,5,5,6,4,"H"
"2013-12-28",2013,"Hereford United","Forest Green Rovers","1-0",1,0,5,5,1,1,"H"
"2013-12-28",2013,"Hyde United","Wrexham","2-5",2,5,5,5,7,-3,"A"
"2013-12-28",2013,"Luton Town","Kidderminster Harriers","6-0",6,0,5,5,6,6,"H"
"2013-12-28",2013,"Nuneaton Town","Cambridge United","0-0",0,0,5,5,0,0,"D"
"2013-12-28",2013,"Salisbury","Barnet","2-1",2,1,5,5,3,1,"H"
"2014-01-01",2013,"Alfreton Town","Wrexham","1-0",1,0,5,5,1,1,"H"
"2014-01-01",2013,"Grimsby Town","Lincoln City","1-1",1,1,5,5,2,0,"D"
"2014-01-01",2013,"Halifax Town","Gateshead","3-3",3,3,5,5,6,0,"D"
"2014-01-01",2013,"Hyde United","Macclesfield","0-3",0,3,5,5,3,-3,"A"
"2014-01-01",2013,"Luton Town","Barnet","2-1",2,1,5,5,3,1,"H"
"2014-01-04",2013,"Barnet","Alfreton Town","1-0",1,0,5,5,1,1,"H"
"2014-01-04",2013,"Gateshead","Hyde United","4-0",4,0,5,5,4,4,"H"
"2014-01-04",2013,"Lincoln City","Luton Town","0-0",0,0,5,5,0,0,"D"
"2014-01-04",2013,"Southport","Nuneaton Town","1-0",1,0,5,5,1,1,"H"
"2014-01-04",2013,"Tamworth","Halifax Town","2-0",2,0,5,5,2,2,"H"
"2014-01-04",2013,"Wrexham","Aldershot","2-1",2,1,5,5,3,1,"H"
"2014-01-07",2013,"Lincoln City","Alfreton Town","4-1",4,1,5,5,5,3,"H"
"2014-01-09",2013,"Forest Green Rovers","Hereford United","1-1",1,1,5,5,2,0,"D"
"2014-01-10",2013,"Welling United","Dartford","1-1",1,1,5,5,2,0,"D"
"2014-01-11",2013,"Gateshead","Nuneaton Town","2-1",2,1,5,5,3,1,"H"
"2014-01-11",2013,"Kidderminster Harriers","Salisbury","3-0",3,0,5,5,3,3,"H"
"2014-01-11",2013,"Southport","Hyde United","1-1",1,1,5,5,2,0,"D"
"2014-01-11",2013,"Woking","Braintree Town","1-0",1,0,5,5,1,1,"H"
"2014-01-11",2013,"Wrexham","Halifax Town","0-0",0,0,5,5,0,0,"D"
"2014-01-14",2013,"Gateshead","Aldershot","0-0",0,0,5,5,0,0,"D"
"2014-01-14",2013,"Welling United","Hyde United","0-2",0,2,5,5,2,-2,"A"
"2014-01-18",2013,"Chester","Barnet","2-1",2,1,5,5,3,1,"H"
"2014-01-18",2013,"Grimsby Town","Gateshead","2-2",2,2,5,5,4,0,"D"
"2014-01-18",2013,"Halifax Town","Cambridge United","1-1",1,1,5,5,2,0,"D"
"2014-01-18",2013,"Hereford United","Southport","4-1",4,1,5,5,5,3,"H"
"2014-01-18",2013,"Hyde United","Forest Green Rovers","2-6",2,6,5,5,8,-4,"A"
"2014-01-18",2013,"Nuneaton Town","Macclesfield","1-0",1,0,5,5,1,1,"H"
"2014-01-18",2013,"Salisbury","Dartford","1-0",1,0,5,5,1,1,"H"
"2014-01-18",2013,"Welling United","Woking","3-0",3,0,5,5,3,3,"H"
"2014-01-21",2013,"Barnet","Aldershot","1-3",1,3,5,5,4,-2,"A"
"2014-01-21",2013,"Gateshead","Welling United","1-1",1,1,5,5,2,0,"D"
"2014-01-21",2013,"Kidderminster Harriers","Dartford","1-2",1,2,5,5,3,-1,"A"
"2014-01-21",2013,"Macclesfield","Lincoln City","3-1",3,1,5,5,4,2,"H"
"2014-01-21",2013,"Southport","Wrexham","1-2",1,2,5,5,3,-1,"A"
"2014-01-21",2013,"Tamworth","Cambridge United","0-1",0,1,5,5,1,-1,"A"
"2014-01-21",2013,"Woking","Chester","0-1",0,1,5,5,1,-1,"A"
"2014-01-25",2013,"Aldershot","Halifax Town","2-2",2,2,5,5,4,0,"D"
"2014-01-25",2013,"Barnet","Southport","1-0",1,0,5,5,1,1,"H"
"2014-01-25",2013,"Dartford","Cambridge United","3-3",3,3,5,5,6,0,"D"
"2014-01-25",2013,"Forest Green Rovers","Chester","3-0",3,0,5,5,3,3,"H"
"2014-01-25",2013,"Hereford United","Salisbury","1-0",1,0,5,5,1,1,"H"
"2014-01-25",2013,"Hyde United","Tamworth","0-3",0,3,5,5,3,-3,"A"
"2014-01-25",2013,"Lincoln City","Woking","2-2",2,2,5,5,4,0,"D"
"2014-01-25",2013,"Luton Town","Nuneaton Town","3-0",3,0,5,5,3,3,"H"
"2014-01-25",2013,"Welling United","Alfreton Town","1-2",1,2,5,5,3,-1,"A"
"2014-01-28",2013,"Cambridge United","Grimsby Town","1-2",1,2,5,5,3,-1,"A"
"2014-01-28",2013,"Hereford United","Kidderminster Harriers","1-1",1,1,5,5,2,0,"D"
"2014-01-28",2013,"Nuneaton Town","Aldershot","2-1",2,1,5,5,3,1,"H"
"2014-01-28",2013,"Wrexham","Tamworth","2-0",2,0,5,5,2,2,"H"
"2014-02-01",2013,"Chester","Welling United","1-3",1,3,5,5,4,-2,"A"
"2014-02-01",2013,"Gateshead","Kidderminster Harriers","3-1",3,1,5,5,4,2,"H"
"2014-02-01",2013,"Lincoln City","Halifax Town","3-1",3,1,5,5,4,2,"H"
"2014-02-01",2013,"Salisbury","Nuneaton Town","2-1",2,1,5,5,3,1,"H"
"2014-02-03",2013,"Woking","Hereford United","3-0",3,0,5,5,3,3,"H"
"2014-02-04",2013,"Halifax Town","Salisbury","5-1",5,1,5,5,6,4,"H"
"2014-02-04",2013,"Lincoln City","Nuneaton Town","1-2",1,2,5,5,3,-1,"A"
"2014-02-04",2013,"Macclesfield","Chester","3-2",3,2,5,5,5,1,"H"
"2014-02-08",2013,"Grimsby Town","Southport","0-0",0,0,5,5,0,0,"D"
"2014-02-08",2013,"Hyde United","Lincoln City","3-4",3,4,5,5,7,-1,"A"
"2014-02-08",2013,"Salisbury","Alfreton Town","0-0",0,0,5,5,0,0,"D"
"2014-02-08",2013,"Wrexham","Dartford","1-2",1,2,5,5,3,-1,"A"
"2014-02-11",2013,"Cambridge United","Alfreton Town","0-1",0,1,5,5,1,-1,"A"
"2014-02-11",2013,"Macclesfield","Luton Town","1-2",1,2,5,5,3,-1,"A"
"2014-02-11",2013,"Salisbury","Woking","2-0",2,0,5,5,2,2,"H"
"2014-02-11",2013,"Tamworth","Hyde United","1-1",1,1,5,5,2,0,"D"
"2014-02-13",2013,"Chester","Halifax Town","2-1",2,1,5,5,3,1,"H"
"2014-02-15",2013,"Barnet","Tamworth","1-0",1,0,5,5,1,1,"H"
"2014-02-15",2013,"Gateshead","Woking","0-2",0,2,5,5,2,-2,"A"
"2014-02-15",2013,"Lincoln City","Kidderminster Harriers","2-0",2,0,5,5,2,2,"H"
"2014-02-15",2013,"Luton Town","Hereford United","7-0",7,0,5,5,7,7,"H"
"2014-02-15",2013,"Nuneaton Town","Hyde United","1-0",1,0,5,5,1,1,"H"
"2014-02-15",2013,"Southport","Salisbury","3-1",3,1,5,5,4,2,"H"
"2014-02-18",2013,"Aldershot","Forest Green Rovers","2-2",2,2,5,5,4,0,"D"
"2014-02-18",2013,"Barnet","Grimsby Town","2-1",2,1,5,5,3,1,"H"
"2014-02-18",2013,"Cambridge United","Wrexham","0-0",0,0,5,5,0,0,"D"
"2014-02-18",2013,"Dartford","Woking","5-1",5,1,5,5,6,4,"H"
"2014-02-18",2013,"Tamworth","Salisbury","1-2",1,2,5,5,3,-1,"A"
"2014-02-22",2013,"Alfreton Town","Gateshead","1-1",1,1,5,5,2,0,"D"
"2014-02-22",2013,"Dartford","Hereford United","2-0",2,0,5,5,2,2,"H"
"2014-02-22",2013,"Forest Green Rovers","Southport","3-1",3,1,5,5,4,2,"H"
"2014-02-22",2013,"Hyde United","Aldershot","2-2",2,2,5,5,4,0,"D"
"2014-02-22",2013,"Kidderminster Harriers","Braintree Town","2-2",2,2,5,5,4,0,"D"
"2014-02-22",2013,"Lincoln City","Chester","1-1",1,1,5,5,2,0,"D"
"2014-02-22",2013,"Nuneaton Town","Luton Town","0-5",0,5,5,5,5,-5,"A"
"2014-02-22",2013,"Tamworth","Welling United","1-1",1,1,5,5,2,0,"D"
"2014-02-22",2013,"Woking","Macclesfield","3-2",3,2,5,5,5,1,"H"
"2014-02-22",2013,"Wrexham","Barnet","0-1",0,1,5,5,1,-1,"A"
"2014-02-25",2013,"Braintree Town","Cambridge United","1-0",1,0,5,5,1,1,"H"
"2014-02-25",2013,"Dartford","Aldershot","1-1",1,1,5,5,2,0,"D"
"2014-02-25",2013,"Forest Green Rovers","Barnet","1-2",1,2,5,5,3,-1,"A"
"2014-02-25",2013,"Hereford United","Macclesfield","1-2",1,2,5,5,3,-1,"A"
"2014-02-25",2013,"Kidderminster Harriers","Woking","2-0",2,0,5,5,2,2,"H"
"2014-02-25",2013,"Luton Town","Wrexham","5-0",5,0,5,5,5,5,"H"
"2014-02-25",2013,"Southport","Grimsby Town","2-1",2,1,5,5,3,1,"H"
"2014-02-25",2013,"Tamworth","Chester","3-4",3,4,5,5,7,-1,"A"
"2014-02-25",2013,"Welling United","Gateshead","2-0",2,0,5,5,2,2,"H"
"2014-03-01",2013,"Aldershot","Lincoln City","2-3",2,3,5,5,5,-1,"A"
"2014-03-01",2013,"Barnet","Woking","1-3",1,3,5,5,4,-2,"A"
"2014-03-01",2013,"Braintree Town","Hyde United","2-1",2,1,5,5,3,1,"H"
"2014-03-01",2013,"Cambridge United","Kidderminster Harriers","5-1",5,1,5,5,6,4,"H"
"2014-03-01",2013,"Chester","Nuneaton Town","3-3",3,3,5,5,6,0,"D"
"2014-03-01",2013,"Gateshead","Forest Green Rovers","1-1",1,1,5,5,2,0,"D"
"2014-03-01",2013,"Grimsby Town","Salisbury","2-0",2,0,5,5,2,2,"H"
"2014-03-01",2013,"Halifax Town","Tamworth","2-0",2,0,5,5,2,2,"H"
"2014-03-01",2013,"Hereford United","Wrexham","0-2",0,2,5,5,2,-2,"A"
"2014-03-01",2013,"Luton Town","Alfreton Town","3-0",3,0,5,5,3,3,"H"
"2014-03-01",2013,"Southport","Dartford","3-0",3,0,5,5,3,3,"H"
"2014-03-01",2013,"Welling United","Macclesfield","1-0",1,0,5,5,1,1,"H"
"2014-03-07",2013,"Dartford","Chester","0-1",0,1,5,5,1,-1,"A"
"2014-03-08",2013,"Alfreton Town","Lincoln City","1-1",1,1,5,5,2,0,"D"
"2014-03-08",2013,"Barnet","Gateshead","0-1",0,1,5,5,1,-1,"A"
"2014-03-08",2013,"Braintree Town","Hereford United","1-1",1,1,5,5,2,0,"D"
"2014-03-08",2013,"Forest Green Rovers","Cambridge United","3-2",3,2,5,5,5,1,"H"
"2014-03-08",2013,"Hyde United","Halifax Town","1-5",1,5,5,5,6,-4,"A"
"2014-03-08",2013,"Macclesfield","Grimsby Town","1-1",1,1,5,5,2,0,"D"
"2014-03-08",2013,"Nuneaton Town","Welling United","2-0",2,0,5,5,2,2,"H"
"2014-03-08",2013,"Salisbury","Luton Town","0-0",0,0,5,5,0,0,"D"
"2014-03-08",2013,"Tamworth","Aldershot","1-0",1,0,5,5,1,1,"H"
"2014-03-08",2013,"Woking","Southport","2-0",2,0,5,5,2,2,"H"
"2014-03-08",2013,"Wrexham","Kidderminster Harriers","0-0",0,0,5,5,0,0,"D"
"2014-03-11",2013,"Aldershot","Chester","2-0",2,0,5,5,2,2,"H"
"2014-03-11",2013,"Alfreton Town","Hyde United","3-0",3,0,5,5,3,3,"H"
"2014-03-11",2013,"Braintree Town","Wrexham","3-0",3,0,5,5,3,3,"H"
"2014-03-11",2013,"Cambridge United","Luton Town","1-1",1,1,5,5,2,0,"D"
"2014-03-11",2013,"Forest Green Rovers","Salisbury","4-0",4,0,5,5,4,4,"H"
"2014-03-11",2013,"Grimsby Town","Hereford United","1-1",1,1,5,5,2,0,"D"
"2014-03-11",2013,"Kidderminster Harriers","Macclesfield","2-1",2,1,5,5,3,1,"H"
"2014-03-11",2013,"Lincoln City","Welling United","1-2",1,2,5,5,3,-1,"A"
"2014-03-11",2013,"Nuneaton Town","Tamworth","1-0",1,0,5,5,1,1,"H"
"2014-03-13",2013,"Forest Green Rovers","Braintree Town","0-2",0,2,5,5,2,-2,"A"
"2014-03-15",2013,"Aldershot","Nuneaton Town","2-2",2,2,5,5,4,0,"D"
"2014-03-15",2013,"Cambridge United","Dartford","1-1",1,1,5,5,2,0,"D"
"2014-03-15",2013,"Chester","Alfreton Town","0-1",0,1,5,5,1,-1,"A"
"2014-03-15",2013,"Grimsby Town","Wrexham","3-1",3,1,5,5,4,2,"H"
"2014-03-15",2013,"Hereford United","Hyde United","0-0",0,0,5,5,0,0,"D"
"2014-03-15",2013,"Kidderminster Harriers","Barnet","1-0",1,0,5,5,1,1,"H"
"2014-03-15",2013,"Lincoln City","Braintree Town","2-0",2,0,5,5,2,2,"H"
"2014-03-15",2013,"Salisbury","Gateshead","0-0",0,0,5,5,0,0,"D"
"2014-03-15",2013,"Southport","Macclesfield","4-1",4,1,5,5,5,3,"H"
"2014-03-15",2013,"Tamworth","Forest Green Rovers","1-2",1,2,5,5,3,-1,"A"
"2014-03-15",2013,"Welling United","Halifax Town","0-1",0,1,5,5,1,-1,"A"
"2014-03-17",2013,"Luton Town","Woking","0-1",0,1,5,5,1,-1,"A"
"2014-03-18",2013,"Aldershot","Kidderminster Harriers","0-0",0,0,5,5,0,0,"D"
"2014-03-18",2013,"Alfreton Town","Tamworth","4-2",4,2,5,5,6,2,"H"
"2014-03-18",2013,"Braintree Town","Lincoln City","0-2",0,2,5,5,2,-2,"A"
"2014-03-18",2013,"Cambridge United","Welling United","2-1",2,1,5,5,3,1,"H"
"2014-03-18",2013,"Chester","Southport","2-2",2,2,5,5,4,0,"D"
"2014-03-18",2013,"Forest Green Rovers","Grimsby Town","2-1",2,1,5,5,3,1,"H"
"2014-03-18",2013,"Macclesfield","Barnet","2-0",2,0,5,5,2,2,"H"
"2014-03-18",2013,"Wrexham","Hereford United","2-0",2,0,5,5,2,2,"H"
"2014-03-22",2013,"Barnet","Hereford United","2-0",2,0,5,5,2,2,"H"
"2014-03-22",2013,"Braintree Town","Aldershot","1-0",1,0,5,5,1,1,"H"
"2014-03-22",2013,"Forest Green Rovers","Welling United","0-0",0,0,5,5,0,0,"D"
"2014-03-22",2013,"Gateshead","Lincoln City","3-1",3,1,5,5,4,2,"H"
"2014-03-22",2013,"Hyde United","Dartford","0-2",0,2,5,5,2,-2,"A"
"2014-03-22",2013,"Kidderminster Harriers","Southport","1-1",1,1,5,5,2,0,"D"
"2014-03-22",2013,"Luton Town","Chester","3-0",3,0,5,5,3,3,"H"
"2014-03-22",2013,"Macclesfield","Tamworth","2-1",2,1,5,5,3,1,"H"
"2014-03-22",2013,"Nuneaton Town","Grimsby Town","0-1",0,1,5,5,1,-1,"A"
"2014-03-22",2013,"Wrexham","Salisbury","1-1",1,1,5,5,2,0,"D"
"2014-03-24",2013,"Halifax Town","Alfreton Town","2-0",2,0,5,5,2,2,"H"
"2014-03-25",2013,"Aldershot","Gateshead","1-2",1,2,5,5,3,-1,"A"
"2014-03-25",2013,"Chester","Tamworth","2-0",2,0,5,5,2,2,"H"
"2014-03-25",2013,"Grimsby Town","Luton Town","1-2",1,2,5,5,3,-1,"A"
"2014-03-25",2013,"Welling United","Braintree Town","0-2",0,2,5,5,2,-2,"A"
"2014-03-26",2013,"Salisbury","Cambridge United","0-3",0,3,5,5,3,-3,"A"
"2014-03-27",2013,"Braintree Town","Nuneaton Town","2-1",2,1,5,5,3,1,"H"
"2014-03-27",2013,"Southport","Forest Green Rovers","2-0",2,0,5,5,2,2,"H"
"2014-03-29",2013,"Aldershot","Hyde United","1-0",1,0,5,5,1,1,"H"
"2014-03-29",2013,"Alfreton Town","Nuneaton Town","1-1",1,1,5,5,2,0,"D"
"2014-03-29",2013,"Cambridge United","Barnet","1-1",1,1,5,5,2,0,"D"
"2014-03-29",2013,"Dartford","Macclesfield","2-1",2,1,5,5,3,1,"H"
"2014-03-29",2013,"Gateshead","Braintree Town","1-0",1,0,5,5,1,1,"H"
"2014-03-29",2013,"Halifax Town","Luton Town","2-0",2,0,5,5,2,2,"H"
"2014-03-29",2013,"Hereford United","Grimsby Town","0-1",0,1,5,5,1,-1,"A"
"2014-03-29",2013,"Salisbury","Kidderminster Harriers","1-1",1,1,5,5,2,0,"D"
"2014-03-29",2013,"Tamworth","Lincoln City","0-0",0,0,5,5,0,0,"D"
"2014-03-29",2013,"Welling United","Chester","2-0",2,0,5,5,2,2,"H"
"2014-03-29",2013,"Woking","Wrexham","2-1",2,1,5,5,3,1,"H"
"2014-04-01",2013,"Dartford","Luton Town","1-2",1,2,5,5,3,-1,"A"
"2014-04-01",2013,"Macclesfield","Cambridge United","0-1",0,1,5,5,1,-1,"A"
"2014-04-01",2013,"Southport","Braintree Town","0-4",0,4,5,5,4,-4,"A"
"2014-04-01",2013,"Woking","Forest Green Rovers","2-1",2,1,5,5,3,1,"H"
"2014-04-01",2013,"Wrexham","Grimsby Town","0-1",0,1,5,5,1,-1,"A"
"2014-04-03",2013,"Halifax Town","Braintree Town","0-0",0,0,5,5,0,0,"D"
"2014-04-05",2013,"Alfreton Town","Welling United","2-2",2,2,5,5,4,0,"D"
"2014-04-05",2013,"Barnet","Forest Green Rovers","2-1",2,1,5,5,3,1,"H"
"2014-04-05",2013,"Braintree Town","Salisbury","0-1",0,1,5,5,1,-1,"A"
"2014-04-05",2013,"Cambridge United","Southport","3-1",3,1,5,5,4,2,"H"
"2014-04-05",2013,"Chester","Hyde United","3-2",3,2,5,5,5,1,"H"
"2014-04-05",2013,"Gateshead","Tamworth","5-0",5,0,5,5,5,5,"H"
"2014-04-05",2013,"Hereford United","Woking","0-2",0,2,5,5,2,-2,"A"
"2014-04-05",2013,"Kidderminster Harriers","Grimsby Town","0-1",0,1,5,5,1,-1,"A"
"2014-04-05",2013,"Lincoln City","Dartford","0-0",0,0,5,5,0,0,"D"
"2014-04-05",2013,"Luton Town","Aldershot","1-0",1,0,5,5,1,1,"H"
"2014-04-05",2013,"Nuneaton Town","Halifax Town","0-1",0,1,5,5,1,-1,"A"
"2014-04-05",2013,"Wrexham","Macclesfield","1-0",1,0,5,5,1,1,"H"
"2014-04-08",2013,"Alfreton Town","Aldershot","1-4",1,4,5,5,5,-3,"A"
"2014-04-08",2013,"Braintree Town","Macclesfield","0-1",0,1,5,5,1,-1,"A"
"2014-04-08",2013,"Forest Green Rovers","Kidderminster Harriers","1-1",1,1,5,5,2,0,"D"
"2014-04-08",2013,"Grimsby Town","Woking","2-2",2,2,5,5,4,0,"D"
"2014-04-08",2013,"Hyde United","Salisbury","0-2",0,2,5,5,2,-2,"A"
"2014-04-08",2013,"Luton Town","Tamworth","2-0",2,0,5,5,2,2,"H"
"2014-04-08",2013,"Southport","Barnet","1-1",1,1,5,5,2,0,"D"
"2014-04-08",2013,"Welling United","Hereford United","0-1",0,1,5,5,1,-1,"A"
"2014-04-10",2013,"Dartford","Grimsby Town","1-0",1,0,5,5,1,1,"H"
"2014-04-10",2013,"Woking","Cambridge United","0-3",0,3,5,5,3,-3,"A"
"2014-04-12",2013,"Barnet","Halifax Town","0-4",0,4,5,5,4,-4,"A"
"2014-04-12",2013,"Cambridge United","Hyde United","7-2",7,2,5,5,9,5,"H"
"2014-04-12",2013,"Dartford","Forest Green Rovers","0-1",0,1,5,5,1,-1,"A"
"2014-04-12",2013,"Grimsby Town","Chester","2-1",2,1,5,5,3,1,"H"
"2014-04-12",2013,"Hereford United","Gateshead","0-1",0,1,5,5,1,-1,"A"
"2014-04-12",2013,"Kidderminster Harriers","Welling United","2-0",2,0,5,5,2,2,"H"
"2014-04-12",2013,"Luton Town","Braintree Town","2-3",2,3,5,5,5,-1,"A"
"2014-04-12",2013,"Macclesfield","Aldershot","1-1",1,1,5,5,2,0,"D"
"2014-04-12",2013,"Salisbury","Lincoln City","1-2",1,2,5,5,3,-1,"A"
"2014-04-12",2013,"Southport","Tamworth","2-0",2,0,5,5,2,2,"H"
"2014-04-12",2013,"Woking","Alfreton Town","2-1",2,1,5,5,3,1,"H"
"2014-04-12",2013,"Wrexham","Nuneaton Town","3-0",3,0,5,5,3,3,"H"
"2014-04-15",2013,"Braintree Town","Gateshead","0-0",0,0,5,5,0,0,"D"
"2014-04-15",2013,"Grimsby Town","Halifax Town","0-1",0,1,5,5,1,-1,"A"
"2014-04-15",2013,"Kidderminster Harriers","Cambridge United","2-0",2,0,5,5,2,2,"H"
"2014-04-15",2013,"Macclesfield","Forest Green Rovers","1-2",1,2,5,5,3,-1,"A"
"2014-04-18",2013,"Aldershot","Salisbury","3-2",3,2,5,5,5,1,"H"
"2014-04-18",2013,"Alfreton Town","Grimsby Town","3-3",3,3,5,5,6,0,"D"
"2014-04-18",2013,"Braintree Town","Dartford","1-0",1,0,5,5,1,1,"H"
"2014-04-18",2013,"Gateshead","Southport","2-2",2,2,5,5,4,0,"D"
"2014-04-18",2013,"Hyde United","Kidderminster Harriers","1-3",1,3,5,5,4,-2,"A"
"2014-04-18",2013,"Lincoln City","Cambridge United","1-0",1,0,5,5,1,1,"H"
"2014-04-18",2013,"Tamworth","Hereford United","1-0",1,0,5,5,1,1,"H"
"2014-04-19",2013,"Chester","Wrexham","0-0",0,0,5,5,0,0,"D"
"2014-04-19",2013,"Forest Green Rovers","Woking","2-2",2,2,5,5,4,0,"D"
"2014-04-19",2013,"Halifax Town","Macclesfield","2-1",2,1,5,5,3,1,"H"
"2014-04-19",2013,"Nuneaton Town","Barnet","0-1",0,1,5,5,1,-1,"A"
"2014-04-19",2013,"Welling United","Luton Town","1-2",1,2,5,5,3,-1,"A"
"2014-04-21",2013,"Barnet","Braintree Town","1-1",1,1,5,5,2,0,"D"
"2014-04-21",2013,"Cambridge United","Chester","0-1",0,1,5,5,1,-1,"A"
"2014-04-21",2013,"Dartford","Tamworth","2-3",2,3,5,5,5,-1,"A"
"2014-04-21",2013,"Grimsby Town","Hyde United","1-0",1,0,5,5,1,1,"H"
"2014-04-21",2013,"Hereford United","Alfreton Town","3-2",3,2,5,5,5,1,"H"
"2014-04-21",2013,"Kidderminster Harriers","Nuneaton Town","0-0",0,0,5,5,0,0,"D"
"2014-04-21",2013,"Luton Town","Forest Green Rovers","4-1",4,1,5,5,5,3,"H"
"2014-04-21",2013,"Macclesfield","Gateshead","0-2",0,2,5,5,2,-2,"A"
"2014-04-21",2013,"Salisbury","Welling United","3-0",3,0,5,5,3,3,"H"
"2014-04-21",2013,"Southport","Halifax Town","2-1",2,1,5,5,3,1,"H"
"2014-04-21",2013,"Woking","Aldershot","1-2",1,2,5,5,3,-1,"A"
"2014-04-21",2013,"Wrexham","Lincoln City","0-1",0,1,5,5,1,-1,"A"
"2014-04-26",2013,"Aldershot","Hereford United","1-2",1,2,5,5,3,-1,"A"
"2014-04-26",2013,"Alfreton Town","Macclesfield","0-1",0,1,5,5,1,-1,"A"
"2014-04-26",2013,"Braintree Town","Grimsby Town","0-0",0,0,5,5,0,0,"D"
"2014-04-26",2013,"Chester","Salisbury","2-2",2,2,5,5,4,0,"D"
"2014-04-26",2013,"Forest Green Rovers","Wrexham","1-1",1,1,5,5,2,0,"D"
"2014-04-26",2013,"Gateshead","Cambridge United","2-0",2,0,5,5,2,2,"H"
"2014-04-26",2013,"Halifax Town","Kidderminster Harriers","1-1",1,1,5,5,2,0,"D"
"2014-04-26",2013,"Hyde United","Luton Town","0-1",0,1,5,5,1,-1,"A"
"2014-04-26",2013,"Lincoln City","Barnet","3-3",3,3,5,5,6,0,"D"
"2014-04-26",2013,"Nuneaton Town","Dartford","3-1",3,1,5,5,4,2,"H"
"2014-04-26",2013,"Tamworth","Woking","2-4",2,4,5,5,6,-2,"A"
"2014-04-26",2013,"Welling United","Southport","4-3",4,3,5,5,7,1,"H"
"2014-08-09",2014,"Aldershot","Altrincham","3-1",3,1,5,5,4,2,"H"
"2014-08-09",2014,"Alfreton Town","Woking","1-3",1,3,5,5,4,-2,"A"
"2014-08-09",2014,"Bristol Rovers","Grimsby Town","0-0",0,0,5,5,0,0,"D"
"2014-08-09",2014,"Chester","Barnet","0-5",0,5,5,5,5,-5,"A"
"2014-08-09",2014,"Dartford","Wrexham","1-2",1,2,5,5,3,-1,"A"
"2014-08-09",2014,"Dover Athletic","Halifax Town","0-1",0,1,5,5,1,-1,"A"
"2014-08-09",2014,"Gateshead","Torquay United","3-1",3,1,5,5,4,2,"H"
"2014-08-09",2014,"Lincoln City","Kidderminster Harriers","0-0",0,0,5,5,0,0,"D"
"2014-08-09",2014,"Macclesfield","Braintree Town","1-0",1,0,5,5,1,1,"H"
"2014-08-09",2014,"Nuneaton Town","Eastleigh","0-3",0,3,5,5,3,-3,"A"
"2014-08-09",2014,"Southport","Forest Green Rovers","0-1",0,1,5,5,1,-1,"A"
"2014-08-09",2014,"Welling United","Telford United","1-1",1,1,5,5,2,0,"D"
"2014-08-12",2014,"Altrincham","Lincoln City","1-2",1,2,5,5,3,-1,"A"
"2014-08-12",2014,"Barnet","Bristol Rovers","2-0",2,0,5,5,2,2,"H"
"2014-08-12",2014,"Braintree Town","Dover Athletic","3-0",3,0,5,5,3,3,"H"
"2014-08-12",2014,"Forest Green Rovers","Chester","2-1",2,1,5,5,3,1,"H"
"2014-08-12",2014,"Grimsby Town","Nuneaton Town","0-0",0,0,5,5,0,0,"D"
"2014-08-12",2014,"Halifax Town","Southport","3-1",3,1,5,5,4,2,"H"
"2014-08-12",2014,"Kidderminster Harriers","Alfreton Town","3-0",3,0,5,5,3,3,"H"
"2014-08-12",2014,"Telford United","Macclesfield","2-3",2,3,5,5,5,-1,"A"
"2014-08-12",2014,"Torquay United","Welling United","3-0",3,0,5,5,3,3,"H"
"2014-08-12",2014,"Woking","Dartford","1-1",1,1,5,5,2,0,"D"
"2014-08-12",2014,"Wrexham","Gateshead","0-3",0,3,5,5,3,-3,"A"
"2014-08-14",2014,"Eastleigh","Aldershot","1-0",1,0,5,5,1,1,"H"
"2014-08-16",2014,"Altrincham","Bristol Rovers","2-1",2,1,5,5,3,1,"H"
"2014-08-16",2014,"Barnet","Lincoln City","1-2",1,2,5,5,3,-1,"A"
"2014-08-16",2014,"Braintree Town","Chester","1-3",1,3,5,5,4,-2,"A"
"2014-08-16",2014,"Eastleigh","Gateshead","2-2",2,2,5,5,4,0,"D"
"2014-08-16",2014,"Forest Green Rovers","Alfreton Town","2-0",2,0,5,5,2,2,"H"
"2014-08-16",2014,"Grimsby Town","Dover Athletic","1-1",1,1,5,5,2,0,"D"
"2014-08-16",2014,"Halifax Town","Welling United","3-0",3,0,5,5,3,3,"H"
"2014-08-16",2014,"Kidderminster Harriers","Dartford","1-0",1,0,5,5,1,1,"H"
"2014-08-16",2014,"Torquay United","Southport","0-0",0,0,5,5,0,0,"D"
"2014-08-16",2014,"Woking","Macclesfield","0-0",0,0,5,5,0,0,"D"
"2014-08-16",2014,"Wrexham","Nuneaton Town","1-0",1,0,5,5,1,1,"H"
"2014-08-17",2014,"Telford United","Aldershot","0-2",0,2,5,5,2,-2,"A"
"2014-08-22",2014,"Aldershot","Forest Green Rovers","1-1",1,1,5,5,2,0,"D"
"2014-08-23",2014,"Alfreton Town","Wrexham","2-3",2,3,5,5,5,-1,"A"
"2014-08-23",2014,"Bristol Rovers","Telford United","1-0",1,0,5,5,1,1,"H"
"2014-08-23",2014,"Chester","Halifax Town","0-3",0,3,5,5,3,-3,"A"
"2014-08-23",2014,"Dartford","Torquay United","0-0",0,0,5,5,0,0,"D"
"2014-08-23",2014,"Dover Athletic","Eastleigh","2-1",2,1,5,5,3,1,"H"
"2014-08-23",2014,"Gateshead","Grimsby Town","1-6",1,6,5,5,7,-5,"A"
"2014-08-23",2014,"Lincoln City","Braintree Town","3-2",3,2,5,5,5,1,"H"
"2014-08-23",2014,"Macclesfield","Kidderminster Harriers","0-0",0,0,5,5,0,0,"D"
"2014-08-23",2014,"Nuneaton Town","Barnet","0-2",0,2,5,5,2,-2,"A"
"2014-08-23",2014,"Southport","Altrincham","2-1",2,1,5,5,3,1,"H"
"2014-08-23",2014,"Welling United","Woking","1-1",1,1,5,5,2,0,"D"
"2014-08-25",2014,"Altrincham","Gateshead","0-1",0,1,5,5,1,-1,"A"
"2014-08-25",2014,"Barnet","Dartford","4-0",4,0,5,5,4,4,"H"
"2014-08-25",2014,"Braintree Town","Nuneaton Town","2-0",2,0,5,5,2,2,"H"
"2014-08-25",2014,"Eastleigh","Welling United","3-1",3,1,5,5,4,2,"H"
"2014-08-25",2014,"Forest Green Rovers","Bristol Rovers","1-1",1,1,5,5,2,0,"D"
"2014-08-25",2014,"Grimsby Town","Alfreton Town","7-0",7,0,5,5,7,7,"H"
"2014-08-25",2014,"Halifax Town","Lincoln City","3-2",3,2,5,5,5,1,"H"
"2014-08-25",2014,"Kidderminster Harriers","Chester","2-2",2,2,5,5,4,0,"D"
"2014-08-25",2014,"Telford United","Southport","3-3",3,3,5,5,6,0,"D"
"2014-08-25",2014,"Torquay United","Aldershot","1-1",1,1,5,5,2,0,"D"
"2014-08-25",2014,"Woking","Dover Athletic","6-1",6,1,5,5,7,5,"H"
"2014-08-25",2014,"Wrexham","Macclesfield","2-2",2,2,5,5,4,0,"D"
"2014-08-30",2014,"Aldershot","Grimsby Town","2-1",2,1,5,5,3,1,"H"
"2014-08-30",2014,"Alfreton Town","Braintree Town","0-2",0,2,5,5,2,-2,"A"
"2014-08-30",2014,"Bristol Rovers","Halifax Town","2-1",2,1,5,5,3,1,"H"
"2014-08-30",2014,"Dartford","Telford United","2-1",2,1,5,5,3,1,"H"
"2014-08-30",2014,"Dover Athletic","Kidderminster Harriers","0-1",0,1,5,5,1,-1,"A"
"2014-08-30",2014,"Gateshead","Chester","2-1",2,1,5,5,3,1,"H"
"2014-08-30",2014,"Lincoln City","Torquay United","1-3",1,3,5,5,4,-2,"A"
"2014-08-30",2014,"Macclesfield","Eastleigh","2-0",2,0,5,5,2,2,"H"
"2014-08-30",2014,"Nuneaton Town","Altrincham","2-1",2,1,5,5,3,1,"H"
"2014-08-30",2014,"Southport","Barnet","0-2",0,2,5,5,2,-2,"A"
"2014-08-30",2014,"Welling United","Forest Green Rovers","1-1",1,1,5,5,2,0,"D"
"2014-08-30",2014,"Wrexham","Woking","1-2",1,2,5,5,3,-1,"A"
"2014-09-06",2014,"Altrincham","Dartford","2-1",2,1,5,5,3,1,"H"
"2014-09-06",2014,"Barnet","Alfreton Town","2-1",2,1,5,5,3,1,"H"
"2014-09-06",2014,"Braintree Town","Bristol Rovers","2-0",2,0,5,5,2,2,"H"
"2014-09-06",2014,"Chester","Macclesfield","1-0",1,0,5,5,1,1,"H"
"2014-09-06",2014,"Eastleigh","Southport","2-1",2,1,5,5,3,1,"H"
"2014-09-06",2014,"Forest Green Rovers","Wrexham","0-1",0,1,5,5,1,-1,"A"
"2014-09-06",2014,"Grimsby Town","Welling United","2-0",2,0,5,5,2,2,"H"
"2014-09-06",2014,"Halifax Town","Aldershot","1-0",1,0,5,5,1,1,"H"
"2014-09-06",2014,"Kidderminster Harriers","Gateshead","2-1",2,1,5,5,3,1,"H"
"2014-09-06",2014,"Telford United","Dover Athletic","1-4",1,4,5,5,5,-3,"A"
"2014-09-06",2014,"Torquay United","Nuneaton Town","4-0",4,0,5,5,4,4,"H"
"2014-09-06",2014,"Woking","Lincoln City","3-1",3,1,5,5,4,2,"H"
"2014-09-09",2014,"Aldershot","Woking","0-1",0,1,5,5,1,-1,"A"
"2014-09-09",2014,"Alfreton Town","Altrincham","1-1",1,1,5,5,2,0,"D"
"2014-09-09",2014,"Bristol Rovers","Wrexham","1-0",1,0,5,5,1,1,"H"
"2014-09-09",2014,"Chester","Torquay United","0-2",0,2,5,5,2,-2,"A"
"2014-09-09",2014,"Dartford","Eastleigh","2-2",2,2,5,5,4,0,"D"
"2014-09-09",2014,"Gateshead","Telford United","4-1",4,1,5,5,5,3,"H"
"2014-09-09",2014,"Lincoln City","Grimsby Town","3-2",3,2,5,5,5,1,"H"
"2014-09-09",2014,"Macclesfield","Halifax Town","1-1",1,1,5,5,2,0,"D"
"2014-09-09",2014,"Nuneaton Town","Forest Green Rovers","1-0",1,0,5,5,1,1,"H"
"2014-09-09",2014,"Southport","Kidderminster Harriers","1-0",1,0,5,5,1,1,"H"
"2014-09-09",2014,"Welling United","Braintree Town","2-1",2,1,5,5,3,1,"H"
"2014-09-10",2014,"Dover Athletic","Barnet","0-3",0,3,5,5,3,-3,"A"
"2014-09-13",2014,"Altrincham","Eastleigh","3-3",3,3,5,5,6,0,"D"
"2014-09-13",2014,"Braintree Town","Kidderminster Harriers","2-0",2,0,5,5,2,2,"H"
"2014-09-13",2014,"Dover Athletic","Macclesfield","0-1",0,1,5,5,1,-1,"A"
"2014-09-13",2014,"Forest Green Rovers","Halifax Town","2-0",2,0,5,5,2,2,"H"
"2014-09-13",2014,"Gateshead","Dartford","1-0",1,0,5,5,1,1,"H"
"2014-09-13",2014,"Grimsby Town","Torquay United","0-2",0,2,5,5,2,-2,"A"
"2014-09-13",2014,"Lincoln City","Bristol Rovers","2-3",2,3,5,5,5,-1,"A"
"2014-09-13",2014,"Nuneaton Town","Aldershot","1-1",1,1,5,5,2,0,"D"
"2014-09-13",2014,"Southport","Alfreton Town","0-2",0,2,5,5,2,-2,"A"
"2014-09-13",2014,"Telford United","Barnet","2-2",2,2,5,5,4,0,"D"
"2014-09-13",2014,"Woking","Chester","1-0",1,0,5,5,1,1,"H"
"2014-09-13",2014,"Wrexham","Welling United","2-1",2,1,5,5,3,1,"H"
"2014-09-16",2014,"Aldershot","Braintree Town","1-3",1,3,5,5,4,-2,"A"
"2014-09-16",2014,"Alfreton Town","Telford United","3-2",3,2,5,5,5,1,"H"
"2014-09-16",2014,"Barnet","Wrexham","0-1",0,1,5,5,1,-1,"A"
"2014-09-16",2014,"Bristol Rovers","Nuneaton Town","3-1",3,1,5,5,4,2,"H"
"2014-09-16",2014,"Chester","Southport","2-0",2,0,5,5,2,2,"H"
"2014-09-16",2014,"Dartford","Dover Athletic","2-1",2,1,5,5,3,1,"H"
"2014-09-16",2014,"Eastleigh","Forest Green Rovers","2-2",2,2,5,5,4,0,"D"
"2014-09-16",2014,"Halifax Town","Grimsby Town","1-1",1,1,5,5,2,0,"D"
"2014-09-16",2014,"Kidderminster Harriers","Altrincham","4-0",4,0,5,5,4,4,"H"
"2014-09-16",2014,"Macclesfield","Gateshead","1-1",1,1,5,5,2,0,"D"
"2014-09-16",2014,"Torquay United","Woking","1-0",1,0,5,5,1,1,"H"
"2014-09-16",2014,"Welling United","Lincoln City","2-0",2,0,5,5,2,2,"H"
"2014-09-20",2014,"Aldershot","Lincoln City","1-0",1,0,5,5,1,1,"H"
"2014-09-20",2014,"Alfreton Town","Nuneaton Town","1-0",1,0,5,5,1,1,"H"
"2014-09-20",2014,"Barnet","Altrincham","5-0",5,0,5,5,5,5,"H"
"2014-09-20",2014,"Bristol Rovers","Woking","2-0",2,0,5,5,2,2,"H"
"2014-09-20",2014,"Dartford","Forest Green Rovers","1-2",1,2,5,5,3,-1,"A"
"2014-09-20",2014,"Eastleigh","Braintree Town","1-0",1,0,5,5,1,1,"H"
"2014-09-20",2014,"Halifax Town","Telford United","5-0",5,0,5,5,5,5,"H"
"2014-09-20",2014,"Kidderminster Harriers","Grimsby Town","0-1",0,1,5,5,1,-1,"A"
"2014-09-20",2014,"Macclesfield","Southport","3-0",3,0,5,5,3,3,"H"
"2014-09-20",2014,"Torquay United","Dover Athletic","2-0",2,0,5,5,2,2,"H"
"2014-09-20",2014,"Welling United","Gateshead","1-1",1,1,5,5,2,0,"D"
"2014-09-22",2014,"Chester","Wrexham","2-1",2,1,5,5,3,1,"H"
"2014-09-27",2014,"Altrincham","Welling United","0-4",0,4,5,5,4,-4,"A"
"2014-09-27",2014,"Braintree Town","Halifax Town","0-0",0,0,5,5,0,0,"D"
"2014-09-27",2014,"Dover Athletic","Alfreton Town","1-0",1,0,5,5,1,1,"H"
"2014-09-27",2014,"Forest Green Rovers","Barnet","1-2",1,2,5,5,3,-1,"A"
"2014-09-27",2014,"Gateshead","Aldershot","1-1",1,1,5,5,2,0,"D"
"2014-09-27",2014,"Grimsby Town","Chester","3-0",3,0,5,5,3,3,"H"
"2014-09-27",2014,"Lincoln City","Macclesfield","2-0",2,0,5,5,2,2,"H"
"2014-09-27",2014,"Nuneaton Town","Dartford","1-2",1,2,5,5,3,-1,"A"
"2014-09-27",2014,"Southport","Bristol Rovers","0-1",0,1,5,5,1,-1,"A"
"2014-09-27",2014,"Telford United","Torquay United","4-3",4,3,5,5,7,1,"H"
"2014-09-27",2014,"Woking","Kidderminster Harriers","2-3",2,3,5,5,5,-1,"A"
"2014-09-27",2014,"Wrexham","Eastleigh","3-0",3,0,5,5,3,3,"H"
"2014-09-30",2014,"Alfreton Town","Halifax Town","0-2",0,2,5,5,2,-2,"A"
"2014-09-30",2014,"Altrincham","Macclesfield","1-0",1,0,5,5,1,1,"H"
"2014-09-30",2014,"Braintree Town","Barnet","1-1",1,1,5,5,2,0,"D"
"2014-09-30",2014,"Dover Athletic","Aldershot","3-0",3,0,5,5,3,3,"H"
"2014-09-30",2014,"Eastleigh","Bristol Rovers","1-1",1,1,5,5,2,0,"D"
"2014-09-30",2014,"Forest Green Rovers","Torquay United","2-1",2,1,5,5,3,1,"H"
"2014-09-30",2014,"Grimsby Town","Southport","0-1",0,1,5,5,1,-1,"A"
"2014-09-30",2014,"Lincoln City","Gateshead","1-1",1,1,5,5,2,0,"D"
"2014-09-30",2014,"Telford United","Chester","1-2",1,2,5,5,3,-1,"A"
"2014-09-30",2014,"Welling United","Dartford","2-2",2,2,5,5,4,0,"D"
"2014-09-30",2014,"Woking","Nuneaton Town","1-0",1,0,5,5,1,1,"H"
"2014-09-30",2014,"Wrexham","Kidderminster Harriers","1-0",1,0,5,5,1,1,"H"
"2014-10-04",2014,"Aldershot","Alfreton Town","2-0",2,0,5,5,2,2,"H"
"2014-10-04",2014,"Barnet","Eastleigh","1-0",1,0,5,5,1,1,"H"
"2014-10-04",2014,"Bristol Rovers","Dover Athletic","1-1",1,1,5,5,2,0,"D"
"2014-10-04",2014,"Chester","Welling United","1-1",1,1,5,5,2,0,"D"
"2014-10-04",2014,"Dartford","Grimsby Town","1-1",1,1,5,5,2,0,"D"
"2014-10-04",2014,"Gateshead","Braintree Town","3-1",3,1,5,5,4,2,"H"
"2014-10-04",2014,"Halifax Town","Altrincham","1-3",1,3,5,5,4,-2,"A"
"2014-10-04",2014,"Kidderminster Harriers","Telford United","1-1",1,1,5,5,2,0,"D"
"2014-10-04",2014,"Macclesfield","Forest Green Rovers","2-2",2,2,5,5,4,0,"D"
"2014-10-04",2014,"Nuneaton Town","Lincoln City","2-1",2,1,5,5,3,1,"H"
"2014-10-04",2014,"Southport","Woking","2-5",2,5,5,5,7,-3,"A"
"2014-10-04",2014,"Torquay United","Wrexham","2-1",2,1,5,5,3,1,"H"
"2014-10-07",2014,"Bristol Rovers","Dartford","1-0",1,0,5,5,1,1,"H"
"2014-10-07",2014,"Chester","Aldershot","1-0",1,0,5,5,1,1,"H"
"2014-10-07",2014,"Gateshead","Alfreton Town","2-0",2,0,5,5,2,2,"H"
"2014-10-07",2014,"Grimsby Town","Altrincham","0-0",0,0,5,5,0,0,"D"
"2014-10-07",2014,"Halifax Town","Wrexham","2-2",2,2,5,5,4,0,"D"
"2014-10-07",2014,"Macclesfield","Barnet","2-1",2,1,5,5,3,1,"H"
"2014-10-07",2014,"Nuneaton Town","Dover Athletic","3-2",3,2,5,5,5,1,"H"
"2014-10-07",2014,"Southport","Lincoln City","3-3",3,3,5,5,6,0,"D"
"2014-10-07",2014,"Telford United","Forest Green Rovers","0-1",0,1,5,5,1,-1,"A"
"2014-10-08",2014,"Kidderminster Harriers","Welling United","2-1",2,1,5,5,3,1,"H"
"2014-10-11",2014,"Aldershot","Bristol Rovers","2-2",2,2,5,5,4,0,"D"
"2014-10-11",2014,"Alfreton Town","Torquay United","4-2",4,2,5,5,6,2,"H"
"2014-10-11",2014,"Altrincham","Woking","0-3",0,3,5,5,3,-3,"A"
"2014-10-11",2014,"Barnet","Kidderminster Harriers","3-3",3,3,5,5,6,0,"D"
"2014-10-11",2014,"Braintree Town","Southport","0-2",0,2,5,5,2,-2,"A"
"2014-10-11",2014,"Dartford","Macclesfield","1-1",1,1,5,5,2,0,"D"
"2014-10-11",2014,"Dover Athletic","Chester","2-0",2,0,5,5,2,2,"H"
"2014-10-11",2014,"Eastleigh","Halifax Town","4-1",4,1,5,5,5,3,"H"
"2014-10-11",2014,"Forest Green Rovers","Gateshead","1-1",1,1,5,5,2,0,"D"
"2014-10-11",2014,"Lincoln City","Telford United","2-0",2,0,5,5,2,2,"H"
"2014-10-11",2014,"Welling United","Nuneaton Town","4-1",4,1,5,5,5,3,"H"
"2014-10-11",2014,"Wrexham","Grimsby Town","0-1",0,1,5,5,1,-1,"A"
"2014-10-18",2014,"Altrincham","Braintree Town","1-0",1,0,5,5,1,1,"H"
"2014-10-18",2014,"Bristol Rovers","Forest Green Rovers","0-1",0,1,5,5,1,-1,"A"
"2014-10-18",2014,"Chester","Alfreton Town","2-1",2,1,5,5,3,1,"H"
"2014-10-18",2014,"Dartford","Aldershot","1-1",1,1,5,5,2,0,"D"
"2014-10-18",2014,"Eastleigh","Nuneaton Town","2-1",2,1,5,5,3,1,"H"
"2014-10-18",2014,"Gateshead","Barnet","0-2",0,2,5,5,2,-2,"A"
"2014-10-18",2014,"Halifax Town","Kidderminster Harriers","2-0",2,0,5,5,2,2,"H"
"2014-10-18",2014,"Lincoln City","Wrexham","1-1",1,1,5,5,2,0,"D"
"2014-10-18",2014,"Macclesfield","Dover Athletic","1-0",1,0,5,5,1,1,"H"
"2014-10-18",2014,"Southport","Welling United","1-0",1,0,5,5,1,1,"H"
"2014-10-18",2014,"Torquay United","Grimsby Town","2-3",2,3,5,5,5,-1,"A"
"2014-10-18",2014,"Woking","Telford United","1-3",1,3,5,5,4,-2,"A"
"2014-10-21",2014,"Barnet","Braintree Town","3-0",3,0,5,5,3,3,"H"
"2014-11-01",2014,"Aldershot","Gateshead","1-2",1,2,5,5,3,-1,"A"
"2014-11-01",2014,"Altrincham","Alfreton Town","0-1",0,1,5,5,1,-1,"A"
"2014-11-01",2014,"Braintree Town","Woking","0-0",0,0,5,5,0,0,"D"
"2014-11-01",2014,"Eastleigh","Chester","3-2",3,2,5,5,5,1,"H"
"2014-11-01",2014,"Forest Green Rovers","Lincoln City","3-3",3,3,5,5,6,0,"D"
"2014-11-01",2014,"Grimsby Town","Dartford","3-0",3,0,5,5,3,3,"H"
"2014-11-01",2014,"Kidderminster Harriers","Torquay United","2-1",2,1,5,5,3,1,"H"
"2014-11-01",2014,"Nuneaton Town","Macclesfield","1-1",1,1,5,5,2,0,"D"
"2014-11-01",2014,"Southport","Dover Athletic","2-2",2,2,5,5,4,0,"D"
"2014-11-01",2014,"Telford United","Bristol Rovers","0-1",0,1,5,5,1,-1,"A"
"2014-11-01",2014,"Welling United","Barnet","1-2",1,2,5,5,3,-1,"A"
"2014-11-01",2014,"Wrexham","Halifax Town","0-0",0,0,5,5,0,0,"D"
"2014-11-04",2014,"Braintree Town","Grimsby Town","0-1",0,1,5,5,1,-1,"A"
"2014-11-04",2014,"Lincoln City","Altrincham","1-2",1,2,5,5,3,-1,"A"
"2014-11-11",2014,"Alfreton Town","Bristol Rovers","0-0",0,0,5,5,0,0,"D"
"2014-11-11",2014,"Barnet","Torquay United","2-3",2,3,5,5,5,-1,"A"
"2014-11-11",2014,"Dartford","Welling United","2-1",2,1,5,5,3,1,"H"
"2014-11-11",2014,"Dover Athletic","Braintree Town","1-0",1,0,5,5,1,1,"H"
"2014-11-11",2014,"Forest Green Rovers","Eastleigh","1-1",1,1,5,5,2,0,"D"
"2014-11-11",2014,"Gateshead","Lincoln City","3-3",3,3,5,5,6,0,"D"
"2014-11-11",2014,"Grimsby Town","Halifax Town","1-0",1,0,5,5,1,1,"H"
"2014-11-11",2014,"Macclesfield","Chester","3-1",3,1,5,5,4,2,"H"
"2014-11-12",2014,"Kidderminster Harriers","Aldershot","0-2",0,2,5,5,2,-2,"A"
"2014-11-12",2014,"Telford United","Altrincham","2-1",2,1,5,5,3,1,"H"
"2014-11-12",2014,"Woking","Wrexham","1-1",1,1,5,5,2,0,"D"
"2014-11-15",2014,"Aldershot","Nuneaton Town","1-0",1,0,5,5,1,1,"H"
"2014-11-15",2014,"Alfreton Town","Dover Athletic","2-3",2,3,5,5,5,-1,"A"
"2014-11-15",2014,"Altrincham","Grimsby Town","1-1",1,1,5,5,2,0,"D"
"2014-11-15",2014,"Barnet","Telford United","3-1",3,1,5,5,4,2,"H"
"2014-11-15",2014,"Braintree Town","Wrexham","1-0",1,0,5,5,1,1,"H"
"2014-11-15",2014,"Bristol Rovers","Kidderminster Harriers","1-1",1,1,5,5,2,0,"D"
"2014-11-15",2014,"Chester","Gateshead","1-0",1,0,5,5,1,1,"H"
"2014-11-15",2014,"Dartford","Southport","1-1",1,1,5,5,2,0,"D"
"2014-11-15",2014,"Torquay United","Forest Green Rovers","3-3",3,3,5,5,6,0,"D"
"2014-11-15",2014,"Welling United","Macclesfield","0-0",0,0,5,5,0,0,"D"
"2014-11-16",2014,"Halifax Town","Woking","1-3",1,3,5,5,4,-2,"A"
"2014-11-22",2014,"Aldershot","Eastleigh","0-2",0,2,5,5,2,-2,"A"
"2014-11-22",2014,"Chester","Bristol Rovers","2-2",2,2,5,5,4,0,"D"
"2014-11-22",2014,"Dover Athletic","Forest Green Rovers","0-0",0,0,5,5,0,0,"D"
"2014-11-22",2014,"Grimsby Town","Kidderminster Harriers","0-2",0,2,5,5,2,-2,"A"
"2014-11-22",2014,"Lincoln City","Dartford","1-0",1,0,5,5,1,1,"H"
"2014-11-22",2014,"Macclesfield","Alfreton Town","2-0",2,0,5,5,2,2,"H"
"2014-11-22",2014,"Nuneaton Town","Southport","2-3",2,3,5,5,5,-1,"A"
"2014-11-22",2014,"Telford United","Braintree Town","1-3",1,3,5,5,4,-2,"A"
"2014-11-22",2014,"Torquay United","Gateshead","2-2",2,2,5,5,4,0,"D"
"2014-11-22",2014,"Welling United","Halifax Town","2-1",2,1,5,5,3,1,"H"
"2014-11-22",2014,"Woking","Barnet","1-1",1,1,5,5,2,0,"D"
"2014-11-22",2014,"Wrexham","Altrincham","2-3",2,3,5,5,5,-1,"A"
"2014-11-25",2014,"Braintree Town","Welling United","0-1",0,1,5,5,1,-1,"A"
"2014-11-25",2014,"Bristol Rovers","Barnet","2-1",2,1,5,5,3,1,"H"
"2014-11-25",2014,"Dartford","Chester","2-4",2,4,5,5,6,-2,"A"
"2014-11-25",2014,"Dover Athletic","Nuneaton Town","5-0",5,0,5,5,5,5,"H"
"2014-11-25",2014,"Grimsby Town","Woking","3-1",3,1,5,5,4,2,"H"
"2014-11-25",2014,"Kidderminster Harriers","Wrexham","1-1",1,1,5,5,2,0,"D"
"2014-11-25",2014,"Macclesfield","Torquay United","1-0",1,0,5,5,1,1,"H"
"2014-11-25",2014,"Southport","Aldershot","1-3",1,3,5,5,4,-2,"A"
"2014-11-29",2014,"Altrincham","Kidderminster Harriers","2-1",2,1,5,5,3,1,"H"
"2014-11-29",2014,"Barnet","Macclesfield","3-1",3,1,5,5,4,2,"H"
"2014-11-29",2014,"Bristol Rovers","Welling United","2-0",2,0,5,5,2,2,"H"
"2014-11-29",2014,"Forest Green Rovers","Dartford","2-1",2,1,5,5,3,1,"H"
"2014-11-29",2014,"Gateshead","Dover Athletic","1-2",1,2,5,5,3,-1,"A"
"2014-11-29",2014,"Halifax Town","Alfreton Town","2-0",2,0,5,5,2,2,"H"
"2014-11-29",2014,"Lincoln City","Southport","1-0",1,0,5,5,1,1,"H"
"2014-11-29",2014,"Nuneaton Town","Chester","3-2",3,2,5,5,5,1,"H"
"2014-11-29",2014,"Telford United","Grimsby Town","1-1",1,1,5,5,2,0,"D"
"2014-11-29",2014,"Torquay United","Eastleigh","2-0",2,0,5,5,2,2,"H"
"2014-11-29",2014,"Woking","Braintree Town","1-0",1,0,5,5,1,1,"H"
"2014-11-29",2014,"Wrexham","Aldershot","3-1",3,1,5,5,4,2,"H"
"2014-12-02",2014,"Alfreton Town","Gateshead","1-2",1,2,5,5,3,-1,"A"
"2014-12-02",2014,"Chester","Telford United","2-0",2,0,5,5,2,2,"H"
"2014-12-02",2014,"Dover Athletic","Torquay United","2-2",2,2,5,5,4,0,"D"
"2014-12-02",2014,"Eastleigh","Dartford","2-0",2,0,5,5,2,2,"H"
"2014-12-02",2014,"Halifax Town","Forest Green Rovers","1-0",1,0,5,5,1,1,"H"
"2014-12-02",2014,"Kidderminster Harriers","Nuneaton Town","3-1",3,1,5,5,4,2,"H"
"2014-12-02",2014,"Woking","Altrincham","2-0",2,0,5,5,2,2,"H"
"2014-12-02",2014,"Wrexham","Bristol Rovers","0-0",0,0,5,5,0,0,"D"
"2014-12-06",2014,"Forest Green Rovers","Altrincham","1-1",1,1,5,5,2,0,"D"
"2014-12-06",2014,"Macclesfield","Woking","2-1",2,1,5,5,3,1,"H"
"2014-12-06",2014,"Nuneaton Town","Alfreton Town","0-1",0,1,5,5,1,-1,"A"
"2014-12-06",2014,"Torquay United","Barnet","1-2",1,2,5,5,3,-1,"A"
"2014-12-06",2014,"Welling United","Bristol Rovers","0-0",0,0,5,5,0,0,"D"
"2014-12-09",2014,"Forest Green Rovers","Woking","2-1",2,1,5,5,3,1,"H"
"2014-12-09",2014,"Lincoln City","Nuneaton Town","3-1",3,1,5,5,4,2,"H"
"2014-12-09",2014,"Telford United","Welling United","1-2",1,2,5,5,3,-1,"A"
"2014-12-09",2014,"Torquay United","Halifax Town","2-1",2,1,5,5,3,1,"H"
"2014-12-10",2014,"Aldershot","Macclesfield","0-1",0,1,5,5,1,-1,"A"
"2014-12-10",2014,"Alfreton Town","Eastleigh","3-2",3,2,5,5,5,1,"H"
"2014-12-10",2014,"Gateshead","Southport","1-1",1,1,5,5,2,0,"D"
"2014-12-19",2014,"Bristol Rovers","Gateshead","3-2",3,2,5,5,5,1,"H"
"2014-12-19",2014,"Grimsby Town","Forest Green Rovers","2-1",2,1,5,5,3,1,"H"
"2014-12-20",2014,"Alfreton Town","Macclesfield","1-5",1,5,5,5,6,-4,"A"
"2014-12-20",2014,"Altrincham","Dover Athletic","2-2",2,2,5,5,4,0,"D"
"2014-12-20",2014,"Barnet","Chester","3-0",3,0,5,5,3,3,"H"
"2014-12-20",2014,"Braintree Town","Torquay United","2-0",2,0,5,5,2,2,"H"
"2014-12-20",2014,"Halifax Town","Nuneaton Town","2-0",2,0,5,5,2,2,"H"
"2014-12-20",2014,"Kidderminster Harriers","Lincoln City","2-1",2,1,5,5,3,1,"H"
"2014-12-20",2014,"Telford United","Eastleigh","3-4",3,4,5,5,7,-1,"A"
"2014-12-20",2014,"Welling United","Aldershot","3-1",3,1,5,5,4,2,"H"
"2014-12-20",2014,"Woking","Southport","1-2",1,2,5,5,3,-1,"A"
"2014-12-20",2014,"Wrexham","Dartford","1-3",1,3,5,5,4,-2,"A"
"2014-12-26",2014,"Aldershot","Barnet","1-3",1,3,5,5,4,-2,"A"
"2014-12-26",2014,"Chester","Altrincham","0-2",0,2,5,5,2,-2,"A"
"2014-12-26",2014,"Dartford","Braintree Town","0-2",0,2,5,5,2,-2,"A"
"2014-12-26",2014,"Dover Athletic","Welling United","4-0",4,0,5,5,4,4,"H"
"2014-12-26",2014,"Eastleigh","Woking","2-2",2,2,5,5,4,0,"D"
"2014-12-26",2014,"Forest Green Rovers","Kidderminster Harriers","2-3",2,3,5,5,5,-1,"A"
"2014-12-26",2014,"Gateshead","Halifax Town","2-2",2,2,5,5,4,0,"D"
"2014-12-26",2014,"Lincoln City","Alfreton Town","3-2",3,2,5,5,5,1,"H"
"2014-12-26",2014,"Macclesfield","Grimsby Town","0-1",0,1,5,5,1,-1,"A"
"2014-12-26",2014,"Nuneaton Town","Telford United","4-4",4,4,5,5,8,0,"D"
"2014-12-26",2014,"Southport","Wrexham","0-1",0,1,5,5,1,-1,"A"
"2014-12-26",2014,"Torquay United","Bristol Rovers","1-2",1,2,5,5,3,-1,"A"
"2014-12-28",2014,"Altrincham","Nuneaton Town","0-1",0,1,5,5,1,-1,"A"
"2014-12-28",2014,"Barnet","Dover Athletic","2-2",2,2,5,5,4,0,"D"
"2014-12-28",2014,"Braintree Town","Eastleigh","1-5",1,5,5,5,6,-4,"A"
"2014-12-28",2014,"Bristol Rovers","Macclesfield","4-0",4,0,5,5,4,4,"H"
"2014-12-28",2014,"Grimsby Town","Lincoln City","1-3",1,3,5,5,4,-2,"A"
"2014-12-28",2014,"Halifax Town","Chester","0-2",0,2,5,5,2,-2,"A"
"2014-12-28",2014,"Kidderminster Harriers","Southport","0-1",0,1,5,5,1,-1,"A"
"2014-12-28",2014,"Welling United","Torquay United","0-0",0,0,5,5,0,0,"D"
"2014-12-28",2014,"Woking","Aldershot","1-2",1,2,5,5,3,-1,"A"
"2015-01-01",2014,"Altrincham","Chester","4-1",4,1,5,5,5,3,"H"
"2015-01-01",2014,"Barnet","Aldershot","1-0",1,0,5,5,1,1,"H"
"2015-01-01",2014,"Braintree Town","Dartford","3-0",3,0,5,5,3,3,"H"
"2015-01-01",2014,"Bristol Rovers","Torquay United","1-1",1,1,5,5,2,0,"D"
"2015-01-01",2014,"Grimsby Town","Macclesfield","1-2",1,2,5,5,3,-1,"A"
"2015-01-01",2014,"Kidderminster Harriers","Forest Green Rovers","2-4",2,4,5,5,6,-2,"A"
"2015-01-01",2014,"Telford United","Nuneaton Town","0-0",0,0,5,5,0,0,"D"
"2015-01-01",2014,"Welling United","Dover Athletic","0-2",0,2,5,5,2,-2,"A"
"2015-01-01",2014,"Woking","Eastleigh","1-1",1,1,5,5,2,0,"D"
"2015-01-04",2014,"Aldershot","Telford United","1-2",1,2,5,5,3,-1,"A"
"2015-01-04",2014,"Chester","Braintree Town","2-3",2,3,5,5,5,-1,"A"
"2015-01-04",2014,"Dartford","Kidderminster Harriers","1-2",1,2,5,5,3,-1,"A"
"2015-01-04",2014,"Eastleigh","Altrincham","0-2",0,2,5,5,2,-2,"A"
"2015-01-04",2014,"Forest Green Rovers","Welling United","4-1",4,1,5,5,5,3,"H"
"2015-01-04",2014,"Lincoln City","Barnet","4-1",4,1,5,5,5,3,"H"
"2015-01-04",2014,"Nuneaton Town","Bristol Rovers","0-2",0,2,5,5,2,-2,"A"
"2015-01-04",2014,"Torquay United","Alfreton Town","1-1",1,1,5,5,2,0,"D"
"2015-01-07",2014,"Gateshead","Woking","0-0",0,0,5,5,0,0,"D"
"2015-01-10",2014,"Eastleigh","Lincoln City","4-0",4,0,5,5,4,4,"H"
"2015-01-13",2014,"Dartford","Halifax Town","1-2",1,2,5,5,3,-1,"A"
"2015-01-17",2014,"Altrincham","Torquay United","2-1",2,1,5,5,3,1,"H"
"2015-01-17",2014,"Braintree Town","Forest Green Rovers","1-2",1,2,5,5,3,-1,"A"
"2015-01-17",2014,"Dover Athletic","Dartford","6-1",6,1,5,5,7,5,"H"
"2015-01-17",2014,"Grimsby Town","Barnet","3-1",3,1,5,5,4,2,"H"
"2015-01-17",2014,"Kidderminster Harriers","Macclesfield","0-2",0,2,5,5,2,-2,"A"
"2015-01-17",2014,"Lincoln City","Aldershot","3-0",3,0,5,5,3,3,"H"
"2015-01-17",2014,"Nuneaton Town","Gateshead","0-2",0,2,5,5,2,-2,"A"
"2015-01-17",2014,"Southport","Chester","0-0",0,0,5,5,0,0,"D"
"2015-01-17",2014,"Welling United","Alfreton Town","2-3",2,3,5,5,5,-1,"A"
"2015-01-17",2014,"Woking","Bristol Rovers","0-0",0,0,5,5,0,0,"D"
"2015-01-17",2014,"Wrexham","Telford United","0-4",0,4,5,5,4,-4,"A"
"2015-01-20",2014,"Aldershot","Kidderminster Harriers","0-1",0,1,5,5,1,-1,"A"
"2015-01-20",2014,"Dover Athletic","Wrexham","2-0",2,0,5,5,2,2,"H"
"2015-01-24",2014,"Barnet","Southport","4-0",4,0,5,5,4,4,"H"
"2015-01-24",2014,"Chester","Kidderminster Harriers","1-0",1,0,5,5,1,1,"H"
"2015-01-24",2014,"Macclesfield","Lincoln City","3-0",3,0,5,5,3,3,"H"
"2015-01-24",2014,"Nuneaton Town","Grimsby Town","0-2",0,2,5,5,2,-2,"A"
"2015-01-27",2014,"Chester","Lincoln City","4-0",4,0,5,5,4,4,"H"
"2015-01-27",2014,"Eastleigh","Grimsby Town","0-1",0,1,5,5,1,-1,"A"
"2015-01-27",2014,"Telford United","Halifax Town","0-1",0,1,5,5,1,-1,"A"
"2015-01-31",2014,"Dartford","Bristol Rovers","2-2",2,2,5,5,4,0,"D"
"2015-01-31",2014,"Forest Green Rovers","Nuneaton Town","1-0",1,0,5,5,1,1,"H"
"2015-01-31",2014,"Lincoln City","Dover Athletic","1-0",1,0,5,5,1,1,"H"
"2015-01-31",2014,"Southport","Gateshead","0-1",0,1,5,5,1,-1,"A"
"2015-01-31",2014,"Welling United","Chester","1-3",1,3,5,5,4,-2,"A"
"2015-01-31",2014,"Woking","Alfreton Town","3-0",3,0,5,5,3,3,"H"
"2015-01-31",2014,"Wrexham","Torquay United","0-0",0,0,5,5,0,0,"D"
"2015-02-07",2014,"Alfreton Town","Southport","4-2",4,2,5,5,6,2,"H"
"2015-02-07",2014,"Altrincham","Aldershot","1-0",1,0,5,5,1,1,"H"
"2015-02-07",2014,"Barnet","Woking","2-1",2,1,5,5,3,1,"H"
"2015-02-07",2014,"Bristol Rovers","Lincoln City","2-0",2,0,5,5,2,2,"H"
"2015-02-07",2014,"Eastleigh","Telford United","3-3",3,3,5,5,6,0,"D"
"2015-02-07",2014,"Forest Green Rovers","Grimsby Town","2-1",2,1,5,5,3,1,"H"
"2015-02-07",2014,"Macclesfield","Welling United","3-2",3,2,5,5,5,1,"H"
"2015-02-10",2014,"Alfreton Town","Forest Green Rovers","2-2",2,2,5,5,4,0,"D"
"2015-02-10",2014,"Macclesfield","Altrincham","2-1",2,1,5,5,3,1,"H"
"2015-02-10",2014,"Southport","Eastleigh","1-2",1,2,5,5,3,-1,"A"
"2015-02-14",2014,"Aldershot","Welling United","2-1",2,1,5,5,3,1,"H"
"2015-02-14",2014,"Altrincham","Forest Green Rovers","2-2",2,2,5,5,4,0,"D"
"2015-02-14",2014,"Braintree Town","Alfreton Town","2-1",2,1,5,5,3,1,"H"
"2015-02-14",2014,"Eastleigh","Torquay United","1-2",1,2,5,5,3,-1,"A"
"2015-02-14",2014,"Gateshead","Nuneaton Town","1-2",1,2,5,5,3,-1,"A"
"2015-02-14",2014,"Grimsby Town","Bristol Rovers","0-1",0,1,5,5,1,-1,"A"
"2015-02-14",2014,"Halifax Town","Dover Athletic","3-2",3,2,5,5,5,1,"H"
"2015-02-14",2014,"Kidderminster Harriers","Woking","1-1",1,1,5,5,2,0,"D"
"2015-02-14",2014,"Lincoln City","Chester","0-1",0,1,5,5,1,-1,"A"
"2015-02-14",2014,"Southport","Macclesfield","1-1",1,1,5,5,2,0,"D"
"2015-02-14",2014,"Telford United","Dartford","2-3",2,3,5,5,5,-1,"A"
"2015-02-14",2014,"Wrexham","Barnet","1-0",1,0,5,5,1,1,"H"
"2015-02-21",2014,"Alfreton Town","Aldershot","2-3",2,3,5,5,5,-1,"A"
"2015-02-21",2014,"Barnet","Grimsby Town","1-3",1,3,5,5,4,-2,"A"
"2015-02-21",2014,"Bristol Rovers","Altrincham","1-0",1,0,5,5,1,1,"H"
"2015-02-21",2014,"Chester","Eastleigh","0-1",0,1,5,5,1,-1,"A"
"2015-02-21",2014,"Dover Athletic","Southport","2-2",2,2,5,5,4,0,"D"
"2015-02-21",2014,"Forest Green Rovers","Telford United","3-0",3,0,5,5,3,3,"H"
"2015-02-21",2014,"Halifax Town","Braintree Town","1-0",1,0,5,5,1,1,"H"
"2015-02-21",2014,"Nuneaton Town","Kidderminster Harriers","0-0",0,0,5,5,0,0,"D"
"2015-02-24",2014,"Bristol Rovers","Braintree Town","2-1",2,1,5,5,3,1,"H"
"2015-02-24",2014,"Gateshead","Kidderminster Harriers","2-0",2,0,5,5,2,2,"H"
"2015-02-24",2014,"Grimsby Town","Telford United","1-0",1,0,5,5,1,1,"H"
"2015-02-24",2014,"Wrexham","Forest Green Rovers","0-0",0,0,5,5,0,0,"D"
"2015-02-28",2014,"Aldershot","Dartford","1-1",1,1,5,5,2,0,"D"
"2015-02-28",2014,"Altrincham","Barnet","1-3",1,3,5,5,4,-2,"A"
"2015-02-28",2014,"Eastleigh","Macclesfield","4-0",4,0,5,5,4,4,"H"
"2015-02-28",2014,"Forest Green Rovers","Southport","5-3",5,3,5,5,8,2,"H"
"2015-02-28",2014,"Gateshead","Bristol Rovers","0-1",0,1,5,5,1,-1,"A"
"2015-02-28",2014,"Grimsby Town","Braintree Town","1-0",1,0,5,5,1,1,"H"
"2015-02-28",2014,"Kidderminster Harriers","Halifax Town","0-0",0,0,5,5,0,0,"D"
"2015-02-28",2014,"Lincoln City","Woking","0-2",0,2,5,5,2,-2,"A"
"2015-02-28",2014,"Nuneaton Town","Welling United","1-0",1,0,5,5,1,1,"H"
"2015-02-28",2014,"Telford United","Alfreton Town","0-1",0,1,5,5,1,-1,"A"
"2015-03-03",2014,"Aldershot","Dover Athletic","3-1",3,1,5,5,4,2,"H"
"2015-03-03",2014,"Braintree Town","Macclesfield","0-1",0,1,5,5,1,-1,"A"
"2015-03-03",2014,"Dartford","Woking","1-3",1,3,5,5,4,-2,"A"
"2015-03-03",2014,"Gateshead","Wrexham","3-1",3,1,5,5,4,2,"H"
"2015-03-03",2014,"Southport","Halifax Town","1-0",1,0,5,5,1,1,"H"
"2015-03-07",2014,"Alfreton Town","Kidderminster Harriers","2-0",2,0,5,5,2,2,"H"
"2015-03-07",2014,"Barnet","Forest Green Rovers","1-3",1,3,5,5,4,-2,"A"
"2015-03-07",2014,"Braintree Town","Gateshead","1-0",1,0,5,5,1,1,"H"
"2015-03-07",2014,"Bristol Rovers","Eastleigh","1-2",1,2,5,5,3,-1,"A"
"2015-03-07",2014,"Dover Athletic","Lincoln City","1-2",1,2,5,5,3,-1,"A"
"2015-03-07",2014,"Halifax Town","Dartford","0-0",0,0,5,5,0,0,"D"
"2015-03-07",2014,"Macclesfield","Aldershot","0-0",0,0,5,5,0,0,"D"
"2015-03-07",2014,"Southport","Nuneaton Town","0-0",0,0,5,5,0,0,"D"
"2015-03-07",2014,"Torquay United","Telford United","0-1",0,1,5,5,1,-1,"A"
"2015-03-07",2014,"Woking","Grimsby Town","1-2",1,2,5,5,3,-1,"A"
"2015-03-07",2014,"Wrexham","Chester","1-0",1,0,5,5,1,1,"H"
"2015-03-08",2014,"Welling United","Altrincham","0-1",0,1,5,5,1,-1,"A"
"2015-03-10",2014,"Aldershot","Halifax Town","1-1",1,1,5,5,2,0,"D"
"2015-03-10",2014,"Gateshead","Welling United","1-1",1,1,5,5,2,0,"D"
"2015-03-10",2014,"Kidderminster Harriers","Eastleigh","1-3",1,3,5,5,4,-2,"A"
"2015-03-10",2014,"Macclesfield","Telford United","1-0",1,0,5,5,1,1,"H"
"2015-03-10",2014,"Torquay United","Chester","0-1",0,1,5,5,1,-1,"A"
"2015-03-10",2014,"Wrexham","Southport","0-0",0,0,5,5,0,0,"D"
"2015-03-14",2014,"Aldershot","Southport","1-2",1,2,5,5,3,-1,"A"
"2015-03-14",2014,"Altrincham","Wrexham","1-4",1,4,5,5,5,-3,"A"
"2015-03-14",2014,"Chester","Grimsby Town","2-2",2,2,5,5,4,0,"D"
"2015-03-14",2014,"Dartford","Alfreton Town","0-1",0,1,5,5,1,-1,"A"
"2015-03-14",2014,"Eastleigh","Barnet","1-2",1,2,5,5,3,-1,"A"
"2015-03-14",2014,"Forest Green Rovers","Braintree Town","1-1",1,1,5,5,2,0,"D"
"2015-03-14",2014,"Gateshead","Macclesfield","2-1",2,1,5,5,3,1,"H"
"2015-03-14",2014,"Halifax Town","Bristol Rovers","2-2",2,2,5,5,4,0,"D"
"2015-03-14",2014,"Kidderminster Harriers","Dover Athletic","0-2",0,2,5,5,2,-2,"A"
"2015-03-14",2014,"Lincoln City","Welling United","0-2",0,2,5,5,2,-2,"A"
"2015-03-14",2014,"Nuneaton Town","Torquay United","0-0",0,0,5,5,0,0,"D"
"2015-03-14",2014,"Telford United","Woking","1-3",1,3,5,5,4,-2,"A"
"2015-03-17",2014,"Alfreton Town","Lincoln City","0-0",0,0,5,5,0,0,"D"
"2015-03-17",2014,"Chester","Dartford","1-2",1,2,5,5,3,-1,"A"
"2015-03-17",2014,"Dover Athletic","Altrincham","2-1",2,1,5,5,3,1,"H"
"2015-03-17",2014,"Eastleigh","Wrexham","2-2",2,2,5,5,4,0,"D"
"2015-03-17",2014,"Halifax Town","Barnet","1-1",1,1,5,5,2,0,"D"
"2015-03-17",2014,"Telford United","Gateshead","0-1",0,1,5,5,1,-1,"A"
"2015-03-17",2014,"Torquay United","Braintree Town","1-5",1,5,5,5,6,-4,"A"
"2015-03-20",2014,"Bristol Rovers","Aldershot","3-1",3,1,5,5,4,2,"H"
"2015-03-21",2014,"Alfreton Town","Chester","1-1",1,1,5,5,2,0,"D"
"2015-03-21",2014,"Altrincham","Halifax Town","0-0",0,0,5,5,0,0,"D"
"2015-03-21",2014,"Barnet","Welling United","5-0",5,0,5,5,5,5,"H"
"2015-03-21",2014,"Dover Athletic","Gateshead","1-0",1,0,5,5,1,1,"H"
"2015-03-21",2014,"Grimsby Town","Eastleigh","2-1",2,1,5,5,3,1,"H"
"2015-03-21",2014,"Macclesfield","Nuneaton Town","0-1",0,1,5,5,1,-1,"A"
"2015-03-21",2014,"Southport","Dartford","2-0",2,0,5,5,2,2,"H"
"2015-03-21",2014,"Torquay United","Kidderminster Harriers","2-1",2,1,5,5,3,1,"H"
"2015-03-21",2014,"Woking","Forest Green Rovers","1-0",1,0,5,5,1,1,"H"
"2015-03-21",2014,"Wrexham","Lincoln City","1-1",1,1,5,5,2,0,"D"
"2015-03-24",2014,"Alfreton Town","Dartford","0-0",0,0,5,5,0,0,"D"
"2015-03-24",2014,"Braintree Town","Telford United","0-2",0,2,5,5,2,-2,"A"
"2015-03-24",2014,"Dover Athletic","Grimsby Town","0-1",0,1,5,5,1,-1,"A"
"2015-03-24",2014,"Halifax Town","Gateshead","2-2",2,2,5,5,4,0,"D"
"2015-03-24",2014,"Nuneaton Town","Wrexham","2-0",2,0,5,5,2,2,"H"
"2015-03-24",2014,"Woking","Torquay United","3-2",3,2,5,5,5,1,"H"
"2015-03-28",2014,"Alfreton Town","Barnet","1-1",1,1,5,5,2,0,"D"
"2015-03-28",2014,"Chester","Woking","2-3",2,3,5,5,5,-1,"A"
"2015-03-28",2014,"Dartford","Altrincham","1-2",1,2,5,5,3,-1,"A"
"2015-03-28",2014,"Dover Athletic","Telford United","1-0",1,0,5,5,1,1,"H"
"2015-03-28",2014,"Gateshead","Eastleigh","2-3",2,3,5,5,5,-1,"A"
"2015-03-28",2014,"Kidderminster Harriers","Braintree Town","3-1",3,1,5,5,4,2,"H"
"2015-03-28",2014,"Lincoln City","Forest Green Rovers","1-2",1,2,5,5,3,-1,"A"
"2015-03-28",2014,"Macclesfield","Bristol Rovers","0-0",0,0,5,5,0,0,"D"
"2015-03-28",2014,"Nuneaton Town","Halifax Town","1-2",1,2,5,5,3,-1,"A"
"2015-03-28",2014,"Southport","Torquay United","2-1",2,1,5,5,3,1,"H"
"2015-03-28",2014,"Welling United","Grimsby Town","0-2",0,2,5,5,2,-2,"A"
"2015-03-31",2014,"Dartford","Gateshead","1-1",1,1,5,5,2,0,"D"
"2015-03-31",2014,"Wrexham","Dover Athletic","1-1",1,1,5,5,2,0,"D"
"2015-04-03",2014,"Altrincham","Southport","2-0",2,0,5,5,2,2,"H"
"2015-04-03",2014,"Braintree Town","Lincoln City","1-3",1,3,5,5,4,-2,"A"
"2015-04-03",2014,"Bristol Rovers","Chester","5-1",5,1,5,5,6,4,"H"
"2015-04-03",2014,"Forest Green Rovers","Aldershot","1-3",1,3,5,5,4,-2,"A"
"2015-04-03",2014,"Halifax Town","Macclesfield","2-2",2,2,5,5,4,0,"D"
"2015-04-04",2014,"Barnet","Nuneaton Town","1-0",1,0,5,5,1,1,"H"
"2015-04-04",2014,"Eastleigh","Dover Athletic","0-1",0,1,5,5,1,-1,"A"
"2015-04-04",2014,"Grimsby Town","Gateshead","2-2",2,2,5,5,4,0,"D"
"2015-04-04",2014,"Telford United","Kidderminster Harriers","1-1",1,1,5,5,2,0,"D"
"2015-04-04",2014,"Torquay United","Dartford","1-1",1,1,5,5,2,0,"D"
"2015-04-04",2014,"Woking","Welling United","2-2",2,2,5,5,4,0,"D"
"2015-04-04",2014,"Wrexham","Alfreton Town","4-0",4,0,5,5,4,4,"H"
"2015-04-06",2014,"Aldershot","Torquay United","2-0",2,0,5,5,2,2,"H"
"2015-04-06",2014,"Alfreton Town","Grimsby Town","0-2",0,2,5,5,2,-2,"A"
"2015-04-06",2014,"Chester","Forest Green Rovers","1-4",1,4,5,5,5,-3,"A"
"2015-04-06",2014,"Dartford","Barnet","0-1",0,1,5,5,1,-1,"A"
"2015-04-06",2014,"Dover Athletic","Woking","2-1",2,1,5,5,3,1,"H"
"2015-04-06",2014,"Gateshead","Altrincham","1-0",1,0,5,5,1,1,"H"
"2015-04-06",2014,"Kidderminster Harriers","Bristol Rovers","0-3",0,3,5,5,3,-3,"A"
"2015-04-06",2014,"Lincoln City","Halifax Town","1-1",1,1,5,5,2,0,"D"
"2015-04-06",2014,"Macclesfield","Wrexham","2-2",2,2,5,5,4,0,"D"
"2015-04-06",2014,"Nuneaton Town","Braintree Town","0-1",0,1,5,5,1,-1,"A"
"2015-04-06",2014,"Southport","Telford United","0-3",0,3,5,5,3,-3,"A"
"2015-04-06",2014,"Welling United","Eastleigh","1-2",1,2,5,5,3,-1,"A"
"2015-04-11",2014,"Barnet","Halifax Town","3-0",3,0,5,5,3,3,"H"
"2015-04-11",2014,"Braintree Town","Aldershot","1-1",1,1,5,5,2,0,"D"
"2015-04-11",2014,"Bristol Rovers","Southport","2-0",2,0,5,5,2,2,"H"
"2015-04-11",2014,"Chester","Dover Athletic","3-1",3,1,5,5,4,2,"H"
"2015-04-11",2014,"Dartford","Nuneaton Town","3-1",3,1,5,5,4,2,"H"
"2015-04-11",2014,"Eastleigh","Alfreton Town","3-1",3,1,5,5,4,2,"H"
"2015-04-11",2014,"Forest Green Rovers","Macclesfield","3-1",3,1,5,5,4,2,"H"
"2015-04-11",2014,"Grimsby Town","Wrexham","0-1",0,1,5,5,1,-1,"A"
"2015-04-11",2014,"Telford United","Lincoln City","1-0",1,0,5,5,1,1,"H"
"2015-04-11",2014,"Torquay United","Altrincham","2-0",2,0,5,5,2,2,"H"
"2015-04-11",2014,"Welling United","Kidderminster Harriers","3-0",3,0,5,5,3,3,"H"
"2015-04-11",2014,"Woking","Gateshead","3-0",3,0,5,5,3,3,"H"
"2015-04-14",2014,"Halifax Town","Eastleigh","0-2",0,2,5,5,2,-2,"A"
"2015-04-14",2014,"Southport","Braintree Town","0-2",0,2,5,5,2,-2,"A"
"2015-04-14",2014,"Torquay United","Lincoln City","1-0",1,0,5,5,1,1,"H"
"2015-04-14",2014,"Welling United","Wrexham","2-1",2,1,5,5,3,1,"H"
"2015-04-18",2014,"Aldershot","Chester","0-1",0,1,5,5,1,-1,"A"
"2015-04-18",2014,"Alfreton Town","Welling United","2-2",2,2,5,5,4,0,"D"
"2015-04-18",2014,"Altrincham","Telford United","1-2",1,2,5,5,3,-1,"A"
"2015-04-18",2014,"Dover Athletic","Bristol Rovers","1-1",1,1,5,5,2,0,"D"
"2015-04-18",2014,"Gateshead","Forest Green Rovers","2-4",2,4,5,5,6,-2,"A"
"2015-04-18",2014,"Halifax Town","Torquay United","0-2",0,2,5,5,2,-2,"A"
"2015-04-18",2014,"Kidderminster Harriers","Barnet","1-1",1,1,5,5,2,0,"D"
"2015-04-18",2014,"Lincoln City","Eastleigh","1-2",1,2,5,5,3,-1,"A"
"2015-04-18",2014,"Macclesfield","Dartford","2-0",2,0,5,5,2,2,"H"
"2015-04-18",2014,"Nuneaton Town","Woking","1-1",1,1,5,5,2,0,"D"
"2015-04-18",2014,"Southport","Grimsby Town","2-2",2,2,5,5,4,0,"D"
"2015-04-18",2014,"Wrexham","Braintree Town","3-0",3,0,5,5,3,3,"H"
"2015-04-21",2014,"Aldershot","Wrexham","1-1",1,1,5,5,2,0,"D"
"2015-04-25",2014,"Barnet","Gateshead","2-0",2,0,5,5,2,2,"H"
"2015-04-25",2014,"Braintree Town","Altrincham","4-2",4,2,5,5,6,2,"H"
"2015-04-25",2014,"Bristol Rovers","Alfreton Town","7-0",7,0,5,5,7,7,"H"
"2015-04-25",2014,"Chester","Nuneaton Town","5-3",5,3,5,5,8,2,"H"
"2015-04-25",2014,"Dartford","Lincoln City","0-0",0,0,5,5,0,0,"D"
"2015-04-25",2014,"Eastleigh","Kidderminster Harriers","2-1",2,1,5,5,3,1,"H"
"2015-04-25",2014,"Forest Green Rovers","Dover Athletic","0-0",0,0,5,5,0,0,"D"
"2015-04-25",2014,"Grimsby Town","Aldershot","3-1",3,1,5,5,4,2,"H"
"2015-04-25",2014,"Telford United","Wrexham","1-2",1,2,5,5,3,-1,"A"
"2015-04-25",2014,"Torquay United","Macclesfield","1-1",1,1,5,5,2,0,"D"
"2015-04-25",2014,"Welling United","Southport","0-1",0,1,5,5,1,-1,"A"
"2015-04-25",2014,"Woking","Halifax Town","3-2",3,2,5,5,5,1,"H"
"2015-08-08",2015,"Aldershot","Gateshead","1-2",1,2,5,5,3,-1,"A"
"2015-08-08",2015,"Altrincham","Forest Green Rovers","0-1",0,1,5,5,1,-1,"A"
"2015-08-08",2015,"Barrow","Dover Athletic","2-1",2,1,5,5,3,1,"H"
"2015-08-08",2015,"Boreham Wood","Halifax Town","3-1",3,1,5,5,4,2,"H"
"2015-08-08",2015,"Bromley","Wrexham","3-1",3,1,5,5,4,2,"H"
"2015-08-08",2015,"Chester","Braintree Town","1-0",1,0,5,5,1,1,"H"
"2015-08-08",2015,"Kidderminster Harriers","Grimsby Town","2-2",2,2,5,5,4,0,"D"
"2015-08-08",2015,"Lincoln City","Cheltenham","1-1",1,1,5,5,2,0,"D"
"2015-08-08",2015,"Southport","Eastleigh","0-4",0,4,5,5,4,-4,"A"
"2015-08-08",2015,"Torquay United","Macclesfield","1-0",1,0,5,5,1,1,"H"
"2015-08-08",2015,"Tranmere Rovers","Woking","1-0",1,0,5,5,1,1,"H"
"2015-08-08",2015,"Welling United","Guiseley","1-0",1,0,5,5,1,1,"H"
"2015-08-11",2015,"Braintree Town","Lincoln City","1-3",1,3,5,5,4,-2,"A"
"2015-08-11",2015,"Cheltenham","Aldershot","0-0",0,0,5,5,0,0,"D"
"2015-08-11",2015,"Dover Athletic","Kidderminster Harriers","3-2",3,2,5,5,5,1,"H"
"2015-08-11",2015,"Eastleigh","Boreham Wood","1-0",1,0,5,5,1,1,"H"
"2015-08-11",2015,"Forest Green Rovers","Welling United","1-0",1,0,5,5,1,1,"H"
"2015-08-11",2015,"Gateshead","Tranmere Rovers","1-4",1,4,5,5,5,-3,"A"
"2015-08-11",2015,"Grimsby Town","Barrow","4-1",4,1,5,5,5,3,"H"
"2015-08-11",2015,"Guiseley","Altrincham","1-0",1,0,5,5,1,1,"H"
"2015-08-11",2015,"Halifax Town","Chester","0-1",0,1,5,5,1,-1,"A"
"2015-08-11",2015,"Macclesfield","Southport","0-0",0,0,5,5,0,0,"D"
"2015-08-11",2015,"Woking","Bromley","2-0",2,0,5,5,2,2,"H"
"2015-08-11",2015,"Wrexham","Torquay United","3-1",3,1,5,5,4,2,"H"
"2015-08-15",2015,"Braintree Town","Tranmere Rovers","0-0",0,0,5,5,0,0,"D"
"2015-08-15",2015,"Cheltenham","Southport","3-0",3,0,5,5,3,3,"H"
"2015-08-15",2015,"Dover Athletic","Chester","0-0",0,0,5,5,0,0,"D"
"2015-08-15",2015,"Eastleigh","Lincoln City","1-1",1,1,5,5,2,0,"D"
"2015-08-15",2015,"Forest Green Rovers","Barrow","4-0",4,0,5,5,4,4,"H"
"2015-08-15",2015,"Gateshead","Boreham Wood","2-1",2,1,5,5,3,1,"H"
"2015-08-15",2015,"Grimsby Town","Bromley","4-1",4,1,5,5,5,3,"H"
"2015-08-15",2015,"Guiseley","Kidderminster Harriers","1-0",1,0,5,5,1,1,"H"
"2015-08-15",2015,"Halifax Town","Torquay United","2-3",2,3,5,5,5,-1,"A"
"2015-08-15",2015,"Macclesfield","Welling United","2-1",2,1,5,5,3,1,"H"
"2015-08-15",2015,"Woking","Altrincham","2-0",2,0,5,5,2,2,"H"
"2015-08-15",2015,"Wrexham","Aldershot","3-0",3,0,5,5,3,3,"H"
"2015-08-18",2015,"Aldershot","Dover Athletic","1-1",1,1,5,5,2,0,"D"
"2015-08-18",2015,"Altrincham","Grimsby Town","2-1",2,1,5,5,3,1,"H"
"2015-08-18",2015,"Barrow","Guiseley","1-1",1,1,5,5,2,0,"D"
"2015-08-18",2015,"Boreham Wood","Forest Green Rovers","0-1",0,1,5,5,1,-1,"A"
"2015-08-18",2015,"Bromley","Braintree Town","1-2",1,2,5,5,3,-1,"A"
"2015-08-18",2015,"Chester","Cheltenham","1-1",1,1,5,5,2,0,"D"
"2015-08-18",2015,"Kidderminster Harriers","Wrexham","1-3",1,3,5,5,4,-2,"A"
"2015-08-18",2015,"Lincoln City","Macclesfield","5-3",5,3,5,5,8,2,"H"
"2015-08-18",2015,"Southport","Gateshead","1-2",1,2,5,5,3,-1,"A"
"2015-08-18",2015,"Torquay United","Woking","0-1",0,1,5,5,1,-1,"A"
"2015-08-18",2015,"Tranmere Rovers","Halifax Town","1-0",1,0,5,5,1,1,"H"
"2015-08-18",2015,"Welling United","Eastleigh","2-2",2,2,5,5,4,0,"D"
"2015-08-22",2015,"Braintree Town","Southport","1-0",1,0,5,5,1,1,"H"
"2015-08-22",2015,"Cheltenham","Barrow","2-1",2,1,5,5,3,1,"H"
"2015-08-22",2015,"Dover Athletic","Altrincham","2-1",2,1,5,5,3,1,"H"
"2015-08-22",2015,"Eastleigh","Macclesfield","1-0",1,0,5,5,1,1,"H"
"2015-08-22",2015,"Forest Green Rovers","Lincoln City","3-1",3,1,5,5,4,2,"H"
"2015-08-22",2015,"Gateshead","Kidderminster Harriers","1-1",1,1,5,5,2,0,"D"
"2015-08-22",2015,"Grimsby Town","Torquay United","2-2",2,2,5,5,4,0,"D"
"2015-08-22",2015,"Guiseley","Aldershot","0-4",0,4,5,5,4,-4,"A"
"2015-08-22",2015,"Halifax Town","Bromley","2-2",2,2,5,5,4,0,"D"
"2015-08-22",2015,"Tranmere Rovers","Boreham Wood","0-2",0,2,5,5,2,-2,"A"
"2015-08-22",2015,"Woking","Chester","5-2",5,2,5,5,7,3,"H"
"2015-08-22",2015,"Wrexham","Welling United","1-0",1,0,5,5,1,1,"H"
"2015-08-29",2015,"Aldershot","Eastleigh","1-2",1,2,5,5,3,-1,"A"
"2015-08-29",2015,"Altrincham","Tranmere Rovers","2-1",2,1,5,5,3,1,"H"
"2015-08-29",2015,"Barrow","Southport","1-0",1,0,5,5,1,1,"H"
"2015-08-29",2015,"Boreham Wood","Woking","1-1",1,1,5,5,2,0,"D"
"2015-08-29",2015,"Bromley","Dover Athletic","1-1",1,1,5,5,2,0,"D"
"2015-08-29",2015,"Guiseley","Gateshead","0-2",0,2,5,5,2,-2,"A"
"2015-08-29",2015,"Kidderminster Harriers","Forest Green Rovers","0-2",0,2,5,5,2,-2,"A"
"2015-08-29",2015,"Lincoln City","Grimsby Town","1-1",1,1,5,5,2,0,"D"
"2015-08-29",2015,"Macclesfield","Chester","1-2",1,2,5,5,3,-1,"A"
"2015-08-29",2015,"Torquay United","Cheltenham","0-3",0,3,5,5,3,-3,"A"
"2015-08-29",2015,"Welling United","Braintree Town","1-2",1,2,5,5,3,-1,"A"
"2015-08-29",2015,"Wrexham","Halifax Town","3-1",3,1,5,5,4,2,"H"
"2015-08-31",2015,"Braintree Town","Aldershot","1-2",1,2,5,5,3,-1,"A"
"2015-08-31",2015,"Cheltenham","Wrexham","2-1",2,1,5,5,3,1,"H"
"2015-08-31",2015,"Chester","Guiseley","1-1",1,1,5,5,2,0,"D"
"2015-08-31",2015,"Dover Athletic","Boreham Wood","2-1",2,1,5,5,3,1,"H"
"2015-08-31",2015,"Eastleigh","Torquay United","3-2",3,2,5,5,5,1,"H"
"2015-08-31",2015,"Forest Green Rovers","Bromley","2-1",2,1,5,5,3,1,"H"
"2015-08-31",2015,"Gateshead","Lincoln City","2-0",2,0,5,5,2,2,"H"
"2015-08-31",2015,"Grimsby Town","Macclesfield","0-2",0,2,5,5,2,-2,"A"
"2015-08-31",2015,"Halifax Town","Barrow","3-1",3,1,5,5,4,2,"H"
"2015-08-31",2015,"Southport","Altrincham","3-0",3,0,5,5,3,3,"H"
"2015-08-31",2015,"Tranmere Rovers","Kidderminster Harriers","2-2",2,2,5,5,4,0,"D"
"2015-08-31",2015,"Woking","Welling United","2-0",2,0,5,5,2,2,"H"
"2015-09-05",2015,"Aldershot","Halifax Town","3-2",3,2,5,5,5,1,"H"
"2015-09-05",2015,"Altrincham","Cheltenham","2-1",2,1,5,5,3,1,"H"
"2015-09-05",2015,"Barrow","Eastleigh","1-0",1,0,5,5,1,1,"H"
"2015-09-05",2015,"Boreham Wood","Grimsby Town","1-3",1,3,5,5,4,-2,"A"
"2015-09-05",2015,"Bromley","Gateshead","3-0",3,0,5,5,3,3,"H"
"2015-09-05",2015,"Chester","Forest Green Rovers","1-2",1,2,5,5,3,-1,"A"
"2015-09-05",2015,"Kidderminster Harriers","Braintree Town","0-1",0,1,5,5,1,-1,"A"
"2015-09-05",2015,"Lincoln City","Wrexham","1-1",1,1,5,5,2,0,"D"
"2015-09-05",2015,"Macclesfield","Woking","2-1",2,1,5,5,3,1,"H"
"2015-09-05",2015,"Southport","Dover Athletic","0-0",0,0,5,5,0,0,"D"
"2015-09-05",2015,"Torquay United","Guiseley","1-1",1,1,5,5,2,0,"D"
"2015-09-05",2015,"Welling United","Tranmere Rovers","1-1",1,1,5,5,2,0,"D"
"2015-09-12",2015,"Braintree Town","Barrow","1-1",1,1,5,5,2,0,"D"
"2015-09-12",2015,"Bromley","Macclesfield","1-0",1,0,5,5,1,1,"H"
"2015-09-12",2015,"Cheltenham","Dover Athletic","3-2",3,2,5,5,5,1,"H"
"2015-09-12",2015,"Eastleigh","Gateshead","1-2",1,2,5,5,3,-1,"A"
"2015-09-12",2015,"Forest Green Rovers","Southport","2-1",2,1,5,5,3,1,"H"
"2015-09-12",2015,"Grimsby Town","Aldershot","4-1",4,1,5,5,5,3,"H"
"2015-09-12",2015,"Guiseley","Woking","4-4",4,4,5,5,8,0,"D"
"2015-09-12",2015,"Halifax Town","Kidderminster Harriers","1-1",1,1,5,5,2,0,"D"
"2015-09-12",2015,"Lincoln City","Boreham Wood","3-1",3,1,5,5,4,2,"H"
"2015-09-12",2015,"Tranmere Rovers","Chester","2-0",2,0,5,5,2,2,"H"
"2015-09-12",2015,"Welling United","Torquay United","1-1",1,1,5,5,2,0,"D"
"2015-09-12",2015,"Wrexham","Altrincham","3-1",3,1,5,5,4,2,"H"
"2015-09-15",2015,"Aldershot","Welling United","1-0",1,0,5,5,1,1,"H"
"2015-09-15",2015,"Altrincham","Eastleigh","1-1",1,1,5,5,2,0,"D"
"2015-09-15",2015,"Barrow","Lincoln City","1-0",1,0,5,5,1,1,"H"
"2015-09-15",2015,"Boreham Wood","Bromley","2-3",2,3,5,5,5,-1,"A"
"2015-09-15",2015,"Cheltenham","Macclesfield","2-0",2,0,5,5,2,2,"H"
"2015-09-15",2015,"Chester","Grimsby Town","1-1",1,1,5,5,2,0,"D"
"2015-09-15",2015,"Dover Athletic","Braintree Town","0-0",0,0,5,5,0,0,"D"
"2015-09-15",2015,"Gateshead","Wrexham","2-1",2,1,5,5,3,1,"H"
"2015-09-15",2015,"Guiseley","Halifax Town","2-1",2,1,5,5,3,1,"H"
"2015-09-15",2015,"Kidderminster Harriers","Torquay United","2-2",2,2,5,5,4,0,"D"
"2015-09-15",2015,"Southport","Tranmere Rovers","2-2",2,2,5,5,4,0,"D"
"2015-09-15",2015,"Woking","Forest Green Rovers","2-1",2,1,5,5,3,1,"H"
"2015-09-18",2015,"Grimsby Town","Tranmere Rovers","1-1",1,1,5,5,2,0,"D"
"2015-09-19",2015,"Altrincham","Braintree Town","0-4",0,4,5,5,4,-4,"A"
"2015-09-19",2015,"Barrow","Aldershot","1-3",1,3,5,5,4,-2,"A"
"2015-09-19",2015,"Boreham Wood","Wrexham","0-1",0,1,5,5,1,-1,"A"
"2015-09-19",2015,"Chester","Eastleigh","1-0",1,0,5,5,1,1,"H"
"2015-09-19",2015,"Dover Athletic","Guiseley","0-0",0,0,5,5,0,0,"D"
"2015-09-19",2015,"Gateshead","Welling United","1-2",1,2,5,5,3,-1,"A"
"2015-09-19",2015,"Halifax Town","Southport","2-2",2,2,5,5,4,0,"D"
"2015-09-19",2015,"Kidderminster Harriers","Lincoln City","0-2",0,2,5,5,2,-2,"A"
"2015-09-19",2015,"Macclesfield","Forest Green Rovers","4-1",4,1,5,5,5,3,"H"
"2015-09-19",2015,"Torquay United","Bromley","3-7",3,7,5,5,10,-4,"A"
"2015-09-19",2015,"Woking","Cheltenham","0-1",0,1,5,5,1,-1,"A"
"2015-09-22",2015,"Braintree Town","Woking","2-1",2,1,5,5,3,1,"H"
"2015-09-22",2015,"Bromley","Kidderminster Harriers","3-2",3,2,5,5,5,1,"H"
"2015-09-22",2015,"Eastleigh","Dover Athletic","2-5",2,5,5,5,7,-3,"A"
"2015-09-22",2015,"Forest Green Rovers","Cheltenham","2-2",2,2,5,5,4,0,"D"
"2015-09-22",2015,"Guiseley","Southport","1-1",1,1,5,5,2,0,"D"
"2015-09-22",2015,"Halifax Town","Gateshead","1-1",1,1,5,5,2,0,"D"
"2015-09-22",2015,"Lincoln City","Altrincham","1-1",1,1,5,5,2,0,"D"
"2015-09-22",2015,"Macclesfield","Barrow","1-2",1,2,5,5,3,-1,"A"
"2015-09-22",2015,"Torquay United","Boreham Wood","1-2",1,2,5,5,3,-1,"A"
"2015-09-22",2015,"Tranmere Rovers","Aldershot","3-1",3,1,5,5,4,2,"H"
"2015-09-22",2015,"Welling United","Chester","2-1",2,1,5,5,3,1,"H"
"2015-09-22",2015,"Wrexham","Grimsby Town","0-0",0,0,5,5,0,0,"D"
"2015-09-25",2015,"Dover Athletic","Woking","2-0",2,0,5,5,2,2,"H"
"2015-09-26",2015,"Aldershot","Macclesfield","0-3",0,3,5,5,3,-3,"A"
"2015-09-26",2015,"Barrow","Kidderminster Harriers","1-1",1,1,5,5,2,0,"D"
"2015-09-26",2015,"Boreham Wood","Altrincham","0-1",0,1,5,5,1,-1,"A"
"2015-09-26",2015,"Braintree Town","Guiseley","0-1",0,1,5,5,1,-1,"A"
"2015-09-26",2015,"Bromley","Chester","3-0",3,0,5,5,3,3,"H"
"2015-09-26",2015,"Cheltenham","Tranmere Rovers","0-1",0,1,5,5,1,-1,"A"
"2015-09-26",2015,"Forest Green Rovers","Gateshead","0-1",0,1,5,5,1,-1,"A"
"2015-09-26",2015,"Lincoln City","Torquay United","2-0",2,0,5,5,2,2,"H"
"2015-09-26",2015,"Southport","Grimsby Town","0-4",0,4,5,5,4,-4,"A"
"2015-09-26",2015,"Welling United","Halifax Town","2-0",2,0,5,5,2,2,"H"
"2015-09-26",2015,"Wrexham","Eastleigh","2-3",2,3,5,5,5,-1,"A"
"2015-10-02",2015,"Guiseley","Lincoln City","0-1",0,1,5,5,1,-1,"A"
"2015-10-03",2015,"Altrincham","Barrow","1-0",1,0,5,5,1,1,"H"
"2015-10-03",2015,"Chester","Wrexham","3-2",3,2,5,5,5,1,"H"
"2015-10-03",2015,"Eastleigh","Braintree Town","0-2",0,2,5,5,2,-2,"A"
"2015-10-03",2015,"Gateshead","Dover Athletic","2-3",2,3,5,5,5,-1,"A"
"2015-10-03",2015,"Grimsby Town","Forest Green Rovers","1-1",1,1,5,5,2,0,"D"
"2015-10-03",2015,"Halifax Town","Cheltenham","1-7",1,7,5,5,8,-6,"A"
"2015-10-03",2015,"Kidderminster Harriers","Welling United","0-1",0,1,5,5,1,-1,"A"
"2015-10-03",2015,"Macclesfield","Boreham Wood","0-0",0,0,5,5,0,0,"D"
"2015-10-03",2015,"Torquay United","Aldershot","0-2",0,2,5,5,2,-2,"A"
"2015-10-03",2015,"Tranmere Rovers","Bromley","4-0",4,0,5,5,4,4,"H"
"2015-10-03",2015,"Woking","Southport","1-2",1,2,5,5,3,-1,"A"
"2015-10-06",2015,"Altrincham","Halifax Town","1-3",1,3,5,5,4,-2,"A"
"2015-10-06",2015,"Barrow","Chester","3-2",3,2,5,5,5,1,"H"
"2015-10-06",2015,"Cheltenham","Braintree Town","1-1",1,1,5,5,2,0,"D"
"2015-10-06",2015,"Grimsby Town","Gateshead","2-1",2,1,5,5,3,1,"H"
"2015-10-06",2015,"Guiseley","Macclesfield","0-3",0,3,5,5,3,-3,"A"
"2015-10-06",2015,"Kidderminster Harriers","Boreham Wood","1-1",1,1,5,5,2,0,"D"
"2015-10-06",2015,"Torquay United","Dover Athletic","2-3",2,3,5,5,5,-1,"A"
"2015-10-06",2015,"Welling United","Bromley","1-2",1,2,5,5,3,-1,"A"
"2015-10-06",2015,"Wrexham","Tranmere Rovers","2-2",2,2,5,5,4,0,"D"
"2015-10-07",2015,"Aldershot","Forest Green Rovers","0-3",0,3,5,5,3,-3,"A"
"2015-10-10",2015,"Aldershot","Altrincham","2-0",2,0,5,5,2,2,"H"
"2015-10-10",2015,"Boreham Wood","Welling United","2-0",2,0,5,5,2,2,"H"
"2015-10-10",2015,"Braintree Town","Grimsby Town","0-0",0,0,5,5,0,0,"D"
"2015-10-10",2015,"Bromley","Barrow","5-0",5,0,5,5,5,5,"H"
"2015-10-10",2015,"Chester","Lincoln City","2-3",2,3,5,5,5,-1,"A"
"2015-10-10",2015,"Dover Athletic","Wrexham","2-1",2,1,5,5,3,1,"H"
"2015-10-10",2015,"Forest Green Rovers","Guiseley","3-0",3,0,5,5,3,3,"H"
"2015-10-10",2015,"Gateshead","Cheltenham","1-1",1,1,5,5,2,0,"D"
"2015-10-10",2015,"Halifax Town","Woking","0-3",0,3,5,5,3,-3,"A"
"2015-10-10",2015,"Macclesfield","Kidderminster Harriers","2-1",2,1,5,5,3,1,"H"
"2015-10-10",2015,"Southport","Torquay United","0-1",0,1,5,5,1,-1,"A"
"2015-10-10",2015,"Tranmere Rovers","Eastleigh","1-2",1,2,5,5,3,-1,"A"
"2015-10-13",2015,"Altrincham","Kidderminster Harriers","2-2",2,2,5,5,4,0,"D"
"2015-10-13",2015,"Boreham Wood","Aldershot","0-1",0,1,5,5,1,-1,"A"
"2015-10-13",2015,"Braintree Town","Dover Athletic","1-0",1,0,5,5,1,1,"H"
"2015-10-13",2015,"Bromley","Cheltenham","1-2",1,2,5,5,3,-1,"A"
"2015-10-13",2015,"Eastleigh","Forest Green Rovers","3-2",3,2,5,5,5,1,"H"
"2015-10-13",2015,"Grimsby Town","Halifax Town","7-0",7,0,5,5,7,7,"H"
"2015-10-13",2015,"Macclesfield","Gateshead","1-0",1,0,5,5,1,1,"H"
"2015-10-13",2015,"Southport","Chester","1-2",1,2,5,5,3,-1,"A"
"2015-10-13",2015,"Tranmere Rovers","Barrow","0-1",0,1,5,5,1,-1,"A"
"2015-10-13",2015,"Welling United","Lincoln City","2-1",2,1,5,5,3,1,"H"
"2015-10-13",2015,"Woking","Torquay United","2-2",2,2,5,5,4,0,"D"
"2015-10-14",2015,"Wrexham","Guiseley","3-3",3,3,5,5,6,0,"D"
"2015-10-17",2015,"Aldershot","Bromley","1-1",1,1,5,5,2,0,"D"
"2015-10-17",2015,"Barrow","Welling United","1-1",1,1,5,5,2,0,"D"
"2015-10-17",2015,"Cheltenham","Eastleigh","1-1",1,1,5,5,2,0,"D"
"2015-10-17",2015,"Chester","Halifax Town","2-1",2,1,5,5,3,1,"H"
"2015-10-17",2015,"Dover Athletic","Macclesfield","2-1",2,1,5,5,3,1,"H"
"2015-10-17",2015,"Forest Green Rovers","Tranmere Rovers","0-2",0,2,5,5,2,-2,"A"
"2015-10-17",2015,"Gateshead","Altrincham","2-2",2,2,5,5,4,0,"D"
"2015-10-17",2015,"Guiseley","Boreham Wood","1-1",1,1,5,5,2,0,"D"
"2015-10-17",2015,"Kidderminster Harriers","Southport","0-1",0,1,5,5,1,-1,"A"
"2015-10-17",2015,"Lincoln City","Braintree Town","2-0",2,0,5,5,2,2,"H"
"2015-10-17",2015,"Torquay United","Grimsby Town","1-1",1,1,5,5,2,0,"D"
"2015-10-17",2015,"Woking","Wrexham","0-1",0,1,5,5,1,-1,"A"
"2015-10-30",2015,"Grimsby Town","Cheltenham","0-1",0,1,5,5,1,-1,"A"
"2015-10-31",2015,"Altrincham","Torquay United","1-1",1,1,5,5,2,0,"D"
"2015-10-31",2015,"Boreham Wood","Gateshead","2-3",2,3,5,5,5,-1,"A"
"2015-10-31",2015,"Braintree Town","Macclesfield","1-0",1,0,5,5,1,1,"H"
"2015-10-31",2015,"Eastleigh","Halifax Town","2-1",2,1,5,5,3,1,"H"
"2015-10-31",2015,"Forest Green Rovers","Chester","2-1",2,1,5,5,3,1,"H"
"2015-10-31",2015,"Guiseley","Welling United","2-0",2,0,5,5,2,2,"H"
"2015-10-31",2015,"Kidderminster Harriers","Woking","1-0",1,0,5,5,1,1,"H"
"2015-10-31",2015,"Lincoln City","Bromley","0-1",0,1,5,5,1,-1,"A"
"2015-10-31",2015,"Southport","Aldershot","1-1",1,1,5,5,2,0,"D"
"2015-10-31",2015,"Tranmere Rovers","Dover Athletic","0-1",0,1,5,5,1,-1,"A"
"2015-10-31",2015,"Wrexham","Barrow","4-1",4,1,5,5,5,3,"H"
"2015-11-07",2015,"Guiseley","Barrow","3-1",3,1,5,5,4,2,"H"
"2015-11-10",2015,"Barrow","Grimsby Town","1-3",1,3,5,5,4,-2,"A"
"2015-11-10",2015,"Bromley","Boreham Wood","1-2",1,2,5,5,3,-1,"A"
"2015-11-10",2015,"Cheltenham","Guiseley","5-0",5,0,5,5,5,5,"H"
"2015-11-10",2015,"Chester","Kidderminster Harriers","3-1",3,1,5,5,4,2,"H"
"2015-11-10",2015,"Dover Athletic","Eastleigh","1-2",1,2,5,5,3,-1,"A"
"2015-11-10",2015,"Macclesfield","Altrincham","3-0",3,0,5,5,3,3,"H"
"2015-11-10",2015,"Welling United","Forest Green Rovers","1-1",1,1,5,5,2,0,"D"
"2015-11-10",2015,"Woking","Braintree Town","1-1",1,1,5,5,2,0,"D"
"2015-11-11",2015,"Aldershot","Lincoln City","1-2",1,2,5,5,3,-1,"A"
"2015-11-14",2015,"Barrow","Torquay United","4-0",4,0,5,5,4,4,"H"
"2015-11-14",2015,"Boreham Wood","Chester","0-0",0,0,5,5,0,0,"D"
"2015-11-14",2015,"Bromley","Altrincham","1-3",1,3,5,5,4,-2,"A"
"2015-11-14",2015,"Forest Green Rovers","Dover Athletic","3-1",3,1,5,5,4,2,"H"
"2015-11-14",2015,"Grimsby Town","Welling United","3-1",3,1,5,5,4,2,"H"
"2015-11-14",2015,"Guiseley","Eastleigh","1-4",1,4,5,5,5,-3,"A"
"2015-11-14",2015,"Halifax Town","Braintree Town","3-6",3,6,5,5,9,-3,"A"
"2015-11-14",2015,"Kidderminster Harriers","Aldershot","2-0",2,0,5,5,2,2,"H"
"2015-11-14",2015,"Lincoln City","Tranmere Rovers","1-0",1,0,5,5,1,1,"H"
"2015-11-14",2015,"Southport","Cheltenham","0-4",0,4,5,5,4,-4,"A"
"2015-11-14",2015,"Woking","Macclesfield","2-5",2,5,5,5,7,-3,"A"
"2015-11-14",2015,"Wrexham","Gateshead","4-0",4,0,5,5,4,4,"H"
"2015-11-21",2015,"Aldershot","Wrexham","0-1",0,1,5,5,1,-1,"A"
"2015-11-21",2015,"Altrincham","Boreham Wood","1-0",1,0,5,5,1,1,"H"
"2015-11-21",2015,"Cheltenham","Forest Green Rovers","1-1",1,1,5,5,2,0,"D"
"2015-11-21",2015,"Chester","Woking","1-2",1,2,5,5,3,-1,"A"
"2015-11-21",2015,"Dover Athletic","Barrow","3-1",3,1,5,5,4,2,"H"
"2015-11-21",2015,"Eastleigh","Grimsby Town","0-1",0,1,5,5,1,-1,"A"
"2015-11-21",2015,"Gateshead","Halifax Town","1-4",1,4,5,5,5,-3,"A"
"2015-11-21",2015,"Macclesfield","Bromley","2-0",2,0,5,5,2,2,"H"
"2015-11-21",2015,"Torquay United","Lincoln City","1-3",1,3,5,5,4,-2,"A"
"2015-11-21",2015,"Tranmere Rovers","Guiseley","2-1",2,1,5,5,3,1,"H"
"2015-11-21",2015,"Welling United","Southport","0-1",0,1,5,5,1,-1,"A"
"2015-11-24",2015,"Chester","Dover Athletic","1-1",1,1,5,5,2,0,"D"
"2015-11-24",2015,"Woking","Tranmere Rovers","4-1",4,1,5,5,5,3,"H"
"2015-11-25",2015,"Boreham Wood","Lincoln City","1-1",1,1,5,5,2,0,"D"
"2015-11-28",2015,"Aldershot","Cheltenham","0-2",0,2,5,5,2,-2,"A"
"2015-11-28",2015,"Barrow","Woking","2-1",2,1,5,5,3,1,"H"
"2015-11-28",2015,"Boreham Wood","Tranmere Rovers","0-0",0,0,5,5,0,0,"D"
"2015-11-28",2015,"Braintree Town","Torquay United","0-0",0,0,5,5,0,0,"D"
"2015-11-28",2015,"Eastleigh","Southport","1-0",1,0,5,5,1,1,"H"
"2015-11-28",2015,"Forest Green Rovers","Altrincham","2-0",2,0,5,5,2,2,"H"
"2015-11-28",2015,"Gateshead","Chester","1-0",1,0,5,5,1,1,"H"
"2015-11-28",2015,"Grimsby Town","Kidderminster Harriers","1-0",1,0,5,5,1,1,"H"
"2015-11-28",2015,"Guiseley","Bromley","2-0",2,0,5,5,2,2,"H"
"2015-11-28",2015,"Halifax Town","Dover Athletic","4-2",4,2,5,5,6,2,"H"
"2015-11-28",2015,"Lincoln City","Welling United","1-1",1,1,5,5,2,0,"D"
"2015-11-28",2015,"Wrexham","Macclesfield","2-3",2,3,5,5,5,-1,"A"
"2015-12-05",2015,"Cheltenham","Chester","3-1",3,1,5,5,4,2,"H"
"2015-12-05",2015,"Dover Athletic","Aldershot","5-2",5,2,5,5,7,3,"H"
"2015-12-05",2015,"Halifax Town","Guiseley","1-1",1,1,5,5,2,0,"D"
"2015-12-05",2015,"Kidderminster Harriers","Gateshead","0-1",0,1,5,5,1,-1,"A"
"2015-12-05",2015,"Southport","Macclesfield","3-1",3,1,5,5,4,2,"H"
"2015-12-05",2015,"Torquay United","Wrexham","0-1",0,1,5,5,1,-1,"A"
"2015-12-05",2015,"Tranmere Rovers","Braintree Town","1-2",1,2,5,5,3,-1,"A"
"2015-12-05",2015,"Woking","Lincoln City","3-1",3,1,5,5,4,2,"H"
"2015-12-08",2015,"Gateshead","Southport","0-1",0,1,5,5,1,-1,"A"
"2015-12-08",2015,"Macclesfield","Eastleigh","1-2",1,2,5,5,3,-1,"A"
"2015-12-19",2015,"Aldershot","Guiseley","1-0",1,0,5,5,1,1,"H"
"2015-12-19",2015,"Cheltenham","Altrincham","1-0",1,0,5,5,1,1,"H"
"2015-12-19",2015,"Chester","Torquay United","4-1",4,1,5,5,5,3,"H"
"2015-12-19",2015,"Eastleigh","Kidderminster Harriers","3-1",3,1,5,5,4,2,"H"
"2015-12-19",2015,"Forest Green Rovers","Boreham Wood","1-0",1,0,5,5,1,1,"H"
"2015-12-19",2015,"Gateshead","Woking","1-5",1,5,5,5,6,-4,"A"
"2015-12-19",2015,"Grimsby Town","Dover Athletic","1-0",1,0,5,5,1,1,"H"
"2015-12-19",2015,"Halifax Town","Tranmere Rovers","1-1",1,1,5,5,2,0,"D"
"2015-12-19",2015,"Lincoln City","Barrow","2-2",2,2,5,5,4,0,"D"
"2015-12-19",2015,"Southport","Bromley","5-3",5,3,5,5,8,2,"H"
"2015-12-19",2015,"Welling United","Macclesfield","0-1",0,1,5,5,1,-1,"A"
"2015-12-26",2015,"Aldershot","Woking","0-1",0,1,5,5,1,-1,"A"
"2015-12-26",2015,"Boreham Wood","Braintree Town","1-0",1,0,5,5,1,1,"H"
"2015-12-26",2015,"Bromley","Eastleigh","2-2",2,2,5,5,4,0,"D"
"2015-12-26",2015,"Kidderminster Harriers","Cheltenham","1-2",1,2,5,5,3,-1,"A"
"2015-12-26",2015,"Lincoln City","Halifax Town","0-1",0,1,5,5,1,-1,"A"
"2015-12-26",2015,"Macclesfield","Tranmere Rovers","1-2",1,2,5,5,3,-1,"A"
"2015-12-26",2015,"Torquay United","Forest Green Rovers","4-1",4,1,5,5,5,3,"H"
"2015-12-26",2015,"Welling United","Dover Athletic","1-2",1,2,5,5,3,-1,"A"
"2015-12-26",2015,"Wrexham","Southport","0-1",0,1,5,5,1,-1,"A"
"2015-12-28",2015,"Cheltenham","Torquay United","1-0",1,0,5,5,1,1,"H"
"2015-12-28",2015,"Chester","Macclesfield","0-2",0,2,5,5,2,-2,"A"
"2015-12-28",2015,"Dover Athletic","Bromley","2-3",2,3,5,5,5,-1,"A"
"2015-12-28",2015,"Eastleigh","Aldershot","1-1",1,1,5,5,2,0,"D"
"2015-12-28",2015,"Forest Green Rovers","Kidderminster Harriers","3-0",3,0,5,5,3,3,"H"
"2015-12-28",2015,"Gateshead","Guiseley","3-0",3,0,5,5,3,3,"H"
"2015-12-28",2015,"Grimsby Town","Lincoln City","2-0",2,0,5,5,2,2,"H"
"2015-12-28",2015,"Halifax Town","Wrexham","2-0",2,0,5,5,2,2,"H"
"2015-12-28",2015,"Southport","Barrow","2-1",2,1,5,5,3,1,"H"
"2015-12-28",2015,"Tranmere Rovers","Altrincham","1-0",1,0,5,5,1,1,"H"
"2015-12-28",2015,"Woking","Boreham Wood","0-0",0,0,5,5,0,0,"D"
"2016-01-01",2015,"Forest Green Rovers","Torquay United","3-1",3,1,5,5,4,2,"H"
"2016-01-02",2015,"Chester","Altrincham","1-1",1,1,5,5,2,0,"D"
"2016-01-02",2015,"Gateshead","Barrow","1-1",1,1,5,5,2,0,"D"
"2016-01-02",2015,"Grimsby Town","Guiseley","1-1",1,1,5,5,2,0,"D"
"2016-01-02",2015,"Halifax Town","Lincoln City","2-2",2,2,5,5,4,0,"D"
"2016-01-02",2015,"Southport","Wrexham","3-2",3,2,5,5,5,1,"H"
"2016-01-02",2015,"Tranmere Rovers","Macclesfield","0-1",0,1,5,5,1,-1,"A"
"2016-01-02",2015,"Woking","Aldershot","2-1",2,1,5,5,3,1,"H"
"2016-01-09",2015,"Aldershot","Chester","3-1",3,1,5,5,4,2,"H"
"2016-01-09",2015,"Barrow","Tranmere Rovers","3-4",3,4,5,5,7,-1,"A"
"2016-01-09",2015,"Boreham Wood","Cheltenham","0-0",0,0,5,5,0,0,"D"
"2016-01-09",2015,"Bromley","Southport","0-0",0,0,5,5,0,0,"D"
"2016-01-09",2015,"Lincoln City","Dover Athletic","2-3",2,3,5,5,5,-1,"A"
"2016-01-09",2015,"Macclesfield","Halifax Town","0-1",0,1,5,5,1,-1,"A"
"2016-01-09",2015,"Welling United","Grimsby Town","0-4",0,4,5,5,4,-4,"A"
"2016-01-09",2015,"Wrexham","Woking","1-3",1,3,5,5,4,-2,"A"
"2016-01-16",2015,"Lincoln City","Forest Green Rovers","0-1",0,1,5,5,1,-1,"A"
"2016-01-23",2015,"Boreham Wood","Eastleigh","1-1",1,1,5,5,2,0,"D"
"2016-01-23",2015,"Bromley","Tranmere Rovers","0-1",0,1,5,5,1,-1,"A"
"2016-01-23",2015,"Chester","Southport","0-0",0,0,5,5,0,0,"D"
"2016-01-23",2015,"Forest Green Rovers","Braintree Town","1-0",1,0,5,5,1,1,"H"
"2016-01-23",2015,"Grimsby Town","Altrincham","5-0",5,0,5,5,5,5,"H"
"2016-01-23",2015,"Kidderminster Harriers","Guiseley","0-1",0,1,5,5,1,-1,"A"
"2016-01-23",2015,"Macclesfield","Aldershot","0-2",0,2,5,5,2,-2,"A"
"2016-01-23",2015,"Torquay United","Gateshead","0-2",0,2,5,5,2,-2,"A"
"2016-01-23",2015,"Welling United","Barrow","1-2",1,2,5,5,3,-1,"A"
"2016-01-23",2015,"Woking","Halifax Town","1-1",1,1,5,5,2,0,"D"
"2016-01-23",2015,"Wrexham","Lincoln City","3-1",3,1,5,5,4,2,"H"
"2016-01-24",2015,"Dover Athletic","Cheltenham","1-2",1,2,5,5,3,-1,"A"
"2016-01-26",2015,"Altrincham","Woking","3-1",3,1,5,5,4,2,"H"
"2016-01-26",2015,"Braintree Town","Wrexham","1-0",1,0,5,5,1,1,"H"
"2016-01-26",2015,"Southport","Forest Green Rovers","0-1",0,1,5,5,1,-1,"A"
"2016-01-30",2015,"Aldershot","Kidderminster Harriers","1-0",1,0,5,5,1,1,"H"
"2016-01-30",2015,"Braintree Town","Chester","2-0",2,0,5,5,2,2,"H"
"2016-01-30",2015,"Cheltenham","Bromley","4-1",4,1,5,5,5,3,"H"
"2016-01-30",2015,"Eastleigh","Wrexham","1-1",1,1,5,5,2,0,"D"
"2016-01-30",2015,"Forest Green Rovers","Macclesfield","2-1",2,1,5,5,3,1,"H"
"2016-01-30",2015,"Gateshead","Grimsby Town","1-0",1,0,5,5,1,1,"H"
"2016-01-30",2015,"Halifax Town","Welling United","1-1",1,1,5,5,2,0,"D"
"2016-01-30",2015,"Lincoln City","Guiseley","1-0",1,0,5,5,1,1,"H"
"2016-01-30",2015,"Tranmere Rovers","Torquay United","2-1",2,1,5,5,3,1,"H"
"2016-01-30",2015,"Woking","Barrow","2-2",2,2,5,5,4,0,"D"
"2016-02-02",2015,"Barrow","Gateshead","0-0",0,0,5,5,0,0,"D"
"2016-02-02",2015,"Braintree Town","Welling United","1-0",1,0,5,5,1,1,"H"
"2016-02-06",2015,"Barrow","Cheltenham","1-2",1,2,5,5,3,-1,"A"
"2016-02-06",2015,"Boreham Wood","Kidderminster Harriers","0-2",0,2,5,5,2,-2,"A"
"2016-02-06",2015,"Lincoln City","Eastleigh","3-0",3,0,5,5,3,3,"H"
"2016-02-06",2015,"Tranmere Rovers","Southport","1-0",1,0,5,5,1,1,"H"
"2016-02-06",2015,"Welling United","Altrincham","1-1",1,1,5,5,2,0,"D"
"2016-02-06",2015,"Wrexham","Forest Green Rovers","2-2",2,2,5,5,4,0,"D"
"2016-02-09",2015,"Altrincham","Wrexham","1-1",1,1,5,5,2,0,"D"
"2016-02-09",2015,"Bromley","Grimsby Town","1-2",1,2,5,5,3,-1,"A"
"2016-02-09",2015,"Kidderminster Harriers","Eastleigh","3-2",3,2,5,5,5,1,"H"
"2016-02-13",2015,"Aldershot","Tranmere Rovers","0-0",0,0,5,5,0,0,"D"
"2016-02-13",2015,"Altrincham","Lincoln City","3-3",3,3,5,5,6,0,"D"
"2016-02-13",2015,"Cheltenham","Welling United","2-0",2,0,5,5,2,2,"H"
"2016-02-13",2015,"Dover Athletic","Gateshead","4-0",4,0,5,5,4,4,"H"
"2016-02-13",2015,"Grimsby Town","Boreham Wood","0-0",0,0,5,5,0,0,"D"
"2016-02-13",2015,"Halifax Town","Forest Green Rovers","0-2",0,2,5,5,2,-2,"A"
"2016-02-13",2015,"Kidderminster Harriers","Macclesfield","3-1",3,1,5,5,4,2,"H"
"2016-02-13",2015,"Southport","Braintree Town","1-1",1,1,5,5,2,0,"D"
"2016-02-13",2015,"Woking","Guiseley","0-1",0,1,5,5,1,-1,"A"
"2016-02-13",2015,"Wrexham","Bromley","2-0",2,0,5,5,2,2,"H"
"2016-02-16",2015,"Altrincham","Chester","0-3",0,3,5,5,3,-3,"A"
"2016-02-16",2015,"Braintree Town","Boreham Wood","0-2",0,2,5,5,2,-2,"A"
"2016-02-16",2015,"Cheltenham","Kidderminster Harriers","2-0",2,0,5,5,2,2,"H"
"2016-02-16",2015,"Gateshead","Eastleigh","2-1",2,1,5,5,3,1,"H"
"2016-02-20",2015,"Altrincham","Guiseley","1-1",1,1,5,5,2,0,"D"
"2016-02-20",2015,"Boreham Wood","Torquay United","0-1",0,1,5,5,1,-1,"A"
"2016-02-20",2015,"Bromley","Woking","2-1",2,1,5,5,3,1,"H"
"2016-02-20",2015,"Forest Green Rovers","Eastleigh","2-1",2,1,5,5,3,1,"H"
"2016-02-20",2015,"Gateshead","Aldershot","3-2",3,2,5,5,5,1,"H"
"2016-02-20",2015,"Halifax Town","Grimsby Town","4-2",4,2,5,5,6,2,"H"
"2016-02-20",2015,"Kidderminster Harriers","Chester","2-2",2,2,5,5,4,0,"D"
"2016-02-20",2015,"Lincoln City","Southport","3-1",3,1,5,5,4,2,"H"
"2016-02-20",2015,"Tranmere Rovers","Cheltenham","0-1",0,1,5,5,1,-1,"A"
"2016-02-20",2015,"Welling United","Wrexham","0-2",0,2,5,5,2,-2,"A"
"2016-02-23",2015,"Braintree Town","Halifax Town","2-0",2,0,5,5,2,2,"H"
"2016-02-23",2015,"Cheltenham","Gateshead","0-0",0,0,5,5,0,0,"D"
"2016-02-23",2015,"Grimsby Town","Woking","3-1",3,1,5,5,4,2,"H"
"2016-02-23",2015,"Guiseley","Forest Green Rovers","0-1",0,1,5,5,1,-1,"A"
"2016-02-23",2015,"Torquay United","Welling United","2-0",2,0,5,5,2,2,"H"
"2016-02-23",2015,"Wrexham","Kidderminster Harriers","2-0",2,0,5,5,2,2,"H"
"2016-02-27",2015,"Barrow","Forest Green Rovers","2-2",2,2,5,5,4,0,"D"
"2016-02-27",2015,"Guiseley","Braintree Town","1-1",1,1,5,5,2,0,"D"
"2016-02-27",2015,"Kidderminster Harriers","Bromley","0-1",0,1,5,5,1,-1,"A"
"2016-02-27",2015,"Macclesfield","Wrexham","0-0",0,0,5,5,0,0,"D"
"2016-02-27",2015,"Southport","Boreham Wood","0-3",0,3,5,5,3,-3,"A"
"2016-02-27",2015,"Welling United","Aldershot","0-1",0,1,5,5,1,-1,"A"
"2016-02-28",2015,"Chester","Tranmere Rovers","0-1",0,1,5,5,1,-1,"A"
"2016-03-01",2015,"Braintree Town","Kidderminster Harriers","2-1",2,1,5,5,3,1,"H"
"2016-03-01",2015,"Bromley","Welling United","2-0",2,0,5,5,2,2,"H"
"2016-03-01",2015,"Dover Athletic","Southport","1-2",1,2,5,5,3,-1,"A"
"2016-03-01",2015,"Eastleigh","Cheltenham","1-0",1,0,5,5,1,1,"H"
"2016-03-01",2015,"Macclesfield","Torquay United","1-2",1,2,5,5,3,-1,"A"
"2016-03-04",2015,"Forest Green Rovers","Grimsby Town","0-1",0,1,5,5,1,-1,"A"
"2016-03-05",2015,"Altrincham","Macclesfield","0-0",0,0,5,5,0,0,"D"
"2016-03-05",2015,"Boreham Wood","Barrow","0-2",0,2,5,5,2,-2,"A"
"2016-03-05",2015,"Braintree Town","Eastleigh","2-0",2,0,5,5,2,2,"H"
"2016-03-05",2015,"Chester","Bromley","1-1",1,1,5,5,2,0,"D"
"2016-03-05",2015,"Lincoln City","Aldershot","2-0",2,0,5,5,2,2,"H"
"2016-03-05",2015,"Southport","Halifax Town","0-1",0,1,5,5,1,-1,"A"
"2016-03-05",2015,"Torquay United","Kidderminster Harriers","3-2",3,2,5,5,5,1,"H"
"2016-03-05",2015,"Tranmere Rovers","Gateshead","3-1",3,1,5,5,4,2,"H"
"2016-03-05",2015,"Welling United","Cheltenham","1-1",1,1,5,5,2,0,"D"
"2016-03-05",2015,"Woking","Dover Athletic","0-1",0,1,5,5,1,-1,"A"
"2016-03-08",2015,"Altrincham","Gateshead","2-3",2,3,5,5,5,-1,"A"
"2016-03-08",2015,"Barrow","Boreham Wood","0-0",0,0,5,5,0,0,"D"
"2016-03-08",2015,"Bromley","Halifax Town","1-0",1,0,5,5,1,1,"H"
"2016-03-08",2015,"Chester","Aldershot","8-2",8,2,5,5,10,6,"H"
"2016-03-08",2015,"Dover Athletic","Welling United","2-1",2,1,5,5,3,1,"H"
"2016-03-08",2015,"Eastleigh","Woking","2-1",2,1,5,5,3,1,"H"
"2016-03-08",2015,"Grimsby Town","Southport","1-0",1,0,5,5,1,1,"H"
"2016-03-08",2015,"Guiseley","Tranmere Rovers","2-2",2,2,5,5,4,0,"D"
"2016-03-08",2015,"Torquay United","Braintree Town","0-0",0,0,5,5,0,0,"D"
"2016-03-12",2015,"Aldershot","Torquay United","0-0",0,0,5,5,0,0,"D"
"2016-03-12",2015,"Barrow","Altrincham","3-2",3,2,5,5,5,1,"H"
"2016-03-12",2015,"Bromley","Guiseley","2-0",2,0,5,5,2,2,"H"
"2016-03-12",2015,"Cheltenham","Woking","4-0",4,0,5,5,4,4,"H"
"2016-03-12",2015,"Dover Athletic","Tranmere Rovers","0-0",0,0,5,5,0,0,"D"
"2016-03-12",2015,"Eastleigh","Chester","1-0",1,0,5,5,1,1,"H"
"2016-03-12",2015,"Gateshead","Forest Green Rovers","0-1",0,1,5,5,1,-1,"A"
"2016-03-12",2015,"Macclesfield","Lincoln City","1-1",1,1,5,5,2,0,"D"
"2016-03-12",2015,"Southport","Welling United","3-3",3,3,5,5,6,0,"D"
"2016-03-12",2015,"Wrexham","Boreham Wood","1-0",1,0,5,5,1,1,"H"
"2016-03-15",2015,"Braintree Town","Gateshead","0-0",0,0,5,5,0,0,"D"
"2016-03-15",2015,"Dover Athletic","Lincoln City","4-1",4,1,5,5,5,3,"H"
"2016-03-15",2015,"Eastleigh","Bromley","2-0",2,0,5,5,2,2,"H"
"2016-03-15",2015,"Guiseley","Grimsby Town","2-2",2,2,5,5,4,0,"D"
"2016-03-15",2015,"Torquay United","Halifax Town","0-0",0,0,5,5,0,0,"D"
"2016-03-19",2015,"Altrincham","Aldershot","4-0",4,0,5,5,4,4,"H"
"2016-03-19",2015,"Barrow","Bromley","1-1",1,1,5,5,2,0,"D"
"2016-03-19",2015,"Boreham Wood","Macclesfield","0-0",0,0,5,5,0,0,"D"
"2016-03-19",2015,"Braintree Town","Cheltenham","1-0",1,0,5,5,1,1,"H"
"2016-03-19",2015,"Guiseley","Dover Athletic","0-1",0,1,5,5,1,-1,"A"
"2016-03-19",2015,"Lincoln City","Kidderminster Harriers","1-2",1,2,5,5,3,-1,"A"
"2016-03-19",2015,"Torquay United","Southport","1-0",1,0,5,5,1,1,"H"
"2016-03-19",2015,"Tranmere Rovers","Forest Green Rovers","1-1",1,1,5,5,2,0,"D"
"2016-03-19",2015,"Welling United","Gateshead","0-1",0,1,5,5,1,-1,"A"
"2016-03-19",2015,"Wrexham","Chester","3-0",3,0,5,5,3,3,"H"
"2016-03-25",2015,"Braintree Town","Bromley","1-0",1,0,5,5,1,1,"H"
"2016-03-25",2015,"Cheltenham","Boreham Wood","4-1",4,1,5,5,5,3,"H"
"2016-03-25",2015,"Eastleigh","Welling United","0-0",0,0,5,5,0,0,"D"
"2016-03-25",2015,"Forest Green Rovers","Aldershot","0-0",0,0,5,5,0,0,"D"
"2016-03-25",2015,"Gateshead","Macclesfield","0-3",0,3,5,5,3,-3,"A"
"2016-03-25",2015,"Tranmere Rovers","Lincoln City","3-2",3,2,5,5,5,1,"H"
"2016-03-26",2015,"Chester","Barrow","1-2",1,2,5,5,3,-1,"A"
"2016-03-26",2015,"Dover Athletic","Torquay United","5-0",5,0,5,5,5,5,"H"
"2016-03-26",2015,"Grimsby Town","Wrexham","1-0",1,0,5,5,1,1,"H"
"2016-03-26",2015,"Halifax Town","Altrincham","1-0",1,0,5,5,1,1,"H"
"2016-03-26",2015,"Southport","Guiseley","2-0",2,0,5,5,2,2,"H"
"2016-03-26",2015,"Woking","Kidderminster Harriers","1-1",1,1,5,5,2,0,"D"
"2016-03-28",2015,"Aldershot","Braintree Town","2-1",2,1,5,5,3,1,"H"
"2016-03-28",2015,"Altrincham","Southport","1-1",1,1,5,5,2,0,"D"
"2016-03-28",2015,"Barrow","Halifax Town","4-1",4,1,5,5,5,3,"H"
"2016-03-28",2015,"Boreham Wood","Dover Athletic","3-0",3,0,5,5,3,3,"H"
"2016-03-28",2015,"Bromley","Forest Green Rovers","2-2",2,2,5,5,4,0,"D"
"2016-03-28",2015,"Guiseley","Chester","3-3",3,3,5,5,6,0,"D"
"2016-03-28",2015,"Kidderminster Harriers","Tranmere Rovers","0-2",0,2,5,5,2,-2,"A"
"2016-03-28",2015,"Lincoln City","Gateshead","1-1",1,1,5,5,2,0,"D"
"2016-03-28",2015,"Macclesfield","Grimsby Town","2-1",2,1,5,5,3,1,"H"
"2016-03-28",2015,"Torquay United","Eastleigh","0-1",0,1,5,5,1,-1,"A"
"2016-03-28",2015,"Welling United","Woking","2-1",2,1,5,5,3,1,"H"
"2016-03-28",2015,"Wrexham","Cheltenham","2-1",2,1,5,5,3,1,"H"
"2016-04-01",2015,"Cheltenham","Grimsby Town","3-1",3,1,5,5,4,2,"H"
"2016-04-02",2015,"Aldershot","Barrow","0-1",0,1,5,5,1,-1,"A"
"2016-04-02",2015,"Bromley","Lincoln City","2-0",2,0,5,5,2,2,"H"
"2016-04-02",2015,"Chester","Boreham Wood","2-2",2,2,5,5,4,0,"D"
"2016-04-02",2015,"Dover Athletic","Halifax Town","1-0",1,0,5,5,1,1,"H"
"2016-04-02",2015,"Eastleigh","Guiseley","1-1",1,1,5,5,2,0,"D"
"2016-04-02",2015,"Forest Green Rovers","Wrexham","0-0",0,0,5,5,0,0,"D"
"2016-04-02",2015,"Gateshead","Torquay United","1-2",1,2,5,5,3,-1,"A"
"2016-04-02",2015,"Kidderminster Harriers","Altrincham","1-1",1,1,5,5,2,0,"D"
"2016-04-02",2015,"Macclesfield","Braintree Town","3-1",3,1,5,5,4,2,"H"
"2016-04-02",2015,"Southport","Woking","2-2",2,2,5,5,4,0,"D"
"2016-04-02",2015,"Tranmere Rovers","Welling United","1-2",1,2,5,5,3,-1,"A"
"2016-04-05",2015,"Aldershot","Grimsby Town","3-4",3,4,5,5,7,-1,"A"
"2016-04-05",2015,"Altrincham","Dover Athletic","1-2",1,2,5,5,3,-1,"A"
"2016-04-05",2015,"Barrow","Braintree Town","2-0",2,0,5,5,2,2,"H"
"2016-04-05",2015,"Halifax Town","Boreham Wood","3-2",3,2,5,5,5,1,"H"
"2016-04-05",2015,"Torquay United","Chester","2-0",2,0,5,5,2,2,"H"
"2016-04-09",2015,"Altrincham","Bromley","0-0",0,0,5,5,0,0,"D"
"2016-04-09",2015,"Barrow","Macclesfield","1-1",1,1,5,5,2,0,"D"
"2016-04-09",2015,"Boreham Wood","Southport","0-2",0,2,5,5,2,-2,"A"
"2016-04-09",2015,"Braintree Town","Forest Green Rovers","1-1",1,1,5,5,2,0,"D"
"2016-04-09",2015,"Grimsby Town","Eastleigh","0-0",0,0,5,5,0,0,"D"
"2016-04-09",2015,"Guiseley","Cheltenham","0-2",0,2,5,5,2,-2,"A"
"2016-04-09",2015,"Halifax Town","Aldershot","0-2",0,2,5,5,2,-2,"A"
"2016-04-09",2015,"Lincoln City","Chester","2-1",2,1,5,5,3,1,"H"
"2016-04-09",2015,"Torquay United","Tranmere Rovers","0-1",0,1,5,5,1,-1,"A"
"2016-04-09",2015,"Welling United","Kidderminster Harriers","1-2",1,2,5,5,3,-1,"A"
"2016-04-09",2015,"Woking","Gateshead","1-1",1,1,5,5,2,0,"D"
"2016-04-09",2015,"Wrexham","Dover Athletic","0-1",0,1,5,5,1,-1,"A"
"2016-04-12",2015,"Eastleigh","Barrow","3-1",3,1,5,5,4,2,"H"
"2016-04-12",2015,"Grimsby Town","Braintree Town","0-1",0,1,5,5,1,-1,"A"
"2016-04-12",2015,"Guiseley","Wrexham","3-1",3,1,5,5,4,2,"H"
"2016-04-12",2015,"Kidderminster Harriers","Halifax Town","1-0",1,0,5,5,1,1,"H"
"2016-04-12",2015,"Macclesfield","Dover Athletic","0-0",0,0,5,5,0,0,"D"
"2016-04-12",2015,"Torquay United","Altrincham","2-0",2,0,5,5,2,2,"H"
"2016-04-16",2015,"Aldershot","Boreham Wood","1-2",1,2,5,5,3,-1,"A"
"2016-04-16",2015,"Bromley","Torquay United","0-2",0,2,5,5,2,-2,"A"
"2016-04-16",2015,"Cheltenham","Halifax Town","2-0",2,0,5,5,2,2,"H"
"2016-04-16",2015,"Chester","Welling United","4-0",4,0,5,5,4,4,"H"
"2016-04-16",2015,"Dover Athletic","Grimsby Town","1-1",1,1,5,5,2,0,"D"
"2016-04-16",2015,"Eastleigh","Altrincham","2-0",2,0,5,5,2,2,"H"
"2016-04-16",2015,"Forest Green Rovers","Woking","1-2",1,2,5,5,3,-1,"A"
"2016-04-16",2015,"Gateshead","Braintree Town","2-3",2,3,5,5,5,-1,"A"
"2016-04-16",2015,"Kidderminster Harriers","Barrow","0-0",0,0,5,5,0,0,"D"
"2016-04-16",2015,"Macclesfield","Guiseley","1-0",1,0,5,5,1,1,"H"
"2016-04-16",2015,"Southport","Lincoln City","2-2",2,2,5,5,4,0,"D"
"2016-04-16",2015,"Tranmere Rovers","Wrexham","1-2",1,2,5,5,3,-1,"A"
"2016-04-19",2015,"Halifax Town","Eastleigh","0-0",0,0,5,5,0,0,"D"
"2016-04-19",2015,"Woking","Grimsby Town","1-3",1,3,5,5,4,-2,"A"
"2016-04-23",2015,"Aldershot","Southport","1-2",1,2,5,5,3,-1,"A"
"2016-04-23",2015,"Altrincham","Welling United","5-0",5,0,5,5,5,5,"H"
"2016-04-23",2015,"Boreham Wood","Guiseley","1-0",1,0,5,5,1,1,"H"
"2016-04-23",2015,"Eastleigh","Tranmere Rovers","0-1",0,1,5,5,1,-1,"A"
"2016-04-23",2015,"Forest Green Rovers","Halifax Town","0-1",0,1,5,5,1,-1,"A"
"2016-04-23",2015,"Gateshead","Bromley","3-1",3,1,5,5,4,2,"H"
"2016-04-23",2015,"Grimsby Town","Chester","1-2",1,2,5,5,3,-1,"A"
"2016-04-23",2015,"Kidderminster Harriers","Dover Athletic","1-1",1,1,5,5,2,0,"D"
"2016-04-23",2015,"Lincoln City","Woking","2-3",2,3,5,5,5,-1,"A"
"2016-04-23",2015,"Macclesfield","Cheltenham","0-1",0,1,5,5,1,-1,"A"
"2016-04-23",2015,"Torquay United","Barrow","2-2",2,2,5,5,4,0,"D"
"2016-04-23",2015,"Wrexham","Braintree Town","2-3",2,3,5,5,5,-1,"A"
"2016-04-30",2015,"Barrow","Wrexham","2-0",2,0,5,5,2,2,"H"
"2016-04-30",2015,"Braintree Town","Altrincham","3-0",3,0,5,5,3,3,"H"
"2016-04-30",2015,"Bromley","Aldershot","1-3",1,3,5,5,4,-2,"A"
"2016-04-30",2015,"Cheltenham","Lincoln City","3-1",3,1,5,5,4,2,"H"
"2016-04-30",2015,"Chester","Gateshead","4-2",4,2,5,5,6,2,"H"
"2016-04-30",2015,"Dover Athletic","Forest Green Rovers","0-1",0,1,5,5,1,-1,"A"
"2016-04-30",2015,"Guiseley","Torquay United","4-3",4,3,5,5,7,1,"H"
"2016-04-30",2015,"Halifax Town","Macclesfield","1-1",1,1,5,5,2,0,"D"
"2016-04-30",2015,"Southport","Kidderminster Harriers","3-4",3,4,5,5,7,-1,"A"
"2016-04-30",2015,"Tranmere Rovers","Grimsby Town","1-0",1,0,5,5,1,1,"H"
"2016-04-30",2015,"Welling United","Boreham Wood","0-3",0,3,5,5,3,-3,"A"
"2016-04-30",2015,"Woking","Eastleigh","2-1",2,1,5,5,3,1,"H"
"2016-08-06",2016,"Barrow","Aldershot","1-0",1,0,5,5,1,1,"H"
"2016-08-06",2016,"Boreham Wood","Forest Green Rovers","1-0",1,0,5,5,1,1,"H"
"2016-08-06",2016,"Bromley","Tranmere Rovers","0-2",0,2,5,5,2,-2,"A"
"2016-08-06",2016,"Dagenham and Redbridge","Southport","3-0",3,0,5,5,3,3,"H"
"2016-08-06",2016,"Eastleigh","Guiseley","2-1",2,1,5,5,3,1,"H"
"2016-08-06",2016,"Gateshead","Chester","3-0",3,0,5,5,3,3,"H"
"2016-08-06",2016,"Macclesfield","Torquay United","2-0",2,0,5,5,2,2,"H"
"2016-08-06",2016,"Maidstone United","York City","1-1",1,1,5,5,2,0,"D"
"2016-08-06",2016,"North Ferriby","Braintree Town","0-0",0,0,5,5,0,0,"D"
"2016-08-06",2016,"Sutton United","Solihull","1-3",1,3,5,5,4,-2,"A"
"2016-08-06",2016,"Woking","Lincoln City","1-3",1,3,5,5,4,-2,"A"
"2016-08-06",2016,"Wrexham","Dover Athletic","0-0",0,0,5,5,0,0,"D"
"2016-08-09",2016,"Aldershot","Maidstone United","1-0",1,0,5,5,1,1,"H"
"2016-08-09",2016,"Braintree Town","Eastleigh","1-1",1,1,5,5,2,0,"D"
"2016-08-09",2016,"Chester","Dagenham and Redbridge","3-0",3,0,5,5,3,3,"H"
"2016-08-09",2016,"Dover Athletic","Boreham Wood","1-4",1,4,5,5,5,-3,"A"
"2016-08-09",2016,"Forest Green Rovers","Sutton United","1-1",1,1,5,5,2,0,"D"
"2016-08-09",2016,"Guiseley","Wrexham","2-3",2,3,5,5,5,-1,"A"
"2016-08-09",2016,"Lincoln City","North Ferriby","6-1",6,1,5,5,7,5,"H"
"2016-08-09",2016,"Solihull","Woking","2-2",2,2,5,5,4,0,"D"
"2016-08-09",2016,"Southport","Gateshead","0-3",0,3,5,5,3,-3,"A"
"2016-08-09",2016,"Torquay United","Bromley","1-0",1,0,5,5,1,1,"H"
"2016-08-09",2016,"Tranmere Rovers","Barrow","2-0",2,0,5,5,2,2,"H"
"2016-08-09",2016,"York City","Macclesfield","1-0",1,0,5,5,1,1,"H"
"2016-08-13",2016,"Aldershot","Wrexham","2-0",2,0,5,5,2,2,"H"
"2016-08-13",2016,"Braintree Town","Macclesfield","1-3",1,3,5,5,4,-2,"A"
"2016-08-13",2016,"Chester","Maidstone United","1-3",1,3,5,5,4,-2,"A"
"2016-08-13",2016,"Dover Athletic","North Ferriby","2-0",2,0,5,5,2,2,"H"
"2016-08-13",2016,"Forest Green Rovers","Gateshead","1-0",1,0,5,5,1,1,"H"
"2016-08-13",2016,"Guiseley","Dagenham and Redbridge","0-2",0,2,5,5,2,-2,"A"
"2016-08-13",2016,"Lincoln City","Sutton United","1-3",1,3,5,5,4,-2,"A"
"2016-08-13",2016,"Solihull","Bromley","1-0",1,0,5,5,1,1,"H"
"2016-08-13",2016,"Southport","Woking","2-1",2,1,5,5,3,1,"H"
"2016-08-13",2016,"Torquay United","Barrow","1-1",1,1,5,5,2,0,"D"
"2016-08-13",2016,"Tranmere Rovers","Eastleigh","2-1",2,1,5,5,3,1,"H"
"2016-08-13",2016,"York City","Boreham Wood","1-1",1,1,5,5,2,0,"D"
"2016-08-16",2016,"Barrow","Chester","3-2",3,2,5,5,5,1,"H"
"2016-08-16",2016,"Boreham Wood","Tranmere Rovers","0-1",0,1,5,5,1,-1,"A"
"2016-08-16",2016,"Bromley","Aldershot","2-2",2,2,5,5,4,0,"D"
"2016-08-16",2016,"Dagenham and Redbridge","Lincoln City","1-0",1,0,5,5,1,1,"H"
"2016-08-16",2016,"Eastleigh","Dover Athletic","2-4",2,4,5,5,6,-2,"A"
"2016-08-16",2016,"Gateshead","York City","6-1",6,1,5,5,7,5,"H"
"2016-08-16",2016,"Macclesfield","Southport","3-1",3,1,5,5,4,2,"H"
"2016-08-16",2016,"Maidstone United","Braintree Town","2-1",2,1,5,5,3,1,"H"
"2016-08-16",2016,"North Ferriby","Guiseley","3-2",3,2,5,5,5,1,"H"
"2016-08-16",2016,"Sutton United","Torquay United","2-0",2,0,5,5,2,2,"H"
"2016-08-16",2016,"Woking","Forest Green Rovers","0-1",0,1,5,5,1,-1,"A"
"2016-08-16",2016,"Wrexham","Solihull","1-0",1,0,5,5,1,1,"H"
"2016-08-20",2016,"Boreham Wood","Chester","1-1",1,1,5,5,2,0,"D"
"2016-08-20",2016,"Braintree Town","Aldershot","2-0",2,0,5,5,2,2,"H"
"2016-08-20",2016,"Bromley","Gateshead","3-2",3,2,5,5,5,1,"H"
"2016-08-20",2016,"Dover Athletic","Barrow","3-1",3,1,5,5,4,2,"H"
"2016-08-20",2016,"Forest Green Rovers","York City","2-1",2,1,5,5,3,1,"H"
"2016-08-20",2016,"Lincoln City","Southport","4-0",4,0,5,5,4,4,"H"
"2016-08-20",2016,"North Ferriby","Torquay United","1-0",1,0,5,5,1,1,"H"
"2016-08-20",2016,"Solihull","Guiseley","3-2",3,2,5,5,5,1,"H"
"2016-08-20",2016,"Sutton United","Macclesfield","2-0",2,0,5,5,2,2,"H"
"2016-08-20",2016,"Tranmere Rovers","Maidstone United","2-1",2,1,5,5,3,1,"H"
"2016-08-20",2016,"Woking","Dagenham and Redbridge","1-3",1,3,5,5,4,-2,"A"
"2016-08-20",2016,"Wrexham","Eastleigh","0-0",0,0,5,5,0,0,"D"
"2016-08-27",2016,"Aldershot","North Ferriby","2-0",2,0,5,5,2,2,"H"
"2016-08-27",2016,"Barrow","Braintree Town","2-1",2,1,5,5,3,1,"H"
"2016-08-27",2016,"Chester","Sutton United","4-0",4,0,5,5,4,4,"H"
"2016-08-27",2016,"Dagenham and Redbridge","Wrexham","3-0",3,0,5,5,3,3,"H"
"2016-08-27",2016,"Eastleigh","Solihull","2-0",2,0,5,5,2,2,"H"
"2016-08-27",2016,"Gateshead","Boreham Wood","1-1",1,1,5,5,2,0,"D"
"2016-08-27",2016,"Guiseley","Bromley","1-4",1,4,5,5,5,-3,"A"
"2016-08-27",2016,"Macclesfield","Lincoln City","1-2",1,2,5,5,3,-1,"A"
"2016-08-27",2016,"Maidstone United","Forest Green Rovers","1-4",1,4,5,5,5,-3,"A"
"2016-08-27",2016,"Southport","Tranmere Rovers","1-1",1,1,5,5,2,0,"D"
"2016-08-27",2016,"Torquay United","Dover Athletic","2-1",2,1,5,5,3,1,"H"
"2016-08-27",2016,"York City","Woking","4-1",4,1,5,5,5,3,"H"
"2016-08-29",2016,"Boreham Wood","Maidstone United","0-1",0,1,5,5,1,-1,"A"
"2016-08-29",2016,"Braintree Town","Torquay United","1-3",1,3,5,5,4,-2,"A"
"2016-08-29",2016,"Bromley","Eastleigh","0-5",0,5,5,5,5,-5,"A"
"2016-08-29",2016,"Dover Athletic","Aldershot","1-2",1,2,5,5,3,-1,"A"
"2016-08-29",2016,"Forest Green Rovers","Southport","5-1",5,1,5,5,6,4,"H"
"2016-08-29",2016,"Lincoln City","Gateshead","3-0",3,0,5,5,3,3,"H"
"2016-08-29",2016,"North Ferriby","Barrow","0-1",0,1,5,5,1,-1,"A"
"2016-08-29",2016,"Solihull","Macclesfield","2-3",2,3,5,5,5,-1,"A"
"2016-08-29",2016,"Sutton United","Dagenham and Redbridge","1-0",1,0,5,5,1,1,"H"
"2016-08-29",2016,"Tranmere Rovers","Guiseley","1-0",1,0,5,5,1,1,"H"
"2016-08-29",2016,"Woking","Chester","3-1",3,1,5,5,4,2,"H"
"2016-08-29",2016,"Wrexham","York City","2-1",2,1,5,5,3,1,"H"
"2016-09-03",2016,"Aldershot","Tranmere Rovers","3-1",3,1,5,5,4,2,"H"
"2016-09-03",2016,"Barrow","Bromley","1-1",1,1,5,5,2,0,"D"
"2016-09-03",2016,"Chester","Forest Green Rovers","1-2",1,2,5,5,3,-1,"A"
"2016-09-03",2016,"Dagenham and Redbridge","Boreham Wood","0-2",0,2,5,5,2,-2,"A"
"2016-09-03",2016,"Eastleigh","North Ferriby","2-0",2,0,5,5,2,2,"H"
"2016-09-03",2016,"Gateshead","Sutton United","1-0",1,0,5,5,1,1,"H"
"2016-09-03",2016,"Guiseley","Braintree Town","0-0",0,0,5,5,0,0,"D"
"2016-09-03",2016,"Macclesfield","Woking","3-1",3,1,5,5,4,2,"H"
"2016-09-03",2016,"Maidstone United","Wrexham","2-2",2,2,5,5,4,0,"D"
"2016-09-03",2016,"Southport","Dover Athletic","0-1",0,1,5,5,1,-1,"A"
"2016-09-03",2016,"Torquay United","Lincoln City","1-2",1,2,5,5,3,-1,"A"
"2016-09-03",2016,"York City","Solihull","4-0",4,0,5,5,4,4,"H"
"2016-09-10",2016,"Aldershot","Chester","0-0",0,0,5,5,0,0,"D"
"2016-09-10",2016,"Barrow","Boreham Wood","1-1",1,1,5,5,2,0,"D"
"2016-09-10",2016,"Braintree Town","Gateshead","1-4",1,4,5,5,5,-3,"A"
"2016-09-10",2016,"Bromley","Macclesfield","0-1",0,1,5,5,1,-1,"A"
"2016-09-10",2016,"Dover Athletic","Forest Green Rovers","4-3",4,3,5,5,7,1,"H"
"2016-09-10",2016,"Eastleigh","Southport","1-1",1,1,5,5,2,0,"D"
"2016-09-10",2016,"Guiseley","Woking","1-1",1,1,5,5,2,0,"D"
"2016-09-10",2016,"North Ferriby","Maidstone United","0-2",0,2,5,5,2,-2,"A"
"2016-09-10",2016,"Solihull","Dagenham and Redbridge","2-5",2,5,5,5,7,-3,"A"
"2016-09-10",2016,"Torquay United","York City","2-0",2,0,5,5,2,2,"H"
"2016-09-10",2016,"Tranmere Rovers","Lincoln City","0-1",0,1,5,5,1,-1,"A"
"2016-09-10",2016,"Wrexham","Sutton United","1-0",1,0,5,5,1,1,"H"
"2016-09-13",2016,"Boreham Wood","Aldershot","1-1",1,1,5,5,2,0,"D"
"2016-09-13",2016,"Chester","Guiseley","2-0",2,0,5,5,2,2,"H"
"2016-09-13",2016,"Dagenham and Redbridge","Dover Athletic","2-0",2,0,5,5,2,2,"H"
"2016-09-13",2016,"Forest Green Rovers","Eastleigh","1-1",1,1,5,5,2,0,"D"
"2016-09-13",2016,"Gateshead","North Ferriby","0-1",0,1,5,5,1,-1,"A"
"2016-09-13",2016,"Lincoln City","Solihull","0-0",0,0,5,5,0,0,"D"
"2016-09-13",2016,"Maidstone United","Bromley","0-2",0,2,5,5,2,-2,"A"
"2016-09-13",2016,"Southport","Barrow","1-4",1,4,5,5,5,-3,"A"
"2016-09-13",2016,"Sutton United","Braintree Town","1-2",1,2,5,5,3,-1,"A"
"2016-09-13",2016,"Woking","Torquay United","3-1",3,1,5,5,4,2,"H"
"2016-09-13",2016,"York City","Tranmere Rovers","0-0",0,0,5,5,0,0,"D"
"2016-09-17",2016,"Boreham Wood","Torquay United","2-0",2,0,5,5,2,2,"H"
"2016-09-17",2016,"Chester","Braintree Town","1-0",1,0,5,5,1,1,"H"
"2016-09-17",2016,"Dagenham and Redbridge","North Ferriby","2-0",2,0,5,5,2,2,"H"
"2016-09-17",2016,"Forest Green Rovers","Bromley","1-0",1,0,5,5,1,1,"H"
"2016-09-17",2016,"Gateshead","Solihull","0-0",0,0,5,5,0,0,"D"
"2016-09-17",2016,"Lincoln City","Barrow","1-2",1,2,5,5,3,-1,"A"
"2016-09-17",2016,"Macclesfield","Eastleigh","0-1",0,1,5,5,1,-1,"A"
"2016-09-17",2016,"Maidstone United","Guiseley","1-1",1,1,5,5,2,0,"D"
"2016-09-17",2016,"Southport","Aldershot","1-1",1,1,5,5,2,0,"D"
"2016-09-17",2016,"Sutton United","Tranmere Rovers","1-0",1,0,5,5,1,1,"H"
"2016-09-17",2016,"Woking","Wrexham","2-0",2,0,5,5,2,2,"H"
"2016-09-17",2016,"York City","Dover Athletic","0-1",0,1,5,5,1,-1,"A"
"2016-09-24",2016,"Aldershot","Gateshead","3-0",3,0,5,5,3,3,"H"
"2016-09-24",2016,"Barrow","York City","2-0",2,0,5,5,2,2,"H"
"2016-09-24",2016,"Braintree Town","Forest Green Rovers","0-1",0,1,5,5,1,-1,"A"
"2016-09-24",2016,"Bromley","Dagenham and Redbridge","1-3",1,3,5,5,4,-2,"A"
"2016-09-24",2016,"Dover Athletic","Lincoln City","2-0",2,0,5,5,2,2,"H"
"2016-09-24",2016,"Eastleigh","Sutton United","2-1",2,1,5,5,3,1,"H"
"2016-09-24",2016,"Guiseley","Macclesfield","1-2",1,2,5,5,3,-1,"A"
"2016-09-24",2016,"North Ferriby","Southport","0-1",0,1,5,5,1,-1,"A"
"2016-09-24",2016,"Solihull","Boreham Wood","1-1",1,1,5,5,2,0,"D"
"2016-09-24",2016,"Torquay United","Maidstone United","2-3",2,3,5,5,5,-1,"A"
"2016-09-24",2016,"Tranmere Rovers","Woking","3-1",3,1,5,5,4,2,"H"
"2016-09-24",2016,"Wrexham","Chester","0-0",0,0,5,5,0,0,"D"
"2016-09-27",2016,"Macclesfield","Wrexham","3-0",3,0,5,5,3,3,"H"
"2016-10-01",2016,"Boreham Wood","Wrexham","0-1",0,1,5,5,1,-1,"A"
"2016-10-01",2016,"Chester","Dover Athletic","5-0",5,0,5,5,5,5,"H"
"2016-10-01",2016,"Dagenham and Redbridge","Tranmere Rovers","0-0",0,0,5,5,0,0,"D"
"2016-10-01",2016,"Forest Green Rovers","Barrow","0-0",0,0,5,5,0,0,"D"
"2016-10-01",2016,"Gateshead","Torquay United","0-0",0,0,5,5,0,0,"D"
"2016-10-01",2016,"Lincoln City","Braintree Town","3-0",3,0,5,5,3,3,"H"
"2016-10-01",2016,"Macclesfield","North Ferriby","1-0",1,0,5,5,1,1,"H"
"2016-10-01",2016,"Maidstone United","Solihull","2-4",2,4,5,5,6,-2,"A"
"2016-10-01",2016,"Southport","Bromley","1-2",1,2,5,5,3,-1,"A"
"2016-10-01",2016,"Sutton United","Guiseley","1-0",1,0,5,5,1,1,"H"
"2016-10-01",2016,"Woking","Eastleigh","3-3",3,3,5,5,6,0,"D"
"2016-10-01",2016,"York City","Aldershot","0-1",0,1,5,5,1,-1,"A"
"2016-10-04",2016,"Aldershot","Forest Green Rovers","0-4",0,4,5,5,4,-4,"A"
"2016-10-04",2016,"Barrow","Macclesfield","1-1",1,1,5,5,2,0,"D"
"2016-10-04",2016,"Braintree Town","Boreham Wood","1-2",1,2,5,5,3,-1,"A"
"2016-10-04",2016,"Bromley","Woking","2-1",2,1,5,5,3,1,"H"
"2016-10-04",2016,"Dover Athletic","Sutton United","3-1",3,1,5,5,4,2,"H"
"2016-10-04",2016,"Eastleigh","Maidstone United","3-0",3,0,5,5,3,3,"H"
"2016-10-04",2016,"Guiseley","York City","6-1",6,1,5,5,7,5,"H"
"2016-10-04",2016,"North Ferriby","Chester","0-1",0,1,5,5,1,-1,"A"
"2016-10-04",2016,"Solihull","Southport","4-0",4,0,5,5,4,4,"H"
"2016-10-04",2016,"Torquay United","Dagenham and Redbridge","1-0",1,0,5,5,1,1,"H"
"2016-10-04",2016,"Tranmere Rovers","Gateshead","0-1",0,1,5,5,1,-1,"A"
"2016-10-04",2016,"Wrexham","Lincoln City","1-2",1,2,5,5,3,-1,"A"
"2016-10-08",2016,"Aldershot","Solihull","2-0",2,0,5,5,2,2,"H"
"2016-10-08",2016,"Barrow","Maidstone United","3-0",3,0,5,5,3,3,"H"
"2016-10-08",2016,"Braintree Town","York City","1-1",1,1,5,5,2,0,"D"
"2016-10-08",2016,"Bromley","Lincoln City","1-1",1,1,5,5,2,0,"D"
"2016-10-08",2016,"Chester","Torquay United","1-0",1,0,5,5,1,1,"H"
"2016-10-08",2016,"Eastleigh","Dagenham and Redbridge","0-1",0,1,5,5,1,-1,"A"
"2016-10-08",2016,"Gateshead","Dover Athletic","4-2",4,2,5,5,6,2,"H"
"2016-10-08",2016,"Guiseley","Southport","2-1",2,1,5,5,3,1,"H"
"2016-10-08",2016,"Macclesfield","Boreham Wood","0-2",0,2,5,5,2,-2,"A"
"2016-10-08",2016,"North Ferriby","Forest Green Rovers","0-3",0,3,5,5,3,-3,"A"
"2016-10-08",2016,"Sutton United","Woking","4-1",4,1,5,5,5,3,"H"
"2016-10-08",2016,"Tranmere Rovers","Wrexham","2-0",2,0,5,5,2,2,"H"
"2016-10-22",2016,"Boreham Wood","North Ferriby","1-0",1,0,5,5,1,1,"H"
"2016-10-22",2016,"Dagenham and Redbridge","Macclesfield","1-1",1,1,5,5,2,0,"D"
"2016-10-22",2016,"Dover Athletic","Braintree Town","6-1",6,1,5,5,7,5,"H"
"2016-10-22",2016,"Forest Green Rovers","Guiseley","3-0",3,0,5,5,3,3,"H"
"2016-10-22",2016,"Lincoln City","Eastleigh","0-0",0,0,5,5,0,0,"D"
"2016-10-22",2016,"Maidstone United","Gateshead","0-2",0,2,5,5,2,-2,"A"
"2016-10-22",2016,"Solihull","Tranmere Rovers","0-3",0,3,5,5,3,-3,"A"
"2016-10-22",2016,"Southport","Sutton United","1-1",1,1,5,5,2,0,"D"
"2016-10-22",2016,"Torquay United","Aldershot","0-0",0,0,5,5,0,0,"D"
"2016-10-22",2016,"Woking","Barrow","1-1",1,1,5,5,2,0,"D"
"2016-10-22",2016,"Wrexham","Bromley","2-1",2,1,5,5,3,1,"H"
"2016-10-22",2016,"York City","Chester","1-1",1,1,5,5,2,0,"D"
"2016-10-25",2016,"Bromley","Dover Athletic","0-2",0,2,5,5,2,-2,"A"
"2016-10-25",2016,"Dagenham and Redbridge","Aldershot","1-0",1,0,5,5,1,1,"H"
"2016-10-25",2016,"Eastleigh","Torquay United","3-0",3,0,5,5,3,3,"H"
"2016-10-25",2016,"Guiseley","Gateshead","1-1",1,1,5,5,2,0,"D"
"2016-10-25",2016,"Lincoln City","Boreham Wood","2-0",2,0,5,5,2,2,"H"
"2016-10-25",2016,"Macclesfield","Chester","0-0",0,0,5,5,0,0,"D"
"2016-10-25",2016,"Solihull","Forest Green Rovers","0-1",0,1,5,5,1,-1,"A"
"2016-10-25",2016,"Southport","York City","2-0",2,0,5,5,2,2,"H"
"2016-10-25",2016,"Sutton United","Maidstone United","2-2",2,2,5,5,4,0,"D"
"2016-10-25",2016,"Tranmere Rovers","North Ferriby","1-0",1,0,5,5,1,1,"H"
"2016-10-25",2016,"Woking","Braintree Town","2-3",2,3,5,5,5,-1,"A"
"2016-10-25",2016,"Wrexham","Barrow","2-2",2,2,5,5,4,0,"D"
"2016-10-29",2016,"Aldershot","Guiseley","1-0",1,0,5,5,1,1,"H"
"2016-10-29",2016,"Barrow","Eastleigh","4-0",4,0,5,5,4,4,"H"
"2016-10-29",2016,"Boreham Wood","Woking","2-1",2,1,5,5,3,1,"H"
"2016-10-29",2016,"Braintree Town","Solihull","0-1",0,1,5,5,1,-1,"A"
"2016-10-29",2016,"Chester","Lincoln City","2-5",2,5,5,5,7,-3,"A"
"2016-10-29",2016,"Dover Athletic","Tranmere Rovers","1-4",1,4,5,5,5,-3,"A"
"2016-10-29",2016,"Forest Green Rovers","Dagenham and Redbridge","1-1",1,1,5,5,2,0,"D"
"2016-10-29",2016,"Gateshead","Wrexham","2-2",2,2,5,5,4,0,"D"
"2016-10-29",2016,"Maidstone United","Macclesfield","2-1",2,1,5,5,3,1,"H"
"2016-10-29",2016,"North Ferriby","Bromley","1-2",1,2,5,5,3,-1,"A"
"2016-10-29",2016,"Torquay United","Southport","1-2",1,2,5,5,3,-1,"A"
"2016-10-29",2016,"York City","Sutton United","2-2",2,2,5,5,4,0,"D"
"2016-11-05",2016,"Forest Green Rovers","Aldershot","2-1",2,1,5,5,3,1,"H"
"2016-11-05",2016,"North Ferriby","Wrexham","0-0",0,0,5,5,0,0,"D"
"2016-11-12",2016,"Bromley","Boreham Wood","1-0",1,0,5,5,1,1,"H"
"2016-11-12",2016,"Dagenham and Redbridge","Gateshead","0-5",0,5,5,5,5,-5,"A"
"2016-11-12",2016,"Eastleigh","York City","1-1",1,1,5,5,2,0,"D"
"2016-11-12",2016,"Guiseley","Torquay United","2-0",2,0,5,5,2,2,"H"
"2016-11-12",2016,"Lincoln City","Aldershot","3-3",3,3,5,5,6,0,"D"
"2016-11-12",2016,"Macclesfield","Forest Green Rovers","0-1",0,1,5,5,1,-1,"A"
"2016-11-12",2016,"Solihull","Dover Athletic","2-3",2,3,5,5,5,-1,"A"
"2016-11-12",2016,"Southport","Maidstone United","3-2",3,2,5,5,5,1,"H"
"2016-11-12",2016,"Sutton United","Barrow","0-0",0,0,5,5,0,0,"D"
"2016-11-12",2016,"Tranmere Rovers","Chester","2-2",2,2,5,5,4,0,"D"
"2016-11-12",2016,"Woking","North Ferriby","1-1",1,1,5,5,2,0,"D"
"2016-11-12",2016,"Wrexham","Braintree Town","0-1",0,1,5,5,1,-1,"A"
"2016-11-19",2016,"Aldershot","Macclesfield","1-2",1,2,5,5,3,-1,"A"
"2016-11-19",2016,"Barrow","Solihull","2-1",2,1,5,5,3,1,"H"
"2016-11-19",2016,"Boreham Wood","Southport","2-0",2,0,5,5,2,2,"H"
"2016-11-19",2016,"Braintree Town","Tranmere Rovers","0-1",0,1,5,5,1,-1,"A"
"2016-11-19",2016,"Chester","Bromley","1-1",1,1,5,5,2,0,"D"
"2016-11-19",2016,"Dover Athletic","Guiseley","2-0",2,0,5,5,2,2,"H"
"2016-11-19",2016,"Forest Green Rovers","Lincoln City","2-3",2,3,5,5,5,-1,"A"
"2016-11-19",2016,"Gateshead","Eastleigh","2-2",2,2,5,5,4,0,"D"
"2016-11-19",2016,"Maidstone United","Woking","0-3",0,3,5,5,3,-3,"A"
"2016-11-19",2016,"North Ferriby","Sutton United","2-1",2,1,5,5,3,1,"H"
"2016-11-19",2016,"Torquay United","Wrexham","1-1",1,1,5,5,2,0,"D"
"2016-11-19",2016,"York City","Dagenham and Redbridge","0-2",0,2,5,5,2,-2,"A"
"2016-11-22",2016,"Aldershot","Eastleigh","0-1",0,1,5,5,1,-1,"A"
"2016-11-22",2016,"Barrow","Guiseley","3-0",3,0,5,5,3,3,"H"
"2016-11-22",2016,"Boreham Wood","Sutton United","1-0",1,0,5,5,1,1,"H"
"2016-11-22",2016,"Braintree Town","Bromley","2-2",2,2,5,5,4,0,"D"
"2016-11-22",2016,"Chester","Southport","2-2",2,2,5,5,4,0,"D"
"2016-11-22",2016,"Dover Athletic","Woking","3-1",3,1,5,5,4,2,"H"
"2016-11-22",2016,"Forest Green Rovers","Tranmere Rovers","2-2",2,2,5,5,4,0,"D"
"2016-11-22",2016,"Gateshead","Macclesfield","1-1",1,1,5,5,2,0,"D"
"2016-11-22",2016,"Maidstone United","Dagenham and Redbridge","0-1",0,1,5,5,1,-1,"A"
"2016-11-22",2016,"Torquay United","Solihull","3-0",3,0,5,5,3,3,"H"
"2016-11-22",2016,"York City","Lincoln City","1-4",1,4,5,5,5,-3,"A"
"2016-11-26",2016,"Bromley","York City","3-0",3,0,5,5,3,3,"H"
"2016-11-26",2016,"Dagenham and Redbridge","Barrow","1-4",1,4,5,5,5,-3,"A"
"2016-11-26",2016,"Eastleigh","Chester","0-3",0,3,5,5,3,-3,"A"
"2016-11-26",2016,"Guiseley","Boreham Wood","3-1",3,1,5,5,4,2,"H"
"2016-11-26",2016,"Lincoln City","Maidstone United","2-0",2,0,5,5,2,2,"H"
"2016-11-26",2016,"Solihull","North Ferriby","2-0",2,0,5,5,2,2,"H"
"2016-11-26",2016,"Southport","Braintree Town","4-5",4,5,5,5,9,-1,"A"
"2016-11-26",2016,"Sutton United","Aldershot","2-0",2,0,5,5,2,2,"H"
"2016-11-26",2016,"Tranmere Rovers","Torquay United","2-1",2,1,5,5,3,1,"H"
"2016-11-26",2016,"Woking","Gateshead","3-0",3,0,5,5,3,3,"H"
"2016-11-26",2016,"Wrexham","Forest Green Rovers","3-1",3,1,5,5,4,2,"H"
"2016-11-29",2016,"Chester","North Ferriby","3-0",3,0,5,5,3,3,"H"
"2016-11-29",2016,"Dagenham and Redbridge","Torquay United","0-1",0,1,5,5,1,-1,"A"
"2016-11-29",2016,"Gateshead","Tranmere Rovers","0-1",0,1,5,5,1,-1,"A"
"2016-11-29",2016,"Lincoln City","Wrexham","1-0",1,0,5,5,1,1,"H"
"2016-11-29",2016,"Maidstone United","Eastleigh","2-1",2,1,5,5,3,1,"H"
"2016-11-29",2016,"Southport","Solihull","0-0",0,0,5,5,0,0,"D"
"2016-11-29",2016,"Sutton United","Dover Athletic","0-6",0,6,5,5,6,-6,"A"
"2016-11-29",2016,"Woking","Bromley","2-1",2,1,5,5,3,1,"H"
"2016-11-29",2016,"York City","Guiseley","1-1",1,1,5,5,2,0,"D"
"2016-12-03",2016,"Aldershot","Boreham Wood","2-0",2,0,5,5,2,2,"H"
"2016-12-03",2016,"Bromley","Maidstone United","2-0",2,0,5,5,2,2,"H"
"2016-12-03",2016,"Dover Athletic","Dagenham and Redbridge","1-2",1,2,5,5,3,-1,"A"
"2016-12-03",2016,"Guiseley","Chester","1-1",1,1,5,5,2,0,"D"
"2016-12-03",2016,"North Ferriby","Gateshead","1-0",1,0,5,5,1,1,"H"
"2016-12-03",2016,"Tranmere Rovers","York City","1-0",1,0,5,5,1,1,"H"
"2016-12-06",2016,"Wrexham","Macclesfield","0-3",0,3,5,5,3,-3,"A"
"2016-12-17",2016,"Boreham Wood","Barrow","1-1",1,1,5,5,2,0,"D"
"2016-12-17",2016,"Chester","Aldershot","2-0",2,0,5,5,2,2,"H"
"2016-12-17",2016,"Dagenham and Redbridge","Solihull","4-4",4,4,5,5,8,0,"D"
"2016-12-17",2016,"Forest Green Rovers","Dover Athletic","1-1",1,1,5,5,2,0,"D"
"2016-12-17",2016,"Gateshead","Braintree Town","1-1",1,1,5,5,2,0,"D"
"2016-12-17",2016,"Lincoln City","Tranmere Rovers","2-1",2,1,5,5,3,1,"H"
"2016-12-17",2016,"Macclesfield","Bromley","1-2",1,2,5,5,3,-1,"A"
"2016-12-17",2016,"Maidstone United","North Ferriby","1-2",1,2,5,5,3,-1,"A"
"2016-12-17",2016,"Southport","Eastleigh","4-3",4,3,5,5,7,1,"H"
"2016-12-17",2016,"Sutton United","Wrexham","1-0",1,0,5,5,1,1,"H"
"2016-12-17",2016,"Woking","Guiseley","0-0",0,0,5,5,0,0,"D"
"2016-12-17",2016,"York City","Torquay United","0-0",0,0,5,5,0,0,"D"
"2016-12-20",2016,"Boreham Wood","Braintree Town","0-1",0,1,5,5,1,-1,"A"
"2016-12-26",2016,"Aldershot","Woking","4-0",4,0,5,5,4,4,"H"
"2016-12-26",2016,"Barrow","Gateshead","0-0",0,0,5,5,0,0,"D"
"2016-12-26",2016,"Braintree Town","Dagenham and Redbridge","3-2",3,2,5,5,5,1,"H"
"2016-12-26",2016,"Bromley","Sutton United","1-0",1,0,5,5,1,1,"H"
"2016-12-26",2016,"Dover Athletic","Maidstone United","1-1",1,1,5,5,2,0,"D"
"2016-12-26",2016,"Guiseley","Lincoln City","2-1",2,1,5,5,3,1,"H"
"2016-12-26",2016,"North Ferriby","York City","0-1",0,1,5,5,1,-1,"A"
"2016-12-26",2016,"Solihull","Chester","3-2",3,2,5,5,5,1,"H"
"2016-12-26",2016,"Torquay United","Forest Green Rovers","4-3",4,3,5,5,7,1,"H"
"2016-12-26",2016,"Tranmere Rovers","Macclesfield","1-0",1,0,5,5,1,1,"H"
"2016-12-26",2016,"Wrexham","Southport","1-0",1,0,5,5,1,1,"H"
"2016-12-27",2016,"Eastleigh","Boreham Wood","2-2",2,2,5,5,4,0,"D"
"2016-12-31",2016,"Boreham Wood","Eastleigh","0-1",0,1,5,5,1,-1,"A"
"2016-12-31",2016,"Gateshead","Barrow","4-1",4,1,5,5,5,3,"H"
"2017-01-01",2016,"Chester","Solihull","0-3",0,3,5,5,3,-3,"A"
"2017-01-01",2016,"Forest Green Rovers","Torquay United","5-5",5,5,5,5,10,0,"D"
"2017-01-01",2016,"Lincoln City","Guiseley","3-1",3,1,5,5,4,2,"H"
"2017-01-01",2016,"Macclesfield","Tranmere Rovers","4-2",4,2,5,5,6,2,"H"
"2017-01-01",2016,"Maidstone United","Dover Athletic","1-4",1,4,5,5,5,-3,"A"
"2017-01-01",2016,"Southport","Wrexham","3-2",3,2,5,5,5,1,"H"
"2017-01-01",2016,"Sutton United","Bromley","2-0",2,0,5,5,2,2,"H"
"2017-01-01",2016,"Woking","Aldershot","1-2",1,2,5,5,3,-1,"A"
"2017-01-01",2016,"York City","North Ferriby","0-1",0,1,5,5,1,-1,"A"
"2017-01-02",2016,"Dagenham and Redbridge","Braintree Town","3-0",3,0,5,5,3,3,"H"
"2017-01-07",2016,"Aldershot","Southport","2-1",2,1,5,5,3,1,"H"
"2017-01-07",2016,"Braintree Town","Chester","1-2",1,2,5,5,3,-1,"A"
"2017-01-07",2016,"Bromley","Forest Green Rovers","1-5",1,5,5,5,6,-4,"A"
"2017-01-07",2016,"Dover Athletic","York City","2-2",2,2,5,5,4,0,"D"
"2017-01-07",2016,"Guiseley","Maidstone United","2-1",2,1,5,5,3,1,"H"
"2017-01-07",2016,"North Ferriby","Dagenham and Redbridge","0-4",0,4,5,5,4,-4,"A"
"2017-01-07",2016,"Solihull","Gateshead","0-2",0,2,5,5,2,-2,"A"
"2017-01-07",2016,"Torquay United","Boreham Wood","0-1",0,1,5,5,1,-1,"A"
"2017-01-07",2016,"Wrexham","Woking","2-1",2,1,5,5,3,1,"H"
"2017-01-10",2016,"Barrow","Southport","0-1",0,1,5,5,1,-1,"A"
"2017-01-10",2016,"Braintree Town","Sutton United","1-0",1,0,5,5,1,1,"H"
"2017-01-10",2016,"Eastleigh","Forest Green Rovers","1-1",1,1,5,5,2,0,"D"
"2017-01-10",2016,"Macclesfield","Dover Athletic","2-1",2,1,5,5,3,1,"H"
"2017-01-14",2016,"Torquay United","Woking","1-2",1,2,5,5,3,-1,"A"
"2017-01-14",2016,"Wrexham","North Ferriby","1-0",1,0,5,5,1,1,"H"
"2017-01-20",2016,"Lincoln City","Dover Athletic","2-0",2,0,5,5,2,2,"H"
"2017-01-21",2016,"Boreham Wood","Solihull","0-0",0,0,5,5,0,0,"D"
"2017-01-21",2016,"Chester","Wrexham","1-1",1,1,5,5,2,0,"D"
"2017-01-21",2016,"Forest Green Rovers","Braintree Town","1-1",1,1,5,5,2,0,"D"
"2017-01-21",2016,"Gateshead","Aldershot","1-1",1,1,5,5,2,0,"D"
"2017-01-21",2016,"Macclesfield","Guiseley","1-2",1,2,5,5,3,-1,"A"
"2017-01-21",2016,"Maidstone United","Torquay United","2-1",2,1,5,5,3,1,"H"
"2017-01-21",2016,"Southport","North Ferriby","2-4",2,4,5,5,6,-2,"A"
"2017-01-21",2016,"Sutton United","Eastleigh","1-1",1,1,5,5,2,0,"D"
"2017-01-21",2016,"York City","Barrow","2-1",2,1,5,5,3,1,"H"
"2017-01-24",2016,"Barrow","Lincoln City","3-0",3,0,5,5,3,3,"H"
"2017-01-28",2016,"Aldershot","York City","0-0",0,0,5,5,0,0,"D"
"2017-01-28",2016,"Barrow","Forest Green Rovers","2-3",2,3,5,5,5,-1,"A"
"2017-01-28",2016,"Bromley","Southport","3-1",3,1,5,5,4,2,"H"
"2017-01-28",2016,"Dover Athletic","Chester","3-1",3,1,5,5,4,2,"H"
"2017-01-28",2016,"Eastleigh","Woking","0-1",0,1,5,5,1,-1,"A"
"2017-01-28",2016,"North Ferriby","Macclesfield","0-2",0,2,5,5,2,-2,"A"
"2017-01-28",2016,"Solihull","Maidstone United","2-0",2,0,5,5,2,2,"H"
"2017-01-28",2016,"Torquay United","Gateshead","3-1",3,1,5,5,4,2,"H"
"2017-01-28",2016,"Tranmere Rovers","Dagenham and Redbridge","0-2",0,2,5,5,2,-2,"A"
"2017-01-28",2016,"Wrexham","Boreham Wood","2-1",2,1,5,5,3,1,"H"
"2017-01-31",2016,"Solihull","Lincoln City","0-1",0,1,5,5,1,-1,"A"
"2017-01-31",2016,"Woking","Tranmere Rovers","0-3",0,3,5,5,3,-3,"A"
"2017-02-04",2016,"Bromley","Torquay United","1-0",1,0,5,5,1,1,"H"
"2017-02-04",2016,"Dagenham and Redbridge","Chester","3-2",3,2,5,5,5,1,"H"
"2017-02-04",2016,"Gateshead","Southport","3-0",3,0,5,5,3,3,"H"
"2017-02-04",2016,"Maidstone United","Aldershot","0-2",0,2,5,5,2,-2,"A"
"2017-02-04",2016,"Wrexham","Guiseley","3-1",3,1,5,5,4,2,"H"
"2017-02-11",2016,"Aldershot","Barrow","2-2",2,2,5,5,4,0,"D"
"2017-02-11",2016,"Braintree Town","North Ferriby","1-0",1,0,5,5,1,1,"H"
"2017-02-11",2016,"Chester","Gateshead","1-2",1,2,5,5,3,-1,"A"
"2017-02-11",2016,"Dover Athletic","Wrexham","1-1",1,1,5,5,2,0,"D"
"2017-02-11",2016,"Forest Green Rovers","Boreham Wood","2-0",2,0,5,5,2,2,"H"
"2017-02-11",2016,"Guiseley","Eastleigh","1-1",1,1,5,5,2,0,"D"
"2017-02-11",2016,"Lincoln City","Woking","3-2",3,2,5,5,5,1,"H"
"2017-02-11",2016,"Solihull","Sutton United","3-0",3,0,5,5,3,3,"H"
"2017-02-11",2016,"Southport","Dagenham and Redbridge","1-4",1,4,5,5,5,-3,"A"
"2017-02-11",2016,"Torquay United","Macclesfield","1-1",1,1,5,5,2,0,"D"
"2017-02-11",2016,"Tranmere Rovers","Bromley","2-2",2,2,5,5,4,0,"D"
"2017-02-11",2016,"York City","Maidstone United","1-1",1,1,5,5,2,0,"D"
"2017-02-14",2016,"Eastleigh","Braintree Town","0-2",0,2,5,5,2,-2,"A"
"2017-02-14",2016,"Guiseley","Sutton United","2-1",2,1,5,5,3,1,"H"
"2017-02-14",2016,"Woking","Solihull","2-1",2,1,5,5,3,1,"H"
"2017-02-15",2016,"Macclesfield","Barrow","0-1",0,1,5,5,1,-1,"A"
"2017-02-18",2016,"Barrow","Torquay United","0-0",0,0,5,5,0,0,"D"
"2017-02-18",2016,"Boreham Wood","York City","1-1",1,1,5,5,2,0,"D"
"2017-02-18",2016,"Bromley","Solihull","0-1",0,1,5,5,1,-1,"A"
"2017-02-18",2016,"Dagenham and Redbridge","Guiseley","1-2",1,2,5,5,3,-1,"A"
"2017-02-18",2016,"Eastleigh","Tranmere Rovers","0-2",0,2,5,5,2,-2,"A"
"2017-02-18",2016,"Gateshead","Forest Green Rovers","3-1",3,1,5,5,4,2,"H"
"2017-02-18",2016,"Macclesfield","Braintree Town","2-0",2,0,5,5,2,2,"H"
"2017-02-18",2016,"Maidstone United","Chester","4-2",4,2,5,5,6,2,"H"
"2017-02-18",2016,"North Ferriby","Dover Athletic","1-2",1,2,5,5,3,-1,"A"
"2017-02-18",2016,"Woking","Southport","0-0",0,0,5,5,0,0,"D"
"2017-02-18",2016,"Wrexham","Aldershot","0-2",0,2,5,5,2,-2,"A"
"2017-02-21",2016,"Dagenham and Redbridge","Bromley","2-1",2,1,5,5,3,1,"H"
"2017-02-21",2016,"Eastleigh","Macclesfield","0-1",0,1,5,5,1,-1,"A"
"2017-02-21",2016,"North Ferriby","Lincoln City","0-1",0,1,5,5,1,-1,"A"
"2017-02-21",2016,"Tranmere Rovers","Boreham Wood","2-1",2,1,5,5,3,1,"H"
"2017-02-21",2016,"York City","Gateshead","1-3",1,3,5,5,4,-2,"A"
"2017-02-25",2016,"Aldershot","Bromley","4-0",4,0,5,5,4,4,"H"
"2017-02-25",2016,"Braintree Town","Maidstone United","0-0",0,0,5,5,0,0,"D"
"2017-02-25",2016,"Dover Athletic","Eastleigh","3-0",3,0,5,5,3,3,"H"
"2017-02-25",2016,"Forest Green Rovers","Woking","4-3",4,3,5,5,7,1,"H"
"2017-02-25",2016,"Guiseley","North Ferriby","1-2",1,2,5,5,3,-1,"A"
"2017-02-25",2016,"Solihull","Wrexham","0-1",0,1,5,5,1,-1,"A"
"2017-02-25",2016,"Southport","Chester","0-1",0,1,5,5,1,-1,"A"
"2017-02-25",2016,"Torquay United","Sutton United","2-3",2,3,5,5,5,-1,"A"
"2017-02-28",2016,"Bromley","Braintree Town","0-5",0,5,5,5,5,-5,"A"
"2017-02-28",2016,"Dagenham and Redbridge","Maidstone United","0-2",0,2,5,5,2,-2,"A"
"2017-02-28",2016,"Eastleigh","Aldershot","1-1",1,1,5,5,2,0,"D"
"2017-02-28",2016,"Guiseley","Barrow","1-0",1,0,5,5,1,1,"H"
"2017-02-28",2016,"Lincoln City","York City","1-1",1,1,5,5,2,0,"D"
"2017-02-28",2016,"Sutton United","Boreham Wood","1-0",1,0,5,5,1,1,"H"
"2017-02-28",2016,"Woking","Dover Athletic","1-0",1,0,5,5,1,1,"H"
"2017-03-03",2016,"Chester","Tranmere Rovers","2-3",2,3,5,5,5,-1,"A"
"2017-03-04",2016,"Aldershot","Lincoln City","0-0",0,0,5,5,0,0,"D"
"2017-03-04",2016,"Barrow","Sutton United","0-0",0,0,5,5,0,0,"D"
"2017-03-04",2016,"Boreham Wood","Bromley","0-0",0,0,5,5,0,0,"D"
"2017-03-04",2016,"Braintree Town","Wrexham","1-2",1,2,5,5,3,-1,"A"
"2017-03-04",2016,"Dover Athletic","Solihull","0-0",0,0,5,5,0,0,"D"
"2017-03-04",2016,"Forest Green Rovers","Macclesfield","3-0",3,0,5,5,3,3,"H"
"2017-03-04",2016,"Gateshead","Dagenham and Redbridge","1-0",1,0,5,5,1,1,"H"
"2017-03-04",2016,"Maidstone United","Southport","4-2",4,2,5,5,6,2,"H"
"2017-03-04",2016,"North Ferriby","Woking","2-1",2,1,5,5,3,1,"H"
"2017-03-04",2016,"Torquay United","Guiseley","1-2",1,2,5,5,3,-1,"A"
"2017-03-04",2016,"York City","Eastleigh","3-1",3,1,5,5,4,2,"H"
"2017-03-07",2016,"Barrow","Tranmere Rovers","2-1",2,1,5,5,3,1,"H"
"2017-03-07",2016,"Braintree Town","Lincoln City","0-4",0,4,5,5,4,-4,"A"
"2017-03-11",2016,"Bromley","North Ferriby","3-0",3,0,5,5,3,3,"H"
"2017-03-11",2016,"Dagenham and Redbridge","Forest Green Rovers","2-1",2,1,5,5,3,1,"H"
"2017-03-11",2016,"Eastleigh","Barrow","2-0",2,0,5,5,2,2,"H"
"2017-03-11",2016,"Guiseley","Aldershot","1-0",1,0,5,5,1,1,"H"
"2017-03-11",2016,"Solihull","Braintree Town","3-3",3,3,5,5,6,0,"D"
"2017-03-11",2016,"Southport","Torquay United","1-2",1,2,5,5,3,-1,"A"
"2017-03-11",2016,"Sutton United","York City","2-2",2,2,5,5,4,0,"D"
"2017-03-11",2016,"Woking","Boreham Wood","0-0",0,0,5,5,0,0,"D"
"2017-03-11",2016,"Wrexham","Gateshead","0-2",0,2,5,5,2,-2,"A"
"2017-03-14",2016,"Boreham Wood","Dover Athletic","5-0",5,0,5,5,5,5,"H"
"2017-03-14",2016,"Macclesfield","Gateshead","1-1",1,1,5,5,2,0,"D"
"2017-03-14",2016,"Sutton United","Forest Green Rovers","1-2",1,2,5,5,3,-1,"A"
"2017-03-14",2016,"Torquay United","Tranmere Rovers","0-0",0,0,5,5,0,0,"D"
"2017-03-18",2016,"Aldershot","Sutton United","2-0",2,0,5,5,2,2,"H"
"2017-03-18",2016,"Barrow","Dagenham and Redbridge","2-1",2,1,5,5,3,1,"H"
"2017-03-18",2016,"Boreham Wood","Guiseley","0-0",0,0,5,5,0,0,"D"
"2017-03-18",2016,"Braintree Town","Southport","2-0",2,0,5,5,2,2,"H"
"2017-03-18",2016,"Chester","Eastleigh","0-1",0,1,5,5,1,-1,"A"
"2017-03-18",2016,"Dover Athletic","Bromley","1-0",1,0,5,5,1,1,"H"
"2017-03-18",2016,"Forest Green Rovers","Wrexham","3-0",3,0,5,5,3,3,"H"
"2017-03-18",2016,"Gateshead","Woking","2-1",2,1,5,5,3,1,"H"
"2017-03-18",2016,"North Ferriby","Solihull","1-4",1,4,5,5,5,-3,"A"
"2017-03-21",2016,"Aldershot","Dagenham and Redbridge","3-1",3,1,5,5,4,2,"H"
"2017-03-21",2016,"Barrow","Wrexham","1-1",1,1,5,5,2,0,"D"
"2017-03-21",2016,"Boreham Wood","Lincoln City","2-0",2,0,5,5,2,2,"H"
"2017-03-21",2016,"Braintree Town","Woking","1-3",1,3,5,5,4,-2,"A"
"2017-03-21",2016,"Chester","Macclesfield","2-3",2,3,5,5,5,-1,"A"
"2017-03-21",2016,"Forest Green Rovers","Solihull","2-1",2,1,5,5,3,1,"H"
"2017-03-21",2016,"Gateshead","Guiseley","1-1",1,1,5,5,2,0,"D"
"2017-03-21",2016,"Maidstone United","Sutton United","1-1",1,1,5,5,2,0,"D"
"2017-03-21",2016,"North Ferriby","Tranmere Rovers","1-4",1,4,5,5,5,-3,"A"
"2017-03-21",2016,"Torquay United","Eastleigh","2-3",2,3,5,5,5,-1,"A"
"2017-03-21",2016,"York City","Southport","5-3",5,3,5,5,8,2,"H"
"2017-03-25",2016,"Bromley","Chester","0-1",0,1,5,5,1,-1,"A"
"2017-03-25",2016,"Dagenham and Redbridge","York City","1-0",1,0,5,5,1,1,"H"
"2017-03-25",2016,"Eastleigh","Gateshead","1-1",1,1,5,5,2,0,"D"
"2017-03-25",2016,"Guiseley","Dover Athletic","0-4",0,4,5,5,4,-4,"A"
"2017-03-25",2016,"Lincoln City","Forest Green Rovers","3-1",3,1,5,5,4,2,"H"
"2017-03-25",2016,"Macclesfield","Aldershot","0-2",0,2,5,5,2,-2,"A"
"2017-03-25",2016,"Solihull","Barrow","2-4",2,4,5,5,6,-2,"A"
"2017-03-25",2016,"Southport","Boreham Wood","1-0",1,0,5,5,1,1,"H"
"2017-03-25",2016,"Sutton United","North Ferriby","5-1",5,1,5,5,6,4,"H"
"2017-03-25",2016,"Tranmere Rovers","Braintree Town","1-0",1,0,5,5,1,1,"H"
"2017-03-25",2016,"Woking","Maidstone United","2-4",2,4,5,5,6,-2,"A"
"2017-03-25",2016,"Wrexham","Torquay United","1-1",1,1,5,5,2,0,"D"
"2017-03-28",2016,"Chester","Barrow","1-2",1,2,5,5,3,-1,"A"
"2017-03-28",2016,"Macclesfield","York City","1-3",1,3,5,5,4,-2,"A"
"2017-03-28",2016,"Solihull","Torquay United","0-1",0,1,5,5,1,-1,"A"
"2017-03-28",2016,"Sutton United","Lincoln City","1-1",1,1,5,5,2,0,"D"
"2017-03-28",2016,"Tranmere Rovers","Dover Athletic","1-0",1,0,5,5,1,1,"H"
"2017-04-01",2016,"Boreham Wood","Macclesfield","2-4",2,4,5,5,6,-2,"A"
"2017-04-01",2016,"Dagenham and Redbridge","Eastleigh","4-0",4,0,5,5,4,4,"H"
"2017-04-01",2016,"Dover Athletic","Gateshead","2-0",2,0,5,5,2,2,"H"
"2017-04-01",2016,"Forest Green Rovers","North Ferriby","0-1",0,1,5,5,1,-1,"A"
"2017-04-01",2016,"Lincoln City","Bromley","1-0",1,0,5,5,1,1,"H"
"2017-04-01",2016,"Maidstone United","Barrow","2-1",2,1,5,5,3,1,"H"
"2017-04-01",2016,"Solihull","Aldershot","0-2",0,2,5,5,2,-2,"A"
"2017-04-01",2016,"Southport","Guiseley","0-1",0,1,5,5,1,-1,"A"
"2017-04-01",2016,"Torquay United","Chester","0-1",0,1,5,5,1,-1,"A"
"2017-04-01",2016,"Woking","Sutton United","2-1",2,1,5,5,3,1,"H"
"2017-04-01",2016,"Wrexham","Tranmere Rovers","0-1",0,1,5,5,1,-1,"A"
"2017-04-01",2016,"York City","Braintree Town","3-0",3,0,5,5,3,3,"H"
"2017-04-03",2016,"Lincoln City","Dagenham and Redbridge","2-0",2,0,5,5,2,2,"H"
"2017-04-04",2016,"Southport","Macclesfield","1-2",1,2,5,5,3,-1,"A"
"2017-04-04",2016,"Tranmere Rovers","Sutton United","3-2",3,2,5,5,5,1,"H"
"2017-04-04",2016,"York City","Bromley","0-2",0,2,5,5,2,-2,"A"
"2017-04-08",2016,"Aldershot","Torquay United","1-1",1,1,5,5,2,0,"D"
"2017-04-08",2016,"Barrow","Woking","2-2",2,2,5,5,4,0,"D"
"2017-04-08",2016,"Braintree Town","Dover Athletic","1-2",1,2,5,5,3,-1,"A"
"2017-04-08",2016,"Bromley","Wrexham","4-3",4,3,5,5,7,1,"H"
"2017-04-08",2016,"Chester","York City","0-2",0,2,5,5,2,-2,"A"
"2017-04-08",2016,"Eastleigh","Lincoln City","0-1",0,1,5,5,1,-1,"A"
"2017-04-08",2016,"Gateshead","Maidstone United","1-2",1,2,5,5,3,-1,"A"
"2017-04-08",2016,"Guiseley","Forest Green Rovers","0-1",0,1,5,5,1,-1,"A"
"2017-04-08",2016,"Macclesfield","Dagenham and Redbridge","1-4",1,4,5,5,5,-3,"A"
"2017-04-08",2016,"North Ferriby","Boreham Wood","2-4",2,4,5,5,6,-2,"A"
"2017-04-08",2016,"Sutton United","Southport","2-2",2,2,5,5,4,0,"D"
"2017-04-08",2016,"Tranmere Rovers","Solihull","9-0",9,0,5,5,9,9,"H"
"2017-04-11",2016,"Lincoln City","Chester","1-0",1,0,5,5,1,1,"H"
"2017-04-11",2016,"Macclesfield","Maidstone United","3-0",3,0,5,5,3,3,"H"
"2017-04-11",2016,"Tranmere Rovers","Forest Green Rovers","0-1",0,1,5,5,1,-1,"A"
"2017-04-14",2016,"Boreham Wood","Dagenham and Redbridge","1-3",1,3,5,5,4,-2,"A"
"2017-04-14",2016,"Braintree Town","Guiseley","2-0",2,0,5,5,2,2,"H"
"2017-04-14",2016,"Bromley","Barrow","4-1",4,1,5,5,5,3,"H"
"2017-04-14",2016,"Dover Athletic","Southport","3-0",3,0,5,5,3,3,"H"
"2017-04-14",2016,"Forest Green Rovers","Chester","2-0",2,0,5,5,2,2,"H"
"2017-04-14",2016,"Lincoln City","Torquay United","2-1",2,1,5,5,3,1,"H"
"2017-04-14",2016,"North Ferriby","Eastleigh","2-1",2,1,5,5,3,1,"H"
"2017-04-14",2016,"Solihull","York City","1-2",1,2,5,5,3,-1,"A"
"2017-04-14",2016,"Sutton United","Gateshead","3-0",3,0,5,5,3,3,"H"
"2017-04-14",2016,"Tranmere Rovers","Aldershot","2-2",2,2,5,5,4,0,"D"
"2017-04-14",2016,"Woking","Macclesfield","1-0",1,0,5,5,1,1,"H"
"2017-04-14",2016,"Wrexham","Maidstone United","1-3",1,3,5,5,4,-2,"A"
"2017-04-17",2016,"Aldershot","Dover Athletic","1-0",1,0,5,5,1,1,"H"
"2017-04-17",2016,"Barrow","North Ferriby","3-1",3,1,5,5,4,2,"H"
"2017-04-17",2016,"Chester","Woking","2-3",2,3,5,5,5,-1,"A"
"2017-04-17",2016,"Dagenham and Redbridge","Sutton United","2-2",2,2,5,5,4,0,"D"
"2017-04-17",2016,"Eastleigh","Bromley","2-1",2,1,5,5,3,1,"H"
"2017-04-17",2016,"Gateshead","Lincoln City","1-2",1,2,5,5,3,-1,"A"
"2017-04-17",2016,"Guiseley","Tranmere Rovers","1-2",1,2,5,5,3,-1,"A"
"2017-04-17",2016,"Macclesfield","Solihull","1-3",1,3,5,5,4,-2,"A"
"2017-04-17",2016,"Maidstone United","Boreham Wood","1-0",1,0,5,5,1,1,"H"
"2017-04-17",2016,"Southport","Forest Green Rovers","2-0",2,0,5,5,2,2,"H"
"2017-04-17",2016,"Torquay United","Braintree Town","3-1",3,1,5,5,4,2,"H"
"2017-04-17",2016,"York City","Wrexham","1-3",1,3,5,5,4,-2,"A"
"2017-04-22",2016,"Boreham Wood","Gateshead","0-4",0,4,5,5,4,-4,"A"
"2017-04-22",2016,"Braintree Town","Barrow","0-2",0,2,5,5,2,-2,"A"
"2017-04-22",2016,"Bromley","Guiseley","1-1",1,1,5,5,2,0,"D"
"2017-04-22",2016,"Dover Athletic","Torquay United","1-2",1,2,5,5,3,-1,"A"
"2017-04-22",2016,"Forest Green Rovers","Maidstone United","2-2",2,2,5,5,4,0,"D"
"2017-04-22",2016,"Lincoln City","Macclesfield","2-1",2,1,5,5,3,1,"H"
"2017-04-22",2016,"North Ferriby","Aldershot","0-3",0,3,5,5,3,-3,"A"
"2017-04-22",2016,"Solihull","Eastleigh","2-0",2,0,5,5,2,2,"H"
"2017-04-22",2016,"Sutton United","Chester","5-2",5,2,5,5,7,3,"H"
"2017-04-22",2016,"Tranmere Rovers","Southport","4-1",4,1,5,5,5,3,"H"
"2017-04-22",2016,"Woking","York City","1-1",1,1,5,5,2,0,"D"
"2017-04-22",2016,"Wrexham","Dagenham and Redbridge","0-1",0,1,5,5,1,-1,"A"
"2017-04-25",2016,"Dover Athletic","Macclesfield","2-2",2,2,5,5,4,0,"D"
"2017-04-25",2016,"Maidstone United","Lincoln City","0-0",0,0,5,5,0,0,"D"
"2017-04-29",2016,"Aldershot","Braintree Town","2-0",2,0,5,5,2,2,"H"
"2017-04-29",2016,"Barrow","Dover Athletic","2-3",2,3,5,5,5,-1,"A"
"2017-04-29",2016,"Chester","Boreham Wood","0-2",0,2,5,5,2,-2,"A"
"2017-04-29",2016,"Dagenham and Redbridge","Woking","1-1",1,1,5,5,2,0,"D"
"2017-04-29",2016,"Eastleigh","Wrexham","1-1",1,1,5,5,2,0,"D"
"2017-04-29",2016,"Gateshead","Bromley","0-2",0,2,5,5,2,-2,"A"
"2017-04-29",2016,"Guiseley","Solihull","1-1",1,1,5,5,2,0,"D"
"2017-04-29",2016,"Macclesfield","Sutton United","0-0",0,0,5,5,0,0,"D"
"2017-04-29",2016,"Maidstone United","Tranmere Rovers","0-1",0,1,5,5,1,-1,"A"
"2017-04-29",2016,"Southport","Lincoln City","1-1",1,1,5,5,2,0,"D"
"2017-04-29",2016,"Torquay United","North Ferriby","2-0",2,0,5,5,2,2,"H"
"2017-04-29",2016,"York City","Forest Green Rovers","2-2",2,2,5,5,4,0,"D"
